Image;Hits;206 Hits;Hits combined;Bandwidth;Avg. Size
/releases/19.07.4/targets/x86/64/openwrt-19.07.4-x86-64-combined-ext4.img.gz;4652;7431;12083;29.08 GB;2.46 MB
/releases/19.07.4/targets/x86/64/openwrt-19.07.4-x86-64-combined-squashfs.img.gz;1993;3007;5000;10.81 GB;2.21 MB
/releases/19.07.4/targets/brcm2708/bcm2710/openwrt-19.07.4-brcm2708-bcm2710-rpi-3-ext4-factory.img.gz;1822;4113;5935;18.68 GB;3.22 MB
/snapshots/targets/bcm27xx/bcm2711/openwrt-bcm27xx-bcm2711-rpi-4-squashfs-factory.img.gz;983;5098;6081;10.37 GB;1.75 MB
/snapshots/targets/bcm27xx/bcm2711/openwrt-bcm27xx-bcm2711-rpi-4-ext4-factory.img.gz;958;964;1922;11.97 GB;6.38 MB
/releases/19.07.4/targets/x86/generic/openwrt-19.07.4-x86-generic-combined-ext4.img.gz;839;1322;2161;5.37 GB;2.54 MB
/releases/19.07.4/targets/brcm2708/bcm2708/openwrt-19.07.4-brcm2708-bcm2708-rpi-ext4-factory.img.gz;816;1311;2127;7.94 GB;3.82 MB
/snapshots/targets/rockchip/armv8/openwrt-rockchip-armv8-friendlyarm_nanopi-r2s-ext4-sysupgrade.img.gz;585;1167;1752;4.03 GB;2.35 MB
/releases/19.07.4/targets/brcm2708/bcm2709/openwrt-19.07.4-brcm2708-bcm2709-rpi-2-ext4-factory.img.gz;493;1145;1638;4.75 GB;2.97 MB
/releases/19.07.4/targets/x86/64/openwrt-19.07.4-x86-64-generic-rootfs.tar.gz;439;708;1147;1.40 GB;1.25 MB
/snapshots/targets/x86/64/openwrt-x86-64-generic-ext4-combined-efi.img.gz;408;953;1361;3.32 GB;2.50 MB
/releases/19.07.4/targets/x86/generic/openwrt-19.07.4-x86-generic-combined-squashfs.img.gz;384;714;1098;2.01 GB;1.88 MB
/releases/19.07.4/targets/brcm2708/bcm2710/openwrt-19.07.4-brcm2708-bcm2710-rpi-3-ext4-sysupgrade.img.gz;375;962;1337;3.60 GB;2.76 MB
/snapshots/targets/bcm27xx/bcm2711/openwrt-bcm27xx-bcm2711-rpi-4-ext4-sysupgrade.img.gz;344;436;780;3.96 GB;5.20 MB
/snapshots/targets/x86/64/openwrt-x86-64-generic-ext4-combined.img.gz;327;389;716;2.79 GB;3.99 MB
/snapshots/targets/rockchip/armv8/openwrt-rockchip-armv8-friendlyarm_nanopi-r2s-squashfs-sysupgrade.img.gz;322;363;685;1.95 GB;2.92 MB
/snapshots/targets/bcm27xx/bcm2711/openwrt-bcm27xx-bcm2711-rpi-4-squashfs-sysupgrade.img.gz;304;772;1076;3.21 GB;3.06 MB
/releases/19.07.4/targets/x86/64/openwrt-19.07.4-x86-64-rootfs-ext4.img.gz;296;405;701;985.74 MB;1.41 MB
/snapshots/targets/bcm27xx/bcm2710/openwrt-bcm27xx-bcm2710-rpi-3-ext4-factory.img.gz;261;970;1231;3.02 GB;2.51 MB
/releases/19.07.4/targets/x86/legacy/openwrt-19.07.4-x86-legacy-combined-ext4.img.gz;255;483;738;1.31 GB;1.81 MB
/releases/19.07.4/targets/ar71xx/nand/openwrt-19.07.4-ar71xx-nand-wndr4300-squashfs-sysupgrade.tar;236;755;991;922.97 MB;953.71 KB
/releases/19.07.4/targets/x86/64/openwrt-19.07.4-x86-64-rootfs-squashfs.img.gz;206;126;332;448.57 MB;1.35 MB
/releases/19.07.4/targets/brcm2708/bcm2710/openwrt-19.07.4-brcm2708-bcm2710-rpi-3-squashfs-factory.img.gz;201;238;439;1.86 GB;4.33 MB
/releases/19.07.4/targets/x86/geode/openwrt-19.07.4-x86-geode-combined-ext4.img.gz;197;491;688;1.21 GB;1.80 MB
/releases/19.07.3/targets/x86/64/openwrt-19.07.3-x86-64-rootfs-ext4.img.gz;186;1;187;715.75 MB;3.83 MB
/snapshots/targets/x86/64/openwrt-x86-64-generic-squashfs-combined.img.gz;184;833;1017;1.23 GB;1.24 MB
/releases/19.07.4/targets/brcm2708/bcm2708/openwrt-19.07.4-brcm2708-bcm2708-rpi-ext4-sysupgrade.img.gz;175;384;559;1.47 GB;2.68 MB
/releases/18.06.1/targets/x86/64/openwrt-18.06.1-x86-64-combined-ext4.img.gz;165;190;355;584.36 MB;1.65 MB
/snapshots/targets/x86/64/openwrt-x86-64-generic-squashfs-combined-efi.img.gz;164;406;570;1.19 GB;2.13 MB
/releases/19.07.4/targets/ar71xx/nand/openwrt-19.07.4-ar71xx-nand-mr18-squashfs-sysupgrade.tar;163;155;318;1015.60 MB;3.19 MB
/releases/19.07.2/targets/x86/64/openwrt-19.07.2-x86-64-combined-ext4.img.gz;163;129;292;1.13 GB;3.95 MB
/releases/19.07.3/targets/sunxi/cortexa7/openwrt-19.07.3-sunxi-cortexa7-sun7i-a20-cubieboard2-squashfs-sdcard.img.gz;149;0;149;430.80 MB;2.89 MB
/releases/19.07.1/targets/x86/64/openwrt-19.07.1-x86-64-combined-ext4.img.gz;147;44;191;1.05 GB;5.63 MB
/releases/18.06.4/targets/x86/64/openwrt-18.06.4-x86-64-combined-ext4.img.gz;140;110;250;657.92 MB;2.63 MB
/releases/19.07.4/targets/sunxi/cortexa7/openwrt-19.07.4-sunxi-cortexa7-sun7i-a20-lamobo-r1-squashfs-sdcard.img.gz;129;99;228;588.40 MB;2.58 MB
/releases/18.06.8/targets/x86/64/openwrt-18.06.8-x86-64-combined-ext4.img.gz;122;478;600;599.36 MB;1022.91 KB
/releases/19.07.4/targets/x86/legacy/openwrt-19.07.4-x86-legacy-combined-squashfs.img.gz;121;247;368;471.50 MB;1.28 MB
/releases/19.07.4/targets/x86/generic/openwrt-19.07.4-x86-generic-generic-rootfs.tar.gz;120;103;223;389.19 MB;1.75 MB
/releases/19.07.4/targets/apm821xx/sata/openwrt-19.07.4-apm821xx-sata-wd_mybooklive-ext4-factory.img.gz;119;27;146;624.49 MB;4.28 MB
/releases/17.01.4/targets/brcm2708/bcm2710/lede-17.01.4-brcm2708-bcm2710-rpi-3-ext4-sdcard.img.gz;119;198;317;721.80 MB;2.28 MB
/releases/19.07.4/targets/brcm2708/bcm2709/openwrt-19.07.4-brcm2708-bcm2709-rpi-2-ext4-sysupgrade.img.gz;112;208;320;988.00 MB;3.09 MB
/releases/19.07.3/targets/x86/64/openwrt-19.07.3-x86-64-combined-ext4.img.gz;107;118;225;739.20 MB;3.29 MB
/releases/19.07.1/targets/x86/generic/openwrt-19.07.1-x86-generic-combined-ext4.img.gz;105;258;363;398.25 MB;1.10 MB
/releases/19.07.4/targets/brcm2708/bcm2710/openwrt-19.07.4-brcm2708-bcm2710-rpi-3-squashfs-sysupgrade.img.gz;100;155;255;929.59 MB;3.65 MB
/releases/19.07.0-rc2/targets/x86/64/openwrt-19.07.0-rc2-x86-64-combined-ext4.img.gz;99;479;578;460.40 MB;815.66 KB
/releases/19.07.4/targets/x86/generic/openwrt-19.07.4-x86-generic-rootfs-ext4.img.gz;99;80;179;300.48 MB;1.68 MB
/snapshots/targets/bcm27xx/bcm2710/openwrt-bcm27xx-bcm2710-rpi-3-ext4-sysupgrade.img.gz;99;327;426;1.11 GB;2.67 MB
/releases/19.07.4/targets/ar71xx/nand/openwrt-19.07.4-ar71xx-nand-wndr3700v4-squashfs-sysupgrade.tar;95;135;230;360.00 MB;1.57 MB
/snapshots/targets/x86/64/openwrt-x86-64-rootfs.tar.gz;91;21;112;268.76 MB;2.40 MB
/releases/19.07.0/targets/x86/64/openwrt-19.07.0-x86-64-combined-ext4.img.gz;91;85;176;469.43 MB;2.67 MB
/snapshots/targets/bcm27xx/bcm2708/openwrt-bcm27xx-bcm2708-rpi-ext4-factory.img.gz;81;477;558;885.85 MB;1.59 MB
/releases/19.07.4/targets/sunxi/cortexa7/openwrt-19.07.4-sunxi-cortexa7-sun8i-h2-plus-orangepi-zero-squashfs-sdcard.img.gz;80;70;150;282.52 MB;1.88 MB
/snapshots/targets/sunxi/cortexa7/openwrt-sunxi-cortexa7-xunlong_orangepi-zero-squashfs-sdcard.img.gz;77;38;115;362.68 MB;3.15 MB
/releases/17.01.0/targets/brcm2708/bcm2710/lede-17.01.0-r3205-59508e3-brcm2708-bcm2710-rpi-3-ext4-sdcard.img.gz;77;2723;2800;765.97 MB;280.13 KB
/releases/19.07.4/targets/sunxi/cortexa7/openwrt-19.07.4-sunxi-cortexa7-sun8i-h3-orangepi-pc-ext4-sdcard.img.gz;74;126;200;382.75 MB;1.91 MB
/releases/19.07.4/targets/octeon/generic/openwrt-19.07.4-octeon-erlite-squashfs-sysupgrade.tar;73;48;121;500.37 MB;4.14 MB
/releases/19.07.4/targets/ar71xx/nand/openwrt-19.07.4-ar71xx-nand-r6100-squashfs-sysupgrade.tar;72;46;118;265.02 MB;2.25 MB
/releases/19.07.0-rc2/targets/x86/64/openwrt-19.07.0-rc2-x86-64-combined-squashfs.img.gz;72;149;221;441.06 MB;2.00 MB
/releases/19.07.4/targets/armvirt/64/openwrt-19.07.4-armvirt-64-default-rootfs.tar.gz;68;5;73;115.93 MB;1.59 MB
/releases/19.07.4/targets/mvebu/cortexa9/omnia-medkit-openwrt-19.07.4-mvebu-cortexa9-cznic_turris-omnia-initramfs.tar.gz;68;4;72;198.14 MB;2.75 MB
/releases/19.07.4/targets/mvebu/cortexa9/openwrt-19.07.4-mvebu-cortexa9-cznic_turris-omnia-sysupgrade.img.gz;65;3;68;287.90 MB;4.23 MB
/releases/19.07.4/targets/sunxi/cortexa53/openwrt-19.07.4-sunxi-cortexa53-sun50i-h5-nanopi-neo-plus2-ext4-sdcard.img.gz;64;79;143;329.84 MB;2.31 MB
/releases/19.07.3/targets/brcm2708/bcm2708/openwrt-19.07.3-brcm2708-bcm2708-rpi-ext4-sysupgrade.img.gz;63;42;105;564.38 MB;5.38 MB
/releases/19.07.4/targets/x86/generic/openwrt-19.07.4-x86-generic-rootfs-squashfs.img.gz;63;47;110;147.07 MB;1.34 MB
/releases/18.06.1/targets/armvirt/32/openwrt-18.06.1-armvirt-32-root.ext4.gz;62;3;65;127.93 MB;1.97 MB
/releases/19.07.4/targets/oxnas/ox820/openwrt-19.07.4-oxnas-ox820-shuttle_kd20-factory.tar.gz;62;15;77;290.32 MB;3.77 MB
/releases/18.06.4/targets/ramips/mt7621/openwrt-18.06.4-ramips-mt7621-mir3g-squashfs-sysupgrade.tar;58;329;387;181.93 MB;481.39 KB
/releases/19.07.4/targets/sunxi/cortexa7/openwrt-19.07.4-sunxi-cortexa7-sun8i-h2-plus-orangepi-r1-ext4-sdcard.img.gz;58;69;127;280.64 MB;2.21 MB
/releases/19.07.4/targets/sunxi/cortexa7/openwrt-19.07.4-sunxi-cortexa7-sun7i-a20-bananapi-squashfs-sdcard.img.gz;56;22;78;191.10 MB;2.45 MB
/snapshots/targets/rockchip/armv8/openwrt-rockchip-armv8-pine64_rockpro64-ext4-sysupgrade.img.gz;56;37;93;325.83 MB;3.50 MB
/releases/18.06.8/targets/x86/64/openwrt-18.06.8-x86-64-combined-squashfs.img.gz;55;112;167;234.56 MB;1.40 MB
/snapshots/targets/x86/generic/openwrt-x86-generic-rootfs.tar.gz;55;0;55;144.55 MB;2.63 MB
/releases/19.07.4/targets/sunxi/cortexa7/openwrt-19.07.4-sunxi-cortexa7-sun8i-h2-plus-orangepi-zero-ext4-sdcard.img.gz;54;96;150;201.19 MB;1.34 MB
/releases/19.07.4/targets/x86/geode/openwrt-19.07.4-x86-geode-combined-squashfs.img.gz;54;20;74;278.61 MB;3.77 MB
/snapshots/targets/x86/64/openwrt-x86-64-generic-ext4-rootfs.img.gz;53;18;71;188.18 MB;2.65 MB
/releases/19.07.4/targets/armvirt/64/openwrt-19.07.4-armvirt-64-root.ext4.gz;52;2;54;94.88 MB;1.76 MB
/releases/19.07.4/targets/armvirt/32/openwrt-19.07.4-armvirt-32-default-rootfs.tar.gz;52;110;162;68.43 MB;432.52 KB
/releases/18.06.4/targets/x86/generic/openwrt-18.06.4-x86-generic-combined-squashfs.img.gz;52;112;164;321.05 MB;1.96 MB
/releases/19.07.4/targets/mvebu/cortexa53/openwrt-19.07.4-mvebu-cortexa53-globalscale_espressobin-v7-emmc-ext4-sdcard.img.gz;50;0;50;251.42 MB;5.03 MB
/snapshots/targets/sunxi/cortexa7/openwrt-sunxi-cortexa7-xunlong_orangepi-zero-ext4-sdcard.img.gz;49;23;72;231.04 MB;3.21 MB
/releases/19.07.4/targets/sunxi/cortexa7/openwrt-19.07.4-sunxi-cortexa7-sun8i-h3-orangepi-one-ext4-sdcard.img.gz;48;63;111;186.13 MB;1.68 MB
/releases/18.06.8/targets/x86/64/openwrt-18.06.8-x86-64-generic-rootfs.tar.gz;47;9;56;112.02 MB;2.00 MB
/releases/18.06.2/targets/x86/64/openwrt-18.06.2-x86-64-combined-ext4.img.gz;47;70;117;229.28 MB;1.96 MB
/releases/19.07.4/targets/apm821xx/sata/openwrt-19.07.4-apm821xx-sata-wd_mybooklive-ext4-sysupgrade.img.gz;47;12;59;202.17 MB;3.43 MB
/releases/19.07.4/targets/sunxi/cortexa53/openwrt-19.07.4-sunxi-cortexa53-sun50i-h5-orangepi-zero-plus-ext4-sdcard.img.gz;46;87;133;256.24 MB;1.93 MB
/snapshots/targets/bcm27xx/bcm2710/openwrt-bcm27xx-bcm2710-rpi-3-squashfs-factory.img.gz;46;10;56;566.11 MB;10.11 MB
/releases/19.07.4/targets/gemini/generic/openwrt-19.07.4-gemini-raidsonic_ib-4220-b-ext4-factory.bin.gz;46;4;50;271.61 MB;5.43 MB
/releases/17.01.4/targets/x86/64/lede-17.01.4-x86-64-combined-ext4.img.gz;46;19;65;176.43 MB;2.71 MB
/snapshots/targets/bcm27xx/bcm2709/openwrt-bcm27xx-bcm2709-rpi-2-ext4-factory.img.gz;46;416;462;571.56 MB;1.24 MB
/snapshots/targets/mediatek/mt7623/openwrt-mediatek-mt7623-bpi_bananapi-r2-squashfs-img.gz;46;10;56;202.85 MB;3.62 MB
/snapshots/targets/sunxi/cortexa7/openwrt-sunxi-cortexa7-friendlyarm_nanopi-r1-squashfs-sdcard.img.gz;45;44;89;248.35 MB;2.79 MB
/releases/19.07.0/targets/sunxi/cortexa7/openwrt-19.07.0-sunxi-cortexa7-sun8i-h2-plus-orangepi-zero-ext4-sdcard.img.gz;45;59;104;229.62 MB;2.21 MB
/releases/18.06.1/targets/brcm2708/bcm2710/openwrt-18.06.1-brcm2708-bcm2710-rpi-3-ext4-factory.img.gz;45;519;564;372.31 MB;675.96 KB
/releases/19.07.4/targets/sunxi/cortexa8/openwrt-19.07.4-sunxi-cortexa8-sun4i-a10-cubieboard-squashfs-sdcard.img.gz;44;376;420;173.25 MB;422.41 KB
/snapshots/targets/x86/64/openwrt-x86-64-generic-squashfs-rootfs.img.gz;44;8;52;115.17 MB;2.21 MB
/releases/19.07.4/targets/sunxi/cortexa7/openwrt-19.07.4-sunxi-cortexa7-sun8i-h3-nanopi-neo-ext4-sdcard.img.gz;44;36;80;184.14 MB;2.30 MB
/releases/19.07.4/targets/mediatek/mt7623/openwrt-19.07.4-mediatek-mt7623-7623a-unielec-u7623-02-emmc-512m-squashfs-sysupgrade-emmc.bin.gz;44;21;65;123.68 MB;1.90 MB
/releases/19.07.4/targets/oxnas/ox820/openwrt-19.07.4-oxnas-ox820-shuttle_kd20-squashfs-sysupgrade.tar;43;12;55;175.06 MB;3.18 MB
/releases/19.07.4/targets/omap/generic/openwrt-19.07.4-omap-ti_am335x-bone-black-squashfs-sdcard.img.gz;43;9;52;155.45 MB;2.99 MB
/releases/19.07.4/targets/sunxi/cortexa7/openwrt-19.07.4-sunxi-cortexa7-sun7i-a20-lamobo-r1-ext4-sdcard.img.gz;42;60;102;209.21 MB;2.05 MB
/releases/19.07.4/targets/oxnas/ox820/openwrt-19.07.4-oxnas-ox820-mitrastar_stg-212-squashfs-sysupgrade.tar;42;9;51;168.25 MB;3.30 MB
/releases/17.01.0/targets/x86/64/lede-17.01.0-r3205-59508e3-x86-64-combined-ext4.img.gz;42;26;68;194.86 MB;2.87 MB
/releases/19.07.2/targets/x86/64/openwrt-19.07.2-x86-64-generic-rootfs.tar.gz;42;0;42;143.69 MB;3.42 MB
/snapshots/targets/bcm27xx/bcm2708/openwrt-bcm27xx-bcm2708-rpi-squashfs-factory.img.gz;41;80;121;424.86 MB;3.51 MB
/releases/18.06.8/targets/x86/generic/openwrt-18.06.8-x86-generic-combined-ext4.img.gz;40;125;165;230.65 MB;1.40 MB
/releases/19.07.4/targets/mvebu/cortexa53/openwrt-19.07.4-mvebu-cortexa53-globalscale_espressobin-v7-ext4-sdcard.img.gz;40;0;40;187.13 MB;4.68 MB
/releases/19.07.4/targets/sunxi/cortexa7/openwrt-19.07.4-sunxi-cortexa7-sun7i-a20-bananapro-squashfs-sdcard.img.gz;40;29;69;161.50 MB;2.34 MB
/releases/19.07.4/targets/armvirt/32/openwrt-19.07.4-armvirt-32-root.squashfs.gz;39;107;146;34.24 MB;240.16 KB
/releases/18.06.8/targets/x86/generic/openwrt-18.06.8-x86-generic-generic-rootfs.tar.gz;39;0;39;93.09 MB;2.39 MB
/snapshots/targets/sunxi/cortexa7/openwrt-sunxi-cortexa7-sinovoip_bananapi-m2-ultra-ext4-sdcard.img.gz;39;27;66;186.26 MB;2.82 MB
/releases/19.07.4/targets/gemini/generic/openwrt-19.07.4-gemini-dlink_dns-313-ext4-factory.bin.gz;38;4;42;232.86 MB;5.54 MB
/snapshots/targets/rockchip/armv8/openwrt-rockchip-armv8-pine64_rockpro64-squashfs-sysupgrade.img.gz;37;67;104;214.44 MB;2.06 MB
/releases/19.07.4/targets/sunxi/cortexa7/openwrt-19.07.4-sunxi-cortexa7-sun8i-h3-orangepi-plus-ext4-sdcard.img.gz;36;89;125;142.47 MB;1.14 MB
/releases/18.06.1/targets/x86/generic/openwrt-18.06.1-x86-generic-combined-ext4.img.gz;36;90;126;213.01 MB;1.69 MB
/releases/19.07.3/targets/x86/generic/openwrt-19.07.3-x86-generic-generic-rootfs.tar.gz;36;0;36;129.95 MB;3.61 MB
/releases/19.07.4/targets/ar71xx/nand/openwrt-19.07.4-ar71xx-nand-rambutan-squashfs-sysupgrade.tar;36;7;43;92.29 MB;2.15 MB
/releases/17.01.4/targets/brcm2708/bcm2708/lede-17.01.4-brcm2708-bcm2708-rpi-ext4-sdcard.img.gz;35;28;63;223.50 MB;3.55 MB
/releases/19.07.4/targets/sunxi/cortexa7/openwrt-19.07.4-sunxi-cortexa7-sun7i-a20-bananapi-ext4-sdcard.img.gz;35;98;133;134.72 MB;1.01 MB
/snapshots/targets/mvebu/cortexa53/openwrt-mvebu-cortexa53-glinet_gl-mv1000-squashfs-sdcard.img.gz;35;4;39;158.19 MB;4.06 MB
/snapshots/targets/bcm27xx/bcm2708/openwrt-bcm27xx-bcm2708-rpi-ext4-sysupgrade.img.gz;34;9;43;327.54 MB;7.62 MB
/releases/19.07.4/targets/octeon/generic/openwrt-19.07.4-octeon-er-squashfs-sysupgrade.tar;34;220;254;194.07 MB;782.39 KB
/releases/17.01.3/targets/ar71xx/nand/lede-17.01.3-ar71xx-nand-vmlinux.lzma;34;0;34;34.39 MB;1.01 MB
/releases/18.06.4/targets/x86/generic/openwrt-18.06.4-x86-generic-combined-ext4.img.gz;34;60;94;118.73 MB;1.26 MB
/snapshots/targets/sunxi/cortexa7/openwrt-sunxi-cortexa7-friendlyarm_nanopi-r1-ext4-sdcard.img.gz;34;3;37;192.67 MB;5.21 MB
/releases/19.07.4/targets/sunxi/cortexa7/openwrt-19.07.4-sunxi-cortexa7-sun8i-h3-orangepi-plus-squashfs-sdcard.img.gz;33;10;43;97.88 MB;2.28 MB
/snapshots/targets/armvirt/32/openwrt-armvirt-32-rootfs-ext4.img.gz;33;0;33;69.62 MB;2.11 MB
/releases/19.07.4/targets/x86/legacy/openwrt-19.07.4-x86-legacy-rootfs-ext4.img.gz;33;4;37;64.61 MB;1.75 MB
/releases/19.07.4/targets/ar71xx/nand/openwrt-19.07.4-ar71xx-nand-nbg6716-squashfs-sysupgrade.tar;33;31;64;120.36 MB;1.88 MB
/releases/19.07.2/targets/x86/generic/openwrt-19.07.2-x86-generic-generic-rootfs.tar.gz;33;0;33;115.31 MB;3.49 MB
/releases/18.06.8/targets/mvebu/cortexa53/openwrt-18.06.8-mvebu-cortexa53-globalscale-espressobin-ext4-sdcard.img.gz;32;0;32;154.47 MB;4.83 MB
/releases/18.06.4/targets/x86/64/openwrt-18.06.4-x86-64-generic-rootfs.tar.gz;32;0;32;84.04 MB;2.63 MB
/snapshots/targets/sunxi/cortexa53/openwrt-sunxi-cortexa53-pine64_pine64-plus-squashfs-sdcard.img.gz;32;7;39;199.63 MB;5.12 MB
/releases/18.06.1/targets/brcm2708/bcm2709/openwrt-18.06.1-brcm2708-bcm2709-rpi-2-ext4-factory.img.gz;32;77;109;196.88 MB;1.81 MB
/releases/19.07.4/targets/sunxi/cortexa53/openwrt-19.07.4-sunxi-cortexa53-sun50i-h5-nanopi-neo2-ext4-sdcard.img.gz;32;36;68;126.84 MB;1.87 MB
/snapshots/targets/sunxi/cortexa7/openwrt-sunxi-cortexa7-lamobo_lamobo-r1-ext4-sdcard.img.gz;32;2;34;176.62 MB;5.19 MB
/snapshots/targets/x86/generic/openwrt-x86-generic-generic-ext4-combined.img.gz;32;32;64;227.64 MB;3.56 MB
/releases/18.06.5/targets/x86/64/openwrt-18.06.5-x86-64-combined-ext4.img.gz;32;25;57;163.99 MB;2.88 MB
/releases/19.07.4/targets/oxnas/ox820/openwrt-19.07.4-oxnas-ox820-cloudengines_pogoplugpro-squashfs-sysupgrade.tar;32;143;175;110.37 MB;645.81 KB
/snapshots/targets/armvirt/64/openwrt-armvirt-64-rootfs-ext4.img.gz;32;4;36;83.43 MB;2.32 MB
/snapshots/targets/gemini/generic/openwrt-gemini-dlink_dns-313-ext4-factory.bin.gz;31;0;31;197.97 MB;6.39 MB
/releases/18.06.2/targets/ramips/mt7621/openwrt-18.06.2-ramips-mt7621-mir3g-squashfs-sysupgrade.tar;31;83;114;96.42 MB;866.10 KB
/snapshots/targets/x86/generic/openwrt-x86-generic-generic-ext4-combined-efi.img.gz;31;98;129;221.84 MB;1.72 MB
/snapshots/targets/mvebu/cortexa9/openwrt-mvebu-cortexa9-cznic_turris-omnia-sysupgrade.img.gz;31;5;36;134.68 MB;3.74 MB
/releases/19.07.4/targets/brcm2708/bcm2709/openwrt-19.07.4-brcm2708-bcm2709-rpi-2-squashfs-factory.img.gz;31;51;82;233.69 MB;2.85 MB
/releases/17.01.0/targets/ar71xx/nand/lede-17.01.0-r3205-59508e3-ar71xx-nand-vmlinux.lzma;31;0;31;22.06 MB;728.64 KB
/releases/19.07.4/targets/mvebu/cortexa9/openwrt-19.07.4-mvebu-cortexa9-solidrun_clearfog-pro-a1-squashfs-sdcard.img.gz;31;0;31;82.25 MB;2.65 MB
/releases/19.07.4/targets/sunxi/cortexa7/openwrt-19.07.4-sunxi-cortexa7-sun7i-a20-cubieboard2-squashfs-sdcard.img.gz;31;23;54;105.49 MB;1.95 MB
/snapshots/targets/ath25/generic/openwrt-ath25-generic-kernel.lzma;30;0;30;24.03 MB;820.08 KB
/releases/18.06.7/targets/x86/generic/openwrt-18.06.7-x86-generic-generic-rootfs.tar.gz;30;0;30;76.57 MB;2.55 MB
/snapshots/targets/mvebu/cortexa9/omnia-medkit-openwrt-mvebu-cortexa9-cznic_turris-omnia-initramfs.tar.gz;30;3;33;90.01 MB;2.73 MB
/releases/18.06.0/targets/x86/64/openwrt-18.06.0-x86-64-combined-ext4.img.gz;30;48;78;137.32 MB;1.76 MB
/releases/18.06.0-rc2/targets/brcm2708/bcm2710/openwrt-18.06.0-rc2-brcm2708-bcm2710-rpi-3-ext4-sdcard.img.gz;29;142;171;191.16 MB;1.12 MB
/releases/19.07.4/targets/sunxi/cortexa53/openwrt-19.07.4-sunxi-cortexa53-sun50i-a64-pine64-plus-squashfs-sdcard.img.gz;29;19;48;77.62 MB;1.62 MB
/releases/17.01.5/targets/x86/generic/lede-17.01.5-x86-generic-generic-rootfs.tar.gz;29;0;29;68.29 MB;2.35 MB
/releases/19.07.4/targets/sunxi/cortexa7/openwrt-19.07.4-sunxi-cortexa7-sun7i-a20-pcduino3-squashfs-sdcard.img.gz;29;77;106;85.83 MB;829.17 KB
/releases/19.07.1/targets/x86/generic/openwrt-19.07.1-x86-generic-generic-rootfs.tar.gz;29;2;31;96.68 MB;3.12 MB
/releases/18.06.2/targets/x86/generic/openwrt-18.06.2-x86-generic-generic-rootfs.tar.gz;29;0;29;74.06 MB;2.55 MB
/snapshots/targets/mediatek/mt7623/openwrt-mediatek-mt7623-unielec_u7623-emmc-squashfs-img.gz;29;0;29;113.23 MB;3.90 MB
/snapshots/targets/sunxi/cortexa7/openwrt-sunxi-cortexa7-xunlong_orangepi-r1-ext4-sdcard.img.gz;29;32;61;148.39 MB;2.43 MB
/releases/19.07.4/targets/sunxi/cortexa53/openwrt-19.07.4-sunxi-cortexa53-sun50i-a64-pine64-plus-ext4-sdcard.img.gz;29;61;90;133.24 MB;1.48 MB
/releases/19.07.0/targets/x86/generic/openwrt-19.07.0-x86-generic-generic-rootfs.tar.gz;29;0;29;103.81 MB;3.58 MB
/releases/19.07.4/targets/brcm2708/bcm2708/openwrt-19.07.4-brcm2708-bcm2708-rpi-squashfs-factory.img.gz;29;105;134;182.66 MB;1.36 MB
/snapshots/targets/sunxi/cortexa53/openwrt-sunxi-cortexa53-pine64_pine64-plus-ext4-sdcard.img.gz;28;2;30;160.68 MB;5.36 MB
/snapshots/targets/oxnas/ox820/openwrt-oxnas-ox820-shuttle_kd20-factory.tar.gz;28;2;30;150.13 MB;5.00 MB
/releases/19.07.4/targets/sunxi/cortexa7/openwrt-19.07.4-sunxi-cortexa7-sun8i-h3-bananapi-m2-plus-squashfs-sdcard.img.gz;28;1;29;102.70 MB;3.54 MB
/snapshots/targets/gemini/generic/openwrt-gemini-raidsonic_ib-4220-b-ext4-factory.bin.gz;28;2;30;166.72 MB;5.56 MB
/releases/19.07.4/targets/x86/legacy/openwrt-19.07.4-x86-legacy-rootfs-squashfs.img.gz;28;20;48;35.90 MB;765.84 KB
/releases/19.07.4/targets/sunxi/cortexa8/openwrt-19.07.4-sunxi-cortexa8-sun4i-a10-pcduino-squashfs-sdcard.img.gz;28;0;28;68.58 MB;2.45 MB
/releases/19.07.4/targets/sunxi/cortexa7/openwrt-19.07.4-sunxi-cortexa7-sun7i-a20-cubietruck-squashfs-sdcard.img.gz;28;117;145;92.18 MB;651.01 KB
/snapshots/targets/x86/generic/openwrt-x86-generic-generic-squashfs-combined.img.gz;28;2;30;172.34 MB;5.74 MB
/releases/18.06.1/targets/ar71xx/generic/openwrt-18.06.1-ar71xx-generic-vmlinux.lzma;28;0;28;36.75 MB;1.31 MB
/snapshots/targets/bcm27xx/bcm2709/openwrt-bcm27xx-bcm2709-rpi-2-ext4-sysupgrade.img.gz;28;12;40;380.74 MB;9.52 MB
/releases/19.07.4/targets/sunxi/cortexa7/openwrt-19.07.4-sunxi-cortexa7-sun7i-a20-olinuxino-micro-squashfs-sdcard.img.gz;28;132;160;79.17 MB;506.66 KB
/releases/19.07.4/targets/sunxi/cortexa53/openwrt-19.07.4-sunxi-cortexa53-sun50i-h5-orangepi-pc2-ext4-sdcard.img.gz;28;88;116;132.24 MB;1.14 MB
/releases/18.06.0/targets/x86/generic/openwrt-18.06.0-x86-generic-generic-rootfs.tar.gz;28;19;47;70.96 MB;1.51 MB
/releases/18.06.1/targets/x86/generic/openwrt-18.06.1-x86-generic-generic-rootfs.tar.gz;27;0;27;71.19 MB;2.64 MB
/releases/19.07.4/targets/x86/legacy/openwrt-19.07.4-x86-legacy-generic-rootfs.tar.gz;27;5;32;44.25 MB;1.38 MB
/releases/19.07.4/targets/sunxi/cortexa53/openwrt-19.07.4-sunxi-cortexa53-sun50i-a64-sopine-baseboard-squashfs-sdcard.img.gz;27;37;64;89.57 MB;1.40 MB
/releases/18.06.8/targets/x86/generic/openwrt-18.06.8-x86-generic-combined-squashfs.img.gz;27;76;103;143.15 MB;1.39 MB
/releases/18.06.6/targets/x86/generic/openwrt-18.06.6-x86-generic-generic-rootfs.tar.gz;27;0;27;71.30 MB;2.64 MB
/releases/19.07.4/targets/sunxi/cortexa7/openwrt-19.07.4-sunxi-cortexa7-sun8i-h3-nanopi-m1-plus-ext4-sdcard.img.gz;27;15;42;110.48 MB;2.63 MB
/releases/19.07.4/targets/brcm2708/bcm2708/openwrt-19.07.4-brcm2708-bcm2708-rpi-squashfs-sysupgrade.img.gz;27;35;62;171.66 MB;2.77 MB
/releases/19.07.4/targets/sunxi/cortexa7/openwrt-19.07.4-sunxi-cortexa7-sun8i-h3-orangepi-pc-plus-ext4-sdcard.img.gz;27;44;71;79.87 MB;1.12 MB
/releases/19.07.4/targets/sunxi/cortexa8/openwrt-19.07.4-sunxi-cortexa8-sun4i-a10-olinuxino-lime-squashfs-sdcard.img.gz;27;0;27;81.96 MB;3.04 MB
/releases/18.06.3/targets/x86/generic/openwrt-18.06.3-x86-generic-generic-rootfs.tar.gz;26;0;26;68.55 MB;2.64 MB
/releases/19.07.4/targets/x86/geode/openwrt-19.07.4-x86-geode-rootfs-ext4.img.gz;26;0;26;69.24 MB;2.66 MB
/releases/18.06.5/targets/x86/generic/openwrt-18.06.5-x86-generic-generic-rootfs.tar.gz;26;0;26;68.64 MB;2.64 MB
/snapshots/targets/mediatek/mt7623/openwrt-mediatek-mt7623-bpi_bananapi-r2-scatter.txt;26;0;26;30.95 KB;1.19 KB
/releases/18.06.4/targets/x86/generic/openwrt-18.06.4-x86-generic-generic-rootfs.tar.gz;26;0;26;68.53 MB;2.64 MB
/snapshots/targets/mvebu/cortexa72/openwrt-mvebu-cortexa72-marvell_macchiatobin-singleshot-squashfs-sdcard.img.gz;26;2;28;126.14 MB;4.50 MB
/releases/19.07.4/targets/x86/geode/openwrt-19.07.4-x86-geode-rootfs-squashfs.img.gz;26;20;46;58.40 MB;1.27 MB
/releases/17.01.4/targets/x86/generic/lede-17.01.4-x86-generic-generic-rootfs.tar.gz;25;0;25;64.99 MB;2.60 MB
/snapshots/targets/x86/generic/openwrt-x86-generic-generic-squashfs-combined-efi.img.gz;25;59;84;158.45 MB;1.89 MB
/snapshots/targets/armvirt/64/openwrt-armvirt-64-default-rootfs.tar.gz;25;0;25;46.46 MB;1.86 MB
/snapshots/targets/mediatek/mt7622/openwrt-mediatek-mt7622-bpi_bananapi-r64-rootdisk-squashfs-sysupgrade-emmc.bin.gz;25;7;32;139.13 MB;4.35 MB
/releases/19.07.4/targets/arc770/generic/openwrt-19.07.4-arc770-generic-Default-sdcard-vfat-ext4.img.gz;25;63;88;93.72 MB;1.07 MB
/snapshots/targets/armvirt/32/openwrt-armvirt-32-rootfs-squashfs.img.gz;25;0;25;37.84 MB;1.51 MB
/releases/19.07.4/targets/armvirt/64/openwrt-19.07.4-armvirt-64-root.squashfs.gz;24;8;32;24.25 MB;775.92 KB
/releases/19.07.3/targets/x86/64/openwrt-19.07.3-x86-64-combined-squashfs.img.gz;24;34;58;128.06 MB;2.21 MB
/releases/17.01.3/targets/ar71xx/mikrotik/lede-17.01.3-ar71xx-mikrotik-vmlinux-initramfs.lzma;24;0;24;68.84 MB;2.87 MB
/releases/19.07.4/targets/mvebu/cortexa9/openwrt-19.07.4-mvebu-cortexa9-solidrun_clearfog-base-a1-squashfs-sdcard.img.gz;24;14;38;74.57 MB;1.96 MB
/releases/19.07.2/targets/x86/generic/openwrt-19.07.2-x86-generic-combined-ext4.img.gz;24;11;35;159.80 MB;4.57 MB
/releases/17.01.6/targets/x86/generic/lede-17.01.6-x86-generic-generic-rootfs.tar.gz;24;0;24;62.45 MB;2.60 MB
/releases/19.07.4/targets/ar71xx/nand/openwrt-19.07.4-ar71xx-nand-z1-squashfs-sysupgrade.tar;24;7;31;93.99 MB;3.03 MB
/releases/18.06.1/targets/ar71xx/nand/openwrt-18.06.1-ar71xx-nand-vmlinux.lzma;24;0;24;4.95 MB;211.12 KB
/releases/19.07.4/targets/mvebu/cortexa53/openwrt-19.07.4-mvebu-cortexa53-globalscale_espressobin-squashfs-sdcard.img.gz;24;2;26;79.50 MB;3.06 MB
/snapshots/targets/mvebu/cortexa53/openwrt-mvebu-cortexa53-methode_udpu-firmware.tgz;24;0;24;257.68 MB;10.74 MB
/snapshots/targets/mvebu/cortexa53/openwrt-mvebu-cortexa53-globalscale_espressobin-ext4-sdcard.img.gz;24;0;24;102.30 MB;4.26 MB
/releases/19.07.4/targets/sunxi/cortexa53/openwrt-19.07.4-sunxi-cortexa53-sun50i-h5-orangepi-zero-plus-squashfs-sdcard.img.gz;24;37;61;84.65 MB;1.39 MB
/snapshots/targets/rockchip/armv8/openwrt-rockchip-armv8-radxa_rock-pi-4-ext4-sysupgrade.img.gz;24;38;62;152.53 MB;2.46 MB
/releases/19.07.4/targets/oxnas/ox820/openwrt-19.07.4-oxnas-ox820-cloudengines_pogoplugpro-ubifs-sysupgrade.tar;24;149;173;97.52 MB;577.21 KB
/releases/19.07.4/targets/armvirt/32/openwrt-19.07.4-armvirt-32-root.ext4.gz;24;0;24;33.71 MB;1.40 MB
/snapshots/targets/bcm27xx/bcm2710/openwrt-bcm27xx-bcm2710-rpi-3-squashfs-sysupgrade.img.gz;24;6;30;197.95 MB;6.60 MB
/releases/19.07.4/targets/sunxi/cortexa7/openwrt-19.07.4-sunxi-cortexa7-sun8i-h3-orangepi-pc-squashfs-sdcard.img.gz;23;0;23;67.25 MB;2.92 MB
/releases/19.07.4/targets/zynq/generic/openwrt-19.07.4-zynq-avnet_zynq-zed-squashfs-sdcard.img.gz;23;1;24;88.40 MB;3.68 MB
/releases/19.07.4/targets/sunxi/cortexa7/openwrt-19.07.4-sunxi-cortexa7-sun7i-a20-pcduino3-ext4-sdcard.img.gz;23;29;52;64.89 MB;1.25 MB
/releases/18.06.9/targets/x86/64/openwrt-18.06.9-x86-64-combined-ext4.img.gz;23;62;85;127.83 MB;1.50 MB
/releases/18.06.4/targets/x86/64/openwrt-18.06.4-x86-64-combined-squashfs.img.gz;23;138;161;83.95 MB;533.95 KB
/releases/19.07.4/targets/sunxi/cortexa8/openwrt-19.07.4-sunxi-cortexa8-sun5i-a13-olimex-som-squashfs-sdcard.img.gz;23;0;23;58.64 MB;2.55 MB
/releases/19.07.4/targets/mvebu/cortexa53/openwrt-19.07.4-mvebu-cortexa53-globalscale_espressobin-emmc-ext4-sdcard.img.gz;23;0;23;69.30 MB;3.01 MB
/releases/19.07.3/targets/brcm2708/bcm2710/openwrt-19.07.3-brcm2708-bcm2710-rpi-3-ext4-factory.img.gz;23;14;37;176.33 MB;4.77 MB
/releases/19.07.4/targets/ar71xx/nand/openwrt-19.07.4-ar71xx-nand-hiveap-121-squashfs-sysupgrade.tar;23;24;47;51.05 MB;1.09 MB
/releases/19.07.4/targets/ar71xx/nand/openwrt-19.07.4-ar71xx-nand-vmlinux.lzma;23;0;23;12.82 MB;570.95 KB
/releases/19.07.4/targets/brcm2708/bcm2709/openwrt-19.07.4-brcm2708-bcm2709-rpi-2-squashfs-sysupgrade.img.gz;23;37;60;96.28 MB;1.60 MB
/releases/18.06.8/targets/brcm2708/bcm2710/openwrt-18.06.8-brcm2708-bcm2710-rpi-3-ext4-factory.img.gz;23;4;27;119.28 MB;4.42 MB
/snapshots/targets/x86/generic/openwrt-x86-generic-generic-ext4-rootfs.img.gz;22;0;22;56.87 MB;2.58 MB
/releases/19.07.4/targets/sunxi/cortexa7/openwrt-19.07.4-sunxi-cortexa7-sun7i-a20-olinuxino-lime-squashfs-sdcard.img.gz;22;0;22;60.13 MB;2.73 MB
/releases/19.07.4/targets/gemini/generic/openwrt-19.07.4-gemini-dlink_dir-685-ext4-factory.bin.gz;22;109;131;85.08 MB;665.03 KB
/releases/19.07.0/targets/x86/64/openwrt-19.07.0-x86-64-combined-squashfs.img.gz;22;65;87;111.53 MB;1.28 MB
/snapshots/targets/sunxi/cortexa7/openwrt-sunxi-cortexa7-lamobo_lamobo-r1-squashfs-sdcard.img.gz;22;0;22;93.74 MB;4.26 MB
/releases/19.07.4/targets/apm821xx/sata/openwrt-19.07.4-apm821xx-sata-wd_mybooklive-squashfs-sysupgrade.img.gz;22;0;22;45.75 MB;2.08 MB
/releases/17.01.1/targets/ar71xx/nand/lede-17.01.1-ar71xx-nand-vmlinux.lzma;22;0;22;17.54 MB;816.62 KB
/snapshots/targets/armvirt/32/openwrt-armvirt-32-default-rootfs.tar.gz;22;16;38;37.07 MB;998.93 KB
/releases/19.07.4/targets/ar71xx/mikrotik/openwrt-19.07.4-ar71xx-mikrotik-vmlinux-initramfs.lzma;22;0;22;29.48 MB;1.34 MB
/releases/17.01.4/targets/ar71xx/mikrotik/lede-17.01.4-ar71xx-mikrotik-vmlinux-initramfs.lzma;22;0;22;52.86 MB;2.40 MB
/releases/19.07.4/targets/sunxi/cortexa7/openwrt-19.07.4-sunxi-cortexa7-sun7i-a20-cubieboard2-ext4-sdcard.img.gz;22;35;57;64.28 MB;1.13 MB
/releases/19.07.4/targets/sunxi/cortexa7/openwrt-19.07.4-sunxi-cortexa7-sun7i-a20-bananapro-ext4-sdcard.img.gz;22;52;74;82.75 MB;1.12 MB
/releases/19.07.4/targets/sunxi/cortexa7/openwrt-19.07.4-sunxi-cortexa7-sun8i-h2-plus-orangepi-r1-squashfs-sdcard.img.gz;22;0;22;48.80 MB;2.22 MB
/releases/19.07.4/targets/omap/generic/openwrt-19.07.4-omap-ti_am335x-bone-black-ext4-sdcard.img.gz;21;0;21;76.37 MB;3.64 MB
/releases/19.07.4/targets/sunxi/cortexa8/openwrt-19.07.4-sunxi-cortexa8-sun4i-a10-cubieboard-ext4-sdcard.img.gz;21;0;21;47.56 MB;2.26 MB
/releases/19.07.4/targets/ar71xx/mikrotik/openwrt-19.07.4-ar71xx-mikrotik-vmlinux.lzma;21;0;21;12.43 MB;606.32 KB
/releases/19.07.4/targets/at91/sama5/openwrt-19.07.4-at91-sama5-at91-sama5d3_xplained-ext4-sdcard.img.gz;21;14;35;60.45 MB;1.73 MB
/snapshots/targets/octeon/generic/openwrt-octeon-itus_shield-router-squashfs-sysupgrade.tar;21;7;28;160.29 MB;5.72 MB
/releases/19.07.4/targets/mvebu/cortexa53/openwrt-19.07.4-mvebu-cortexa53-globalscale_espressobin-emmc-squashfs-sdcard.img.gz;21;0;21;57.77 MB;2.75 MB
/releases/19.07.4/targets/mvebu/cortexa53/openwrt-19.07.4-mvebu-cortexa53-marvell_armada-3720-db-squashfs-sdcard.img.gz;21;0;21;47.04 MB;2.24 MB
/snapshots/targets/mvebu/cortexa53/openwrt-mvebu-cortexa53-glinet_gl-mv1000-ext4-sdcard.img.gz;21;0;21;77.79 MB;3.70 MB
/releases/19.07.4/targets/mvebu/cortexa72/openwrt-19.07.4-mvebu-cortexa72-marvell_armada8040-db-squashfs-sdcard.img.gz;21;4;25;59.79 MB;2.39 MB
/snapshots/targets/sunxi/cortexa7/openwrt-sunxi-cortexa7-friendlyarm_nanopi-neo-air-ext4-sdcard.img.gz;21;0;21;105.16 MB;5.01 MB
/releases/19.07.4/targets/omap/generic/openwrt-19.07.4-omap-rootfs.tar.gz;21;0;21;20.81 MB;1014.74 KB
/snapshots/targets/gemini/generic/openwrt-gemini-itian_sq201-ext4-factory.bin.gz;21;0;21;122.90 MB;5.85 MB
/snapshots/targets/omap/generic/openwrt-omap-ti_am335x-bone-black-squashfs-sdcard.img.gz;21;0;21;88.86 MB;4.23 MB
/releases/19.07.4/targets/mvebu/cortexa53/openwrt-19.07.4-mvebu-cortexa53-globalscale_espressobin-v7-squashfs-sdcard.img.gz;21;0;21;57.38 MB;2.73 MB
/releases/19.07.4/targets/tegra/generic/openwrt-19.07.4-tegra-compulab_trimslice-squashfs-sdcard.img.gz;21;0;21;43.95 MB;2.09 MB
/releases/17.01.4/targets/ar71xx/mikrotik/lede-17.01.4-ar71xx-mikrotik-vmlinux.lzma;21;0;21;22.22 MB;1.06 MB
/snapshots/targets/mvebu/cortexa72/openwrt-mvebu-cortexa72-marvell_macchiatobin-doubleshot-squashfs-sdcard.img.gz;21;0;21;95.49 MB;4.55 MB
/snapshots/targets/sunxi/cortexa53/openwrt-sunxi-cortexa53-xunlong_orangepi-pc2-ext4-sdcard.img.gz;21;0;21;107.06 MB;5.10 MB
/releases/18.06.8/targets/ar71xx/mikrotik/openwrt-18.06.8-ar71xx-mikrotik-vmlinux.lzma;21;0;21;10.51 MB;512.50 KB
/releases/19.07.4/targets/sunxi/cortexa7/openwrt-19.07.4-sunxi-cortexa7-sun6i-a31-m9-squashfs-sdcard.img.gz;21;4;25;52.85 MB;2.11 MB
/releases/18.06.8/targets/x86/legacy/openwrt-18.06.8-x86-legacy-combined-ext4.img.gz;21;0;21;101.70 MB;4.84 MB
/releases/17.01.1/targets/x86/64/lede-17.01.1-x86-64-combined-ext4.img.gz;21;4;25;90.42 MB;3.62 MB
/releases/18.06.8/targets/ramips/mt7621/openwrt-18.06.8-ramips-mt7621-mir3g-squashfs-sysupgrade.tar;21;49;70;55.27 MB;808.48 KB
/releases/18.06.7/targets/x86/64/openwrt-18.06.7-x86-64-combined-ext4.img.gz;20;13;33;97.68 MB;2.96 MB
/releases/19.07.4/targets/oxnas/ox820/openwrt-19.07.4-oxnas-ox820-cloudengines_pogoplug-series-3-ubifs-sysupgrade.tar;20;32;52;78.52 MB;1.51 MB
/releases/17.01.0/targets/x86/generic/lede-17.01.0-r3205-59508e3-x86-generic-combined-ext4.img.gz;20;50;70;124.71 MB;1.78 MB
/releases/19.07.0/targets/sunxi/cortexa7/openwrt-19.07.0-sunxi-cortexa7-sun8i-h2-plus-orangepi-zero-squashfs-sdcard.img.gz;20;8;28;91.06 MB;3.25 MB
/releases/19.07.4/targets/mvebu/cortexa53/openwrt-19.07.4-mvebu-cortexa53-globalscale_espressobin-ext4-sdcard.img.gz;20;0;20;60.95 MB;3.05 MB
/releases/19.07.4/targets/brcm63xx/smp/openwrt-19.07.4-brcm63xx-smp-livebox-vmlinux.gz;20;0;20;18.22 MB;932.69 KB
/releases/19.07.4/targets/mvebu/cortexa53/openwrt-19.07.4-mvebu-cortexa53-marvell_armada-3720-db-ext4-sdcard.img.gz;20;0;20;46.45 MB;2.32 MB
/snapshots/targets/oxnas/ox820/openwrt-oxnas-ox820-cloudengines_pogoplugpro-squashfs-sysupgrade.tar;20;74;94;94.14 MB;1.00 MB
/releases/19.07.4/targets/sunxi/cortexa8/openwrt-19.07.4-sunxi-cortexa8-sun5i-a13-olinuxino-squashfs-sdcard.img.gz;20;0;20;52.34 MB;2.62 MB
/snapshots/targets/x86/legacy/openwrt-x86-legacy-generic-ext4-combined-efi.img.gz;20;19;39;111.87 MB;2.87 MB
/releases/19.07.4/targets/tegra/generic/openwrt-19.07.4-tegra-compulab_trimslice-ext4-sdcard.img.gz;20;7;27;52.49 MB;1.94 MB
/releases/19.07.4/targets/sunxi/cortexa7/openwrt-19.07.4-sunxi-cortexa7-sun8i-h3-orangepi-pc-plus-squashfs-sdcard.img.gz;20;0;20;48.12 MB;2.41 MB
/releases/19.07.2/targets/armvirt/64/openwrt-19.07.2-armvirt-64-default-rootfs.tar.gz;20;12;32;32.32 MB;1.01 MB
/releases/18.06.0-rc2/targets/ar71xx/mikrotik/openwrt-18.06.0-rc2-ar71xx-mikrotik-vmlinux-initramfs.lzma;20;0;20;49.01 MB;2.45 MB
/releases/19.07.4/targets/sunxi/cortexa8/openwrt-19.07.4-sunxi-cortexa8-sun4i-a10-olinuxino-lime-ext4-sdcard.img.gz;20;0;20;52.10 MB;2.60 MB
/snapshots/targets/omap/generic/openwrt-omap-ti_am335x-evm-ext4-sdcard.img.gz;20;0;20;93.54 MB;4.68 MB
/snapshots/targets/x86/legacy/openwrt-x86-legacy-generic-ext4-combined.img.gz;20;43;63;137.32 MB;2.18 MB
/snapshots/targets/bcm27xx/bcm2708/openwrt-bcm27xx-bcm2708-rpi-squashfs-sysupgrade.img.gz;20;0;20;185.16 MB;9.26 MB
/releases/19.07.4/targets/sunxi/cortexa7/openwrt-19.07.4-sunxi-cortexa7-sun8i-h3-orangepi-2-ext4-sdcard.img.gz;20;0;20;62.26 MB;3.11 MB
/releases/19.07.4/targets/zynq/generic/openwrt-19.07.4-zynq-digilent_zynq-zybo-squashfs-sdcard.img.gz;20;0;20;58.92 MB;2.95 MB
/releases/17.01.3/targets/ar71xx/generic/lede-17.01.3-ar71xx-generic-vmlinux.lzma;20;0;20;21.69 MB;1.08 MB
/snapshots/targets/rockchip/armv8/openwrt-rockchip-armv8-radxa_rock-pi-4-squashfs-sysupgrade.img.gz;20;0;20;111.13 MB;5.56 MB
/snapshots/targets/armvirt/64/openwrt-armvirt-64-rootfs-squashfs.img.gz;20;0;20;34.48 MB;1.72 MB
/releases/19.07.4/targets/zynq/generic/openwrt-19.07.4-zynq-xlnx_zynq-zc702-squashfs-sdcard.img.gz;20;15;35;51.58 MB;1.47 MB
/releases/19.07.4/targets/ath25/generic/openwrt-19.07.4-ath25-generic-kernel.lzma;20;0;20;12.48 MB;639.11 KB
/snapshots/targets/mediatek/mt7623/openwrt-mediatek-mt7623-unielec_u7623-emmc-scatter.txt;19;0;19;20.82 KB;1.10 KB
/snapshots/targets/zynq/generic/openwrt-zynq-xlnx_zynq-zc702-squashfs-sdcard.img.gz;19;0;19;89.41 MB;4.71 MB
/snapshots/targets/mediatek/mt7623/openwrt-mediatek-mt7623-unielec_u7623-02-emmc-512m-legacy-squashfs-sysupgrade-emmc.bin.gz;19;0;19;63.53 MB;3.34 MB
/releases/17.01.2/targets/ar71xx/mikrotik/lede-17.01.2-ar71xx-mikrotik-vmlinux-initramfs.lzma;19;0;19;37.78 MB;1.99 MB
/releases/19.07.4/targets/apm821xx/sata/openwrt-19.07.4-apm821xx-sata-wd_mybooklive-squashfs-factory.img.gz;19;0;19;39.10 MB;2.06 MB
/releases/18.06.8/targets/x86/64/openwrt-18.06.8-x86-64-rootfs-ext4.img.gz;19;1;20;36.05 MB;1.80 MB
/snapshots/targets/x86/geode/openwrt-x86-geode-geos-squashfs-rootfs.img.gz;19;0;19;29.35 MB;1.54 MB
/snapshots/targets/omap/generic/openwrt-omap-ti_am335x-bone-black-ext4-sdcard.img.gz;19;20;39;82.67 MB;2.12 MB
/snapshots/targets/mvebu/cortexa9/openwrt-mvebu-cortexa9-solidrun_clearfog-base-a1-squashfs-sdcard.img.gz;19;2;21;62.38 MB;2.97 MB
/releases/19.07.4/targets/sunxi/cortexa53/openwrt-19.07.4-sunxi-cortexa53-sun50i-h5-orangepi-pc2-squashfs-sdcard.img.gz;19;16;35;51.16 MB;1.46 MB
/releases/19.07.4/targets/layerscape/armv8_64b/openwrt-19.07.4-layerscape-armv8_64b-ls1012afrwy-ext4-firmware.bin.gz;19;0;19;3.18 MB;171.18 KB
/releases/19.07.4/targets/oxnas/ox820/openwrt-19.07.4-oxnas-ox820-akitio_mycloud-squashfs-sysupgrade.tar;19;1;20;39.95 MB;2.00 MB
/releases/19.07.4/targets/mvebu/cortexa72/openwrt-19.07.4-mvebu-cortexa72-marvell_armada7040-db-ext4-sdcard.img.gz;19;0;19;47.22 MB;2.49 MB
/snapshots/targets/mvebu/cortexa9/openwrt-mvebu-cortexa9-solidrun_clearfog-pro-a1-squashfs-sdcard.img.gz;19;0;19;53.56 MB;2.82 MB
/snapshots/targets/apm821xx/sata/openwrt-apm821xx-sata-wd_mybooklive-ext4-factory.img.gz;19;0;19;87.98 MB;4.63 MB
/releases/19.07.4/targets/imx6/generic/openwrt-19.07.4-imx6-rootfs.tar.gz;19;0;19;25.76 MB;1.36 MB
/releases/19.07.4/targets/sunxi/cortexa8/openwrt-19.07.4-sunxi-cortexa8-sun4i-a10-pcduino-ext4-sdcard.img.gz;19;0;19;50.28 MB;2.65 MB
/releases/19.07.4/targets/sunxi/cortexa7/openwrt-19.07.4-sunxi-cortexa7-sun8i-h3-orangepi-one-squashfs-sdcard.img.gz;19;0;19;48.14 MB;2.53 MB
/releases/19.07.4/targets/sunxi/cortexa7/openwrt-19.07.4-sunxi-cortexa7-sun8i-h3-nanopi-neo-squashfs-sdcard.img.gz;19;0;19;43.75 MB;2.30 MB
/snapshots/targets/sunxi/cortexa53/openwrt-sunxi-cortexa53-pine64_sopine-baseboard-squashfs-sdcard.img.gz;19;0;19;89.65 MB;4.72 MB
/releases/19.07.4/targets/mvebu/cortexa53/openwrt-19.07.4-mvebu-cortexa53-globalscale_espressobin-v7-emmc-squashfs-sdcard.img.gz;19;0;19;44.01 MB;2.32 MB
/snapshots/targets/mvebu/cortexa72/openwrt-mvebu-cortexa72-marvell_armada7040-db-squashfs-sdcard.img.gz;19;0;19;60.50 MB;3.18 MB
/releases/19.07.4/targets/sunxi/cortexa7/openwrt-19.07.4-sunxi-cortexa7-sun7i-a20-olinuxino-lime2-ext4-sdcard.img.gz;19;18;37;44.11 MB;1.19 MB
/snapshots/targets/x86/geode/openwrt-x86-geode-generic-squashfs-combined.img.gz;19;0;19;76.42 MB;4.02 MB
/releases/17.01.1/targets/ar71xx/mikrotik/lede-17.01.1-ar71xx-mikrotik-vmlinux.lzma;19;0;19;16.09 MB;867.28 KB
/snapshots/targets/malta/be/openwrt-malta-be-rootfs-ext4.img.gz;19;0;19;47.24 MB;2.49 MB
/snapshots/targets/sunxi/cortexa8/openwrt-sunxi-cortexa8-marsboard_a10-marsboard-ext4-sdcard.img.gz;19;0;19;60.69 MB;3.19 MB
/snapshots/targets/sunxi/cortexa7/openwrt-sunxi-cortexa7-xunlong_orangepi-one-ext4-sdcard.img.gz;19;0;19;47.21 MB;2.48 MB
/releases/19.07.4/targets/archs38/generic/openwrt-19.07.4-archs38-generic-root.ext4.gz;18;0;18;21.61 MB;1.20 MB
/snapshots/targets/sunxi/cortexa53/openwrt-sunxi-cortexa53-olimex_a64-olinuxino-ext4-sdcard.img.gz;18;0;18;96.15 MB;5.34 MB
/snapshots/targets/ath79/nand/openwrt-ath79-nand-8dev_rambutan-squashfs-sysupgrade.tar;18;13;31;37.58 MB;1.21 MB
/releases/18.06.2/targets/armvirt/64/openwrt-18.06.2-armvirt-64-default-rootfs.tar.gz;18;4;22;20.68 MB;962.79 KB
/snapshots/targets/omap/generic/openwrt-omap-ti_omap3-beagle-squashfs-sdcard.img.gz;18;0;18;77.34 MB;4.30 MB
/releases/19.07.4/targets/gemini/generic/openwrt-19.07.4-gemini-dlink_dir-685-ext4-sysupgrade.bin.gz;18;0;18;63.73 MB;3.54 MB
/releases/19.07.4/targets/sunxi/cortexa7/openwrt-19.07.4-sunxi-cortexa7-sun7i-a20-olinuxino-lime-ext4-sdcard.img.gz;18;28;46;46.42 MB;1.01 MB
/releases/18.06.8/targets/brcm2708/bcm2709/openwrt-18.06.8-brcm2708-bcm2709-rpi-2-ext4-factory.img.gz;18;26;44;82.65 MB;1.88 MB
/snapshots/targets/sunxi/cortexa53/openwrt-sunxi-cortexa53-olimex_a64-olinuxino-emmc-ext4-sdcard.img.gz;18;0;18;97.22 MB;5.40 MB
/snapshots/targets/mvebu/cortexa53/openwrt-mvebu-cortexa53-globalscale_espressobin-v7-emmc-squashfs-sdcard.img.gz;18;0;18;79.70 MB;4.43 MB
/releases/19.07.4/targets/at91/sama5/openwrt-19.07.4-at91-sama5-at91-sama5d3_xplained-ext4-zImage.gz;18;0;18;26.89 MB;1.49 MB
/snapshots/targets/sunxi/cortexa53/openwrt-sunxi-cortexa53-olimex_a64-olinuxino-emmc-squashfs-sdcard.img.gz;18;0;18;86.90 MB;4.83 MB
/releases/18.06.1/targets/ramips/mt7621/openwrt-18.06.1-ramips-mt7621-ubnt-erx-squashfs-sysupgrade.tar;18;21;39;42.68 MB;1.09 MB
/releases/19.07.4/targets/sunxi/cortexa7/openwrt-19.07.4-sunxi-cortexa7-sun7i-a20-olinuxino-lime2-squashfs-sdcard.img.gz;18;2;20;45.63 MB;2.28 MB
/releases/19.07.4/targets/sunxi/cortexa8/openwrt-19.07.4-sunxi-cortexa8-sun4i-a10-marsboard-ext4-sdcard.img.gz;18;0;18;35.70 MB;1.98 MB
/releases/19.07.4/targets/sunxi/cortexa7/openwrt-19.07.4-sunxi-cortexa7-sun8i-h3-orangepi-2-squashfs-sdcard.img.gz;18;0;18;38.19 MB;2.12 MB
/releases/19.07.4/targets/sunxi/cortexa53/openwrt-19.07.4-sunxi-cortexa53-sun50i-h5-nanopi-neo-plus2-squashfs-sdcard.img.gz;18;16;34;45.78 MB;1.35 MB
/releases/19.07.4/targets/sunxi/cortexa53/openwrt-19.07.4-sunxi-cortexa53-sun50i-h5-nanopi-neo2-squashfs-sdcard.img.gz;18;16;34;50.60 MB;1.49 MB
/releases/19.07.4/targets/sunxi/cortexa8/openwrt-19.07.4-sunxi-cortexa8-sun5i-a13-olinuxino-ext4-sdcard.img.gz;18;0;18;45.93 MB;2.55 MB
/releases/19.07.4/targets/mxs/generic/openwrt-19.07.4-mxs-duckbill-sdcard.img.gz;18;0;18;69.63 MB;3.87 MB
/releases/18.06.4/targets/armvirt/64/openwrt-18.06.4-armvirt-64-default-rootfs.tar.gz;18;117;135;32.42 MB;245.92 KB
/releases/19.07.4/targets/layerscape/armv8_64b/openwrt-19.07.4-layerscape-armv8_64b-ls1012afrwy-ext4-sdcard.img.gz;18;0;18;66.32 MB;3.68 MB
/releases/19.07.4/targets/at91/sama5/openwrt-19.07.4-at91-sama5-at91-sama5d27_som1_ek-ext4-sdcard.img.gz;18;0;18;42.90 MB;2.38 MB
/releases/19.07.4/targets/sunxi/cortexa7/openwrt-19.07.4-sunxi-cortexa7-sun7i-a20-olinuxino-lime2-emmc-ext4-sdcard.img.gz;18;29;47;47.40 MB;1.01 MB
/releases/19.07.4/targets/mvebu/cortexa72/openwrt-19.07.4-mvebu-cortexa72-marvell_macchiatobin-squashfs-sdcard.img.gz;18;0;18;45.30 MB;2.52 MB
/releases/19.07.4/targets/omap/generic/openwrt-19.07.4-omap-ti_omap3-beagle-ext4-sdcard.img.gz;18;0;18;48.47 MB;2.69 MB
/releases/19.07.4/targets/armvirt/64/openwrt-19.07.4-armvirt-64-rootfs.cpio.gz;18;0;18;200 Bytes;11 Bytes
/snapshots/targets/sunxi/cortexa53/openwrt-sunxi-cortexa53-xunlong_orangepi-pc2-squashfs-sdcard.img.gz;18;0;18;84.95 MB;4.72 MB
/snapshots/targets/mvebu/cortexa53/openwrt-mvebu-cortexa53-globalscale_espressobin-squashfs-sdcard.img.gz;18;0;18;71.92 MB;4.00 MB
/releases/19.07.4/targets/oxnas/ox820/openwrt-19.07.4-oxnas-ox820-cloudengines_pogoplug-series-3-squashfs-sysupgrade.tar;18;37;55;47.97 MB;893.16 KB
/snapshots/targets/x86/legacy/openwrt-x86-legacy-generic-ext4-rootfs.img.gz;18;0;18;29.87 MB;1.66 MB
/releases/19.07.4/targets/ar71xx/tiny/openwrt-19.07.4-ar71xx-tiny-vmlinux.lzma;18;0;18;5.84 MB;332.27 KB
/snapshots/targets/mvebu/cortexa53/openwrt-mvebu-cortexa53-globalscale_espressobin-v7-ext4-sdcard.img.gz;17;0;17;70.34 MB;4.14 MB
/releases/19.07.4/targets/pistachio/generic/openwrt-19.07.4-pistachio-marduk-squashfs-sysupgrade.tar;17;2;19;45.61 MB;2.40 MB
/snapshots/targets/sunxi/cortexa7/openwrt-sunxi-cortexa7-xunlong_orangepi-r1-squashfs-sdcard.img.gz;17;0;17;61.45 MB;3.61 MB
/releases/19.07.0/targets/x86/generic/openwrt-19.07.0-x86-generic-combined-ext4.img.gz;17;61;78;98.34 MB;1.26 MB
/snapshots/targets/sunxi/cortexa53/openwrt-sunxi-cortexa53-xunlong_orangepi-zero-plus-squashfs-sdcard.img.gz;17;0;17;72.40 MB;4.26 MB
/releases/19.07.4/targets/sunxi/cortexa8/openwrt-19.07.4-sunxi-cortexa8-sun5i-a13-olimex-som-ext4-sdcard.img.gz;17;0;17;43.21 MB;2.54 MB
/releases/19.07.4/targets/layerscape/armv8_64b/openwrt-19.07.4-layerscape-armv8_64b-ls1043ardb-sdboot-ext4-sdcard.img.gz;17;0;17;60.37 MB;3.55 MB
/releases/19.07.4/targets/at91/sama5/openwrt-19.07.4-at91-sama5-at91-sama5d3_xplained-ext4-root.ubi.gz;17;0;17;17.60 MB;1.04 MB
/releases/17.01.7/targets/ar71xx/nand/lede-17.01.7-ar71xx-nand-vmlinux.lzma;17;0;17;10.56 MB;636.04 KB
/snapshots/targets/sunxi/cortexa53/openwrt-sunxi-cortexa53-olimex_a64-olinuxino-squashfs-sdcard.img.gz;17;0;17;82.27 MB;4.84 MB
/releases/17.01.0/targets/ath25/generic/lede-17.01.0-r3205-59508e3-ath25-generic-kernel.lzma;17;0;17;9.69 MB;583.38 KB
/snapshots/targets/mvebu/cortexa72/openwrt-mvebu-cortexa72-marvell_macchiatobin-doubleshot-ext4-sdcard.img.gz;17;0;17;67.98 MB;4.00 MB
/snapshots/targets/x86/legacy/openwrt-x86-legacy-generic-squashfs-combined-efi.img.gz;17;0;17;91.67 MB;5.39 MB
/snapshots/targets/sunxi/cortexa7/openwrt-sunxi-cortexa7-xunlong_orangepi-plus-squashfs-sdcard.img.gz;17;121;138;62.48 MB;463.60 KB
/releases/19.07.4/targets/at91/sam9x/openwrt-19.07.4-at91-sam9x-lmu5000-ext4-factory.bin.gz;17;0;17;34.92 MB;2.05 MB
/releases/19.07.4/targets/archs38/generic/openwrt-19.07.4-archs38-generic-Default-sdcard-vfat-ext4.img.gz;17;0;17;35.19 MB;2.07 MB
/releases/19.07.4/targets/layerscape/armv8_64b/openwrt-19.07.4-layerscape-armv8_64b-ls1088ardb-sdboot-ext4-sdcard.img.gz;17;0;17;63.07 MB;3.71 MB
/releases/19.07.4/targets/at91/sam9x/openwrt-19.07.4-at91-sam9x-at91sam9g35ek-ext4-root.ubi.gz;17;0;17;15.59 MB;939.11 KB
/snapshots/targets/sunxi/cortexa7/openwrt-sunxi-cortexa7-friendlyarm_nanopi-neo-ext4-sdcard.img.gz;17;0;17;75.18 MB;4.42 MB
/snapshots/targets/sunxi/cortexa7/openwrt-sunxi-cortexa7-friendlyarm_nanopi-m1-plus-squashfs-sdcard.img.gz;17;0;17;72.81 MB;4.28 MB
/snapshots/targets/sunxi/cortexa7/openwrt-sunxi-cortexa7-cubietech_cubieboard2-squashfs-sdcard.img.gz;17;0;17;54.46 MB;3.20 MB
/releases/19.07.4/targets/at91/sam9x/openwrt-19.07.4-at91-sam9x-usb_a9260-ext4-factory.bin.gz;17;0;17;32.41 MB;1.91 MB
/snapshots/targets/oxnas/ox820/openwrt-oxnas-ox820-shuttle_kd20-squashfs-sysupgrade.tar;17;3;20;69.23 MB;3.46 MB
/snapshots/targets/sunxi/cortexa53/openwrt-sunxi-cortexa53-xunlong_orangepi-zero-plus-ext4-sdcard.img.gz;17;0;17;86.95 MB;5.11 MB
/releases/19.07.4/targets/at91/sam9x/openwrt-19.07.4-at91-sam9x-at91sam9g20ek-ext4-root.ubi.gz;17;0;17;15.48 MB;932.19 KB
/releases/19.07.4/targets/at91/sama5/openwrt-19.07.4-at91-sama5-at91-sama5d2_xplained-ext4-zImage.gz;17;0;17;23.72 MB;1.40 MB
/releases/19.07.4/targets/at91/sam9x/openwrt-19.07.4-at91-sam9x-usb_a9263-ext4-factory.bin.gz;17;0;17;31.51 MB;1.85 MB
/releases/19.07.4/targets/mvebu/cortexa72/openwrt-19.07.4-mvebu-cortexa72-marvell_armada8040-db-ext4-sdcard.img.gz;17;0;17;38.98 MB;2.29 MB
/releases/19.07.4/targets/at91/sam9x/openwrt-19.07.4-at91-sam9x-usb_a9g20-ext4-factory.bin.gz;17;0;17;26.16 MB;1.54 MB
/snapshots/targets/sunxi/cortexa53/openwrt-sunxi-cortexa53-pine64_sopine-baseboard-ext4-sdcard.img.gz;17;0;17;79.13 MB;4.65 MB
/releases/18.06.8/targets/ath25/generic/openwrt-18.06.8-ath25-generic-kernel.lzma;17;0;17;12.87 MB;775.39 KB
/releases/19.07.4/targets/mvebu/cortexa72/openwrt-19.07.4-mvebu-cortexa72-marvell_armada7040-db-squashfs-sdcard.img.gz;17;0;17;39.54 MB;2.33 MB
/releases/19.07.4/targets/sunxi/cortexa7/openwrt-19.07.4-sunxi-cortexa7-sun7i-a20-cubietruck-ext4-sdcard.img.gz;17;33;50;46.70 MB;956.47 KB
/releases/19.07.4/targets/pistachio/generic/openwrt-19.07.4-pistachio-rootfs.tar.gz;17;0;17;12.92 MB;778.34 KB
/releases/19.07.4/targets/layerscape/armv8_64b/openwrt-19.07.4-layerscape-armv8_64b-ls1046ardb-sdboot-ext4-sdcard.img.gz;17;0;17;59.70 MB;3.51 MB
/releases/19.07.4/targets/at91/sam9x/openwrt-19.07.4-at91-sam9x-at91sam9263ek-ext4-zImage.gz;17;1;18;20.13 MB;1.12 MB
/releases/19.07.2/targets/x86/64/openwrt-19.07.2-x86-64-combined-squashfs.img.gz;17;0;17;95.41 MB;5.61 MB
/releases/19.07.4/targets/arc770/generic/openwrt-19.07.4-arc770-generic-root.ext4.gz;17;0;17;21.09 MB;1.24 MB
/releases/19.07.4/targets/sunxi/cortexa53/openwrt-19.07.4-sunxi-cortexa53-sun50i-a64-sopine-baseboard-ext4-sdcard.img.gz;17;38;55;39.07 MB;727.38 KB
/snapshots/targets/sunxi/cortexa53/openwrt-sunxi-cortexa53-friendlyarm_nanopi-neo2-ext4-sdcard.img.gz;17;0;17;85.34 MB;5.02 MB
/releases/19.07.4/targets/at91/sama5/openwrt-19.07.4-at91-sama5-at91-sama5d2_ptc_ek-ext4-root.ubi.gz;17;0;17;15.20 MB;915.78 KB
/releases/19.07.4/targets/sunxi/cortexa8/openwrt-19.07.4-sunxi-cortexa8-sun4i-a10-marsboard-squashfs-sdcard.img.gz;17;0;17;36.74 MB;2.16 MB
/releases/19.07.4/targets/mvebu/cortexa72/openwrt-19.07.4-mvebu-cortexa72-marvell_macchiatobin-ext4-sdcard.img.gz;17;0;17;39.50 MB;2.32 MB
/releases/19.07.4/targets/layerscape/armv7/openwrt-19.07.4-layerscape-armv7-ls1021aiot-sdboot-ext4-sdcard.img.gz;17;0;17;39.15 MB;2.30 MB
/releases/19.07.4/targets/sunxi/cortexa7/openwrt-19.07.4-sunxi-cortexa7-sun7i-a20-olinuxino-micro-ext4-sdcard.img.gz;16;0;16;39.71 MB;2.48 MB
/releases/19.07.4/targets/at91/sam9x/openwrt-19.07.4-at91-sam9x-rootfs.tar.gz;16;0;16;10.07 MB;644.75 KB
/releases/17.01.1/targets/ar71xx/mikrotik/lede-17.01.1-ar71xx-mikrotik-vmlinux-initramfs.lzma;16;0;16;29.51 MB;1.84 MB
/releases/19.07.4/targets/sunxi/cortexa7/openwrt-19.07.4-sunxi-cortexa7-sun8i-h3-bananapi-m2-plus-ext4-sdcard.img.gz;16;0;16;42.20 MB;2.64 MB
/releases/19.07.4/targets/sunxi/cortexa7/openwrt-19.07.4-sunxi-cortexa7-sun6i-a31-m9-ext4-sdcard.img.gz;16;0;16;30.68 MB;1.92 MB
/releases/19.07.4/targets/at91/sama5/openwrt-19.07.4-at91-sama5-at91-sama5d2_ptc_ek-ext4-zImage.gz;16;0;16;17.35 MB;1.08 MB
/releases/19.07.4/targets/mxs/generic/openwrt-19.07.4-mxs-root.ext4.gz;16;0;16;37.88 MB;2.37 MB
/snapshots/targets/sunxi/cortexa7/openwrt-sunxi-cortexa7-sinovoip_bananapi-m2-ultra-squashfs-sdcard.img.gz;16;0;16;72.68 MB;4.54 MB
/snapshots/targets/mvebu/cortexa53/openwrt-mvebu-cortexa53-globalscale_espressobin-v7-squashfs-sdcard.img.gz;16;0;16;58.85 MB;3.68 MB
/releases/19.07.4/targets/at91/sam9x/openwrt-19.07.4-at91-sam9x-at91sam9g20ek-ext4-zImage.gz;16;0;16;16.46 MB;1.03 MB
/releases/19.07.4/targets/at91/sam9x/openwrt-19.07.4-at91-sam9x-at91sam9g15ek-ext4-root.ubi.gz;16;0;16;13.03 MB;833.84 KB
/releases/19.07.4/targets/at91/sama5/openwrt-19.07.4-at91-sama5-at91-sama5d4_xplained-ext4-zImage.gz;16;0;16;20.40 MB;1.28 MB
/releases/19.07.4/targets/layerscape/armv7/openwrt-19.07.4-layerscape-armv7-ls1021atwr-sdboot-ext4-sdcard.img.gz;16;0;16;32.45 MB;2.03 MB
/snapshots/targets/zynq/generic/openwrt-zynq-digilent_zynq-zybo-z7-squashfs-sdcard.img.gz;16;0;16;64.44 MB;4.03 MB
/snapshots/targets/sunxi/cortexa53/openwrt-sunxi-cortexa53-friendlyarm_nanopi-neo2-squashfs-sdcard.img.gz;16;0;16;71.98 MB;4.50 MB
/releases/19.07.3/targets/x86/generic/openwrt-19.07.3-x86-generic-combined-ext4.img.gz;16;40;56;108.90 MB;1.94 MB
/releases/19.07.4/targets/at91/sama5/openwrt-19.07.4-at91-sama5-at91-sama5d4_xplained-ext4-sdcard.img.gz;16;0;16;36.18 MB;2.26 MB
/snapshots/targets/omap/generic/openwrt-omap-ti_omap4-panda-squashfs-sdcard.img.gz;16;0;16;56.65 MB;3.54 MB
/snapshots/targets/bcm27xx/bcm2709/openwrt-bcm27xx-bcm2709-rpi-2-squashfs-sysupgrade.img.gz;16;0;16;194.08 MB;12.13 MB
/releases/19.07.4/targets/at91/sama5/openwrt-19.07.4-at91-sama5-at91-sama5d2_ptc_ek-ext4-sdcard.img.gz;16;0;16;36.15 MB;2.26 MB
/releases/19.07.4/targets/armvirt/32/openwrt-19.07.4-armvirt-32-rootfs.cpio.gz;16;0;16;160 Bytes;10 Bytes
/releases/19.07.4/targets/sunxi/cortexa7/openwrt-19.07.4-sunxi-cortexa7-sun7i-a20-olinuxino-lime2-emmc-squashfs-sdcard.img.gz;16;0;16;35.24 MB;2.20 MB
/snapshots/targets/sunxi/cortexa8/openwrt-sunxi-cortexa8-cubietech_a10-cubieboard-squashfs-sdcard.img.gz;16;10;26;57.69 MB;2.22 MB
/releases/19.07.4/targets/at91/sam9x/openwrt-19.07.4-at91-sam9x-at91sam9x25ek-ext4-root.ubi.gz;16;0;16;13.08 MB;836.83 KB
/snapshots/targets/mvebu/cortexa53/openwrt-mvebu-cortexa53-globalscale_espressobin-emmc-squashfs-sdcard.img.gz;16;0;16;58.61 MB;3.66 MB
/releases/19.07.4/targets/ath25/generic/openwrt-19.07.4-ath25-generic-kernel.gz;16;0;16;12.83 MB;820.97 KB
/releases/19.07.4/targets/oxnas/ox820/openwrt-19.07.4-oxnas-ox820-akitio_mycloud-ubifs-sysupgrade.tar;16;0;16;44.09 MB;2.76 MB
/snapshots/targets/sunxi/cortexa7/openwrt-sunxi-cortexa7-friendlyarm_nanopi-neo-air-squashfs-sdcard.img.gz;16;0;16;62.16 MB;3.88 MB
/releases/19.07.4/targets/at91/sama5/openwrt-19.07.4-at91-sama5-at91-sama5d2_xplained-ext4-root.ubi.gz;16;0;16;15.13 MB;968.16 KB
/snapshots/targets/mvebu/cortexa72/openwrt-mvebu-cortexa72-marvell_armada7040-db-ext4-sdcard.img.gz;16;0;16;55.49 MB;3.47 MB
/releases/19.07.4/targets/at91/sam9x/openwrt-19.07.4-at91-sam9x-at91sam9263ek-ext4-root.ubi.gz;16;0;16;15.34 MB;981.83 KB
/snapshots/targets/sunxi/cortexa7/openwrt-sunxi-cortexa7-lemaker_bananapro-ext4-sdcard.img.gz;16;2;18;67.41 MB;3.74 MB
/releases/19.07.4/targets/omap/generic/openwrt-19.07.4-omap-ti_am335x-evm-ext4-sdcard.img.gz;16;0;16;41.03 MB;2.56 MB
/snapshots/targets/sunxi/cortexa8/openwrt-sunxi-cortexa8-linksprite_a10-pcduino-ext4-sdcard.img.gz;16;0;16;67.94 MB;4.25 MB
/releases/18.06.8/targets/ar71xx/tiny/openwrt-18.06.8-ar71xx-tiny-vmlinux.lzma;16;0;16;7.14 MB;456.80 KB
/releases/19.07.4/targets/at91/sama5/openwrt-19.07.4-at91-sama5-at91-sama5d2_xplained-ext4-sdcard.img.gz;16;0;16;36.06 MB;2.25 MB
/releases/19.07.4/targets/at91/sam9x/openwrt-19.07.4-at91-sam9x-tny_a9263-ext4-factory.bin.gz;16;0;16;25.84 MB;1.62 MB
/releases/18.06.5/targets/brcm2708/bcm2710/openwrt-18.06.5-brcm2708-bcm2710-rpi-3-ext4-factory.img.gz;16;0;16;124.69 MB;7.79 MB
/releases/19.07.4/targets/at91/sam9x/openwrt-19.07.4-at91-sam9x-at91sam9x35ek-ext4-root.ubi.gz;16;0;16;13.06 MB;835.82 KB
/snapshots/targets/apm821xx/sata/openwrt-apm821xx-sata-wd_mybooklive-squashfs-factory.img.gz;16;0;16;68.33 MB;4.27 MB
/snapshots/targets/sunxi/cortexa7/openwrt-sunxi-cortexa7-xunlong_orangepi-pc-ext4-sdcard.img.gz;16;0;16;63.22 MB;3.95 MB
/snapshots/targets/sunxi/cortexa7/openwrt-sunxi-cortexa7-xunlong_orangepi-pc-squashfs-sdcard.img.gz;16;0;16;52.65 MB;3.29 MB
/releases/18.06.0/targets/ar71xx/generic/openwrt-18.06.0-ar71xx-generic-vmlinux.lzma;16;0;16;18.87 MB;1.18 MB
/snapshots/targets/at91/sama5/openwrt-at91-sama5-microchip_sama5d3-xplained-ext4-sdcard.img.gz;16;0;16;63.03 MB;3.94 MB
/snapshots/targets/sunxi/cortexa8/openwrt-sunxi-cortexa8-cubietech_a10-cubieboard-ext4-sdcard.img.gz;16;11;27;64.22 MB;2.38 MB
/releases/19.07.4/targets/at91/sama5/openwrt-19.07.4-at91-sama5-at91-sama5d4_xplained-ext4-root.ubi.gz;16;0;16;15.00 MB;960.31 KB
/snapshots/targets/sunxi/cortexa7/openwrt-sunxi-cortexa7-sinovoip_bananapi-m2-plus-squashfs-sdcard.img.gz;16;0;16;67.35 MB;4.21 MB
/releases/19.07.4/targets/at91/sama5/openwrt-19.07.4-at91-sama5-at91-sama5d27_som1_ek-ext4-zImage.gz;16;0;16;17.76 MB;1.11 MB
/snapshots/targets/mvebu/cortexa9/openwrt-mvebu-cortexa9-kobol_helios4-squashfs-sdcard.img.gz;16;0;16;48.58 MB;3.04 MB
/snapshots/targets/x86/legacy/openwrt-x86-legacy-generic-squashfs-rootfs.img.gz;16;0;16;27.52 MB;1.72 MB
/snapshots/targets/zynq/generic/openwrt-zynq-avnet_zynq-zed-squashfs-sdcard.img.gz;16;0;16;55.05 MB;3.44 MB
/snapshots/targets/apm821xx/sata/openwrt-apm821xx-sata-wd_mybooklive-squashfs-sysupgrade.img.gz;16;0;16;66.35 MB;4.15 MB
/snapshots/targets/apm821xx/sata/openwrt-apm821xx-sata-wd_mybooklive-ext4-sysupgrade.img.gz;16;0;16;80.87 MB;5.05 MB
/releases/18.06.8/targets/ar71xx/nand/openwrt-18.06.8-ar71xx-nand-wndr4300-squashfs-sysupgrade.tar;16;22;38;43.42 MB;1.14 MB
/releases/19.07.4/targets/brcm63xx/generic/openwrt-19.07.4-brcm63xx-generic-livebox-vmlinux.gz;16;0;16;16.34 MB;1.02 MB
/releases/19.07.0/targets/brcm2708/bcm2710/openwrt-19.07.0-brcm2708-bcm2710-rpi-3-squashfs-factory.img.gz;16;44;60;107.90 MB;1.80 MB
/snapshots/targets/omap/generic/openwrt-omap-ti_omap3-beagle-ext4-sdcard.img.gz;15;0;15;61.09 MB;4.07 MB
/snapshots/targets/sunxi/cortexa8/openwrt-sunxi-cortexa8-linksprite_a10-pcduino-squashfs-sdcard.img.gz;15;0;15;48.47 MB;3.23 MB
/releases/18.06.1/targets/ar71xx/nand/openwrt-18.06.1-ar71xx-nand-hiveap-121-squashfs-sysupgrade.tar;15;0;15;6.65 MB;454.21 KB
/snapshots/targets/sunxi/cortexa7/openwrt-sunxi-cortexa7-olimex_a20-olinuxino-lime2-squashfs-sdcard.img.gz;15;0;15;43.46 MB;2.90 MB
/snapshots/targets/sunxi/cortexa7/openwrt-sunxi-cortexa7-friendlyarm_nanopi-m1-plus-ext4-sdcard.img.gz;15;0;15;62.43 MB;4.16 MB
/releases/19.07.4/targets/at91/sam9x/openwrt-19.07.4-at91-sam9x-at91sam9g20ek_2mmc-ext4-zImage.gz;15;0;15;14.32 MB;977.41 KB
/releases/19.07.4/targets/sunxi/cortexa7/openwrt-19.07.4-sunxi-cortexa7-sun8i-h3-nanopi-m1-plus-squashfs-sdcard.img.gz;15;0;15;29.74 MB;1.98 MB
/snapshots/targets/at91/sama5/openwrt-at91-sama5-microchip_sama5d4-xplained-ext4-root.ubi.gz;15;0;15;19.10 MB;1.27 MB
/snapshots/targets/sunxi/cortexa8/openwrt-sunxi-cortexa8-olimex_a13-olimex-som-squashfs-sdcard.img.gz;15;0;15;47.38 MB;3.16 MB
/releases/19.07.4/targets/at91/sam9x/openwrt-19.07.4-at91-sam9x-ethernut5-ext4-root.ubi.gz;15;0;15;11.78 MB;804.31 KB
/snapshots/targets/mvebu/cortexa53/openwrt-mvebu-cortexa53-globalscale_espressobin-emmc-ext4-sdcard.img.gz;15;0;15;54.99 MB;3.67 MB
/releases/19.07.4/targets/at91/sam9x/openwrt-19.07.4-at91-sam9x-tny_a9260-ext4-factory.bin.gz;15;0;15;35.51 MB;2.37 MB
/releases/19.07.4/targets/oxnas/ox820/openwrt-19.07.4-oxnas-ox820-shuttle_kd20-ubifs-sysupgrade.tar;15;0;15;38.76 MB;2.58 MB
/releases/18.06.8/targets/ar71xx/mikrotik/openwrt-18.06.8-ar71xx-mikrotik-vmlinux-initramfs.lzma;15;0;15;12.03 MB;821.12 KB
/snapshots/targets/mvebu/cortexa72/openwrt-mvebu-cortexa72-marvell_macchiatobin-singleshot-ext4-sdcard.img.gz;15;0;15;63.77 MB;4.25 MB
/snapshots/targets/sunxi/cortexa8/openwrt-sunxi-cortexa8-olimex_a13-olinuxino-squashfs-sdcard.img.gz;15;0;15;54.87 MB;3.66 MB
/releases/19.07.0/targets/x86/64/openwrt-19.07.0-x86-64-generic-rootfs.tar.gz;15;0;15;44.25 MB;2.95 MB
/releases/17.01.2/targets/ar71xx/mikrotik/lede-17.01.2-ar71xx-mikrotik-vmlinux.lzma;15;0;15;11.08 MB;756.15 KB
/releases/19.07.4/targets/at91/sam9x/openwrt-19.07.4-at91-sam9x-at91sam9g25ek-ext4-root.ubi.gz;15;0;15;12.69 MB;865.97 KB
/snapshots/targets/layerscape/armv8_64b/openwrt-layerscape-armv8_64b-fsl_ls1046a-rdb-sdboot-squashfs-sdcard.img.gz;15;1;16;107.12 MB;6.70 MB
/releases/19.07.0/targets/octeontx/generic/openwrt-19.07.0-octeontx-default-rootfs.tar.gz;15;0;15;29.26 MB;1.95 MB
/releases/18.06.0/targets/brcm2708/bcm2710/openwrt-18.06.0-brcm2708-bcm2710-rpi-3-ext4-factory.img.gz;15;36;51;84.40 MB;1.65 MB
/snapshots/targets/ath25/generic/openwrt-ath25-generic-kernel.gz;15;0;15;20.64 MB;1.38 MB
/snapshots/targets/mvebu/cortexa72/openwrt-mvebu-cortexa72-marvell_armada8040-db-ext4-sdcard.img.gz;15;0;15;67.70 MB;4.51 MB
/releases/18.06.7/targets/x86/64/openwrt-18.06.7-x86-64-combined-squashfs.img.gz;15;8;23;53.08 MB;2.31 MB
/snapshots/targets/x86/geode/openwrt-x86-geode-geos-ext4-combined-efi.img.gz;15;0;15;71.36 MB;4.76 MB
/snapshots/targets/gemini/generic/openwrt-gemini-dlink_dir-685-ext4-sysupgrade.bin.gz;15;0;15;70.11 MB;4.67 MB
/snapshots/targets/sunxi/cortexa8/openwrt-sunxi-cortexa8-olimex_a10-olinuxino-lime-ext4-sdcard.img.gz;15;0;15;55.20 MB;3.68 MB
/releases/19.07.4/targets/at91/sama5/openwrt-19.07.4-at91-sama5-at91-sama5d27_som1_ek-ext4-root.ubi.gz;15;0;15;15.92 MB;1.06 MB
/snapshots/targets/mvebu/cortexa53/openwrt-mvebu-cortexa53-globalscale_espressobin-v7-emmc-ext4-sdcard.img.gz;15;0;15;62.98 MB;4.20 MB
/snapshots/targets/x86/legacy/openwrt-x86-legacy-generic-squashfs-combined.img.gz;15;4;19;72.67 MB;3.82 MB
/snapshots/targets/zynq/generic/openwrt-zynq-digilent_zynq-zybo-squashfs-sdcard.img.gz;15;0;15;54.92 MB;3.66 MB
/snapshots/targets/mvebu/cortexa53/openwrt-mvebu-cortexa53-marvell_armada-3720-db-ext4-sdcard.img.gz;15;0;15;62.42 MB;4.16 MB
/releases/17.01.0-rc2/targets/ar71xx/mikrotik/lede-17.01.0-rc2-r3131-42f3c1f-ar71xx-mikrotik-vmlinux.lzma;15;0;15;8.75 MB;597.15 KB
/snapshots/targets/mxs/generic/openwrt-mxs-duckbill-sdcard.img.gz;15;0;15;121.18 MB;8.08 MB
/releases/19.07.4/targets/octeontx/generic/openwrt-19.07.4-octeontx-default-rootfs.tar.gz;15;0;15;12.47 MB;851.35 KB
/releases/19.07.4/targets/omap/generic/openwrt-19.07.4-omap-ti_omap4-panda-squashfs-sdcard.img.gz;15;0;15;23.90 MB;1.59 MB
/snapshots/targets/sunxi/cortexa7/openwrt-sunxi-cortexa7-xunlong_orangepi-pc-plus-ext4-sdcard.img.gz;15;0;15;50.86 MB;3.39 MB
/releases/19.07.3/targets/ar71xx/tiny/openwrt-19.07.3-ar71xx-tiny-vmlinux.lzma;15;0;15;10.87 MB;742.09 KB
/releases/17.01.6/targets/ar71xx/mikrotik/lede-17.01.6-ar71xx-mikrotik-vmlinux.lzma;15;0;15;6.95 MB;474.46 KB
/snapshots/targets/oxnas/ox820/openwrt-oxnas-ox820-akitio_mycloud-squashfs-sysupgrade.tar;15;1;16;48.55 MB;3.03 MB
/releases/18.06.1/targets/ar71xx/nand/openwrt-18.06.1-ar71xx-nand-rambutan-squashfs-sysupgrade.tar;15;0;15;6.07 MB;414.07 KB
/releases/19.07.4/targets/gemini/generic/openwrt-19.07.4-gemini-itian_sq201-ext4-factory.bin.gz;15;0;15;52.52 MB;3.50 MB
/snapshots/targets/archs38/generic/openwrt-archs38-generic-Default-sdcard-vfat-ext4.img.gz;15;0;15;63.04 MB;4.20 MB
/releases/17.01.0/targets/ar71xx/mikrotik/lede-17.01.0-r3205-59508e3-ar71xx-mikrotik-vmlinux-initramfs.lzma;15;0;15;15.50 MB;1.03 MB
/releases/18.06.2/targets/x86/generic/openwrt-18.06.2-x86-generic-combined-ext4.img.gz;15;8;23;43.25 MB;1.88 MB
/releases/19.07.4/targets/at91/sam9x/openwrt-19.07.4-at91-sam9x-tny_a9g20-ext4-factory.bin.gz;15;0;15;24.78 MB;1.65 MB
/snapshots/targets/sunxi/cortexa7/openwrt-sunxi-cortexa7-xunlong_orangepi-one-squashfs-sdcard.img.gz;15;0;15;43.82 MB;2.92 MB
/snapshots/targets/sunxi/cortexa53/openwrt-sunxi-cortexa53-friendlyarm_nanopi-neo-plus2-squashfs-sdcard.img.gz;15;0;15;64.82 MB;4.32 MB
/snapshots/targets/omap/generic/openwrt-omap-ti_am335x-evm-squashfs-sdcard.img.gz;15;0;15;58.18 MB;3.88 MB
/releases/19.07.4/targets/at91/sam9x/openwrt-19.07.4-at91-sam9x-at91sam9g20ek_2mmc-ext4-root.ubi.gz;15;0;15;15.34 MB;1.02 MB
/releases/18.06.1/targets/armvirt/64/openwrt-18.06.1-armvirt-64-default-rootfs.tar.gz;15;13;28;16.92 MB;618.75 KB
/snapshots/targets/mvebu/cortexa53/openwrt-mvebu-cortexa53-marvell_armada-3720-db-squashfs-sdcard.img.gz;15;0;15;56.35 MB;3.76 MB
/snapshots/targets/x86/geode/openwrt-x86-geode-generic-ext4-combined.img.gz;15;0;15;61.58 MB;4.11 MB
/snapshots/targets/sunxi/cortexa7/openwrt-sunxi-cortexa7-sinovoip_bananapi-m2-plus-ext4-sdcard.img.gz;15;0;15;57.07 MB;3.80 MB
/snapshots/targets/omap/generic/openwrt-omap-ti_omap4-panda-ext4-sdcard.img.gz;15;0;15;64.14 MB;4.28 MB
/snapshots/targets/sunxi/cortexa53/openwrt-sunxi-cortexa53-friendlyarm_nanopi-neo-plus2-ext4-sdcard.img.gz;15;0;15;70.77 MB;4.72 MB
/snapshots/targets/sunxi/cortexa7/openwrt-sunxi-cortexa7-lemaker_bananapi-ext4-sdcard.img.gz;15;2;17;60.30 MB;3.55 MB
/releases/19.07.4/targets/omap/generic/openwrt-19.07.4-omap-ti_am335x-evm-squashfs-sdcard.img.gz;15;0;15;29.47 MB;1.96 MB
/snapshots/targets/gemini/generic/openwrt-gemini-storlink_sl93512r-ext4-factory.bin.gz;15;0;15;73.90 MB;4.93 MB
/snapshots/targets/gemini/generic/openwrt-gemini-dlink_dir-685-ext4-factory.bin.gz;15;0;15;71.36 MB;4.76 MB
/releases/19.07.4/targets/at91/sam9x/openwrt-19.07.4-at91-sam9x-at91sam9m10g45ek-ext4-root.ubi.gz;15;0;15;10.42 MB;711.31 KB
/snapshots/targets/x86/geode/openwrt-x86-geode-generic-squashfs-combined-efi.img.gz;14;0;14;57.05 MB;4.07 MB
/snapshots/targets/sunxi/cortexa8/openwrt-sunxi-cortexa8-olimex_a13-olinuxino-ext4-sdcard.img.gz;14;0;14;45.17 MB;3.23 MB
/snapshots/targets/sunxi/cortexa7/openwrt-sunxi-cortexa7-lemaker_bananapi-squashfs-sdcard.img.gz;14;0;14;42.84 MB;3.06 MB
/releases/18.06.1/targets/ar71xx/nand/openwrt-18.06.1-ar71xx-nand-wndr4300-squashfs-sysupgrade.tar;14;0;14;4.67 MB;341.40 KB
/snapshots/targets/x86/geode/openwrt-x86-geode-geos-ext4-combined.img.gz;14;0;14;53.59 MB;3.83 MB
/snapshots/targets/sunxi/cortexa7/openwrt-sunxi-cortexa7-friendlyarm_zeropi-ext4-sdcard.img.gz;14;0;14;52.27 MB;3.73 MB
/snapshots/targets/malta/be/openwrt-malta-be-default-rootfs.tar.gz;14;0;14;28.30 MB;2.02 MB
/snapshots/targets/sunxi/cortexa7/openwrt-sunxi-cortexa7-olimex_a20-olinuxino-lime2-emmc-ext4-sdcard.img.gz;14;0;14;51.47 MB;3.68 MB
/releases/18.06.8/targets/x86/geode/openwrt-18.06.8-x86-geode-combined-ext4.img.gz;14;20;34;53.02 MB;1.56 MB
/releases/17.01.3/targets/ath25/generic/lede-17.01.3-ath25-generic-kernel.lzma;14;0;14;6.00 MB;438.68 KB
/snapshots/targets/sunxi/cortexa7/openwrt-sunxi-cortexa7-olimex_a20-olinuxino-micro-squashfs-sdcard.img.gz;14;0;14;50.29 MB;3.59 MB
/snapshots/targets/x86/geode/openwrt-x86-geode-geos-squashfs-combined-efi.img.gz;14;0;14;58.62 MB;4.19 MB
/snapshots/targets/arc770/generic/openwrt-arc770-generic-Default-sdcard-vfat-ext4.img.gz;14;0;14;47.53 MB;3.40 MB
/releases/18.06.1/targets/ar71xx/nand/openwrt-18.06.1-ar71xx-nand-mr18-squashfs-sysupgrade.tar;14;0;14;6.72 MB;491.40 KB
/snapshots/targets/at91/sama5/openwrt-at91-sama5-microchip_sama5d27-som1-ek-ext4-sdcard.img.gz;14;0;14;48.14 MB;3.44 MB
/releases/19.07.4/targets/ar71xx/nand/openwrt-19.07.4-ar71xx-nand-wi2a-ac200i-squashfs-sysupgrade.tar;14;0;14;19.98 MB;1.43 MB
/releases/19.07.3/targets/brcm2708/bcm2709/openwrt-19.07.3-brcm2708-bcm2709-rpi-2-ext4-factory.img.gz;14;7;21;126.88 MB;6.04 MB
/releases/18.06.1/targets/ar71xx/nand/openwrt-18.06.1-ar71xx-nand-wndr3700v4-squashfs-sysupgrade.tar;14;0;14;4.67 MB;341.40 KB
/releases/18.06.9/targets/x86/64/openwrt-18.06.9-x86-64-generic-rootfs.tar.gz;14;0;14;39.46 MB;2.82 MB
/snapshots/targets/octeon/generic/openwrt-octeon-ubnt_edgerouter-lite-squashfs-sysupgrade.tar;14;0;14;100.74 MB;7.20 MB
/snapshots/targets/sunxi/cortexa7/openwrt-sunxi-cortexa7-olimex_a20-olinuxino-lime-ext4-sdcard.img.gz;14;0;14;55.16 MB;3.94 MB
/snapshots/targets/bcm27xx/bcm2709/openwrt-bcm27xx-bcm2709-rpi-2-squashfs-factory.img.gz;14;0;14;154.71 MB;11.05 MB
/releases/19.07.3/targets/ar71xx/nand/openwrt-19.07.3-ar71xx-nand-vmlinux.lzma;14;0;14;6.85 MB;501.32 KB
/releases/17.01.4/targets/ar71xx/nand/lede-17.01.4-ar71xx-nand-vmlinux.lzma;14;0;14;10.19 MB;745.02 KB
/snapshots/targets/at91/sama5/openwrt-at91-sama5-microchip_sama5d4-xplained-ext4-sdcard.img.gz;14;0;14;57.74 MB;4.12 MB
/releases/18.06.8/targets/x86/legacy/openwrt-18.06.8-x86-legacy-combined-squashfs.img.gz;14;1;15;49.52 MB;3.30 MB
/snapshots/targets/at91/sama5/openwrt-at91-sama5-microchip_sama5d2-xplained-ext4-sdcard.img.gz;14;0;14;54.80 MB;3.91 MB
/releases/19.07.0/targets/brcm2708/bcm2710/openwrt-19.07.0-brcm2708-bcm2710-rpi-3-ext4-factory.img.gz;14;66;80;114.39 MB;1.43 MB
/snapshots/targets/omap/generic/openwrt-omap-rootfs.tar.gz;14;0;14;22.24 MB;1.59 MB
/releases/19.07.4/targets/zynq/generic/openwrt-19.07.4-zynq-digilent_zynq-zybo-z7-squashfs-sdcard.img.gz;14;0;14;29.56 MB;2.11 MB
/snapshots/targets/at91/sama5/openwrt-at91-sama5-microchip_sama5d3-xplained-ext4-root.ubi.gz;14;0;14;19.38 MB;1.38 MB
/snapshots/targets/x86/geode/openwrt-x86-geode-geos-ext4-rootfs.img.gz;14;0;14;34.24 MB;2.45 MB
/releases/19.07.4/targets/omap/generic/openwrt-19.07.4-omap-ti_omap3-beagle-squashfs-sdcard.img.gz;14;0;14;24.59 MB;1.76 MB
/snapshots/targets/x86/geode/openwrt-x86-geode-generic-ext4-combined-efi.img.gz;14;0;14;55.36 MB;3.95 MB
/snapshots/targets/sunxi/cortexa8/openwrt-sunxi-cortexa8-marsboard_a10-marsboard-squashfs-sdcard.img.gz;14;0;14;45.28 MB;3.23 MB
/snapshots/targets/malta/be/openwrt-malta-be-rootfs-squashfs.img.gz;14;0;14;26.19 MB;1.87 MB
/snapshots/targets/x86/geode/openwrt-x86-geode-rootfs.tar.gz;14;0;14;26.53 MB;1.90 MB
/snapshots/targets/archs38/generic/openwrt-archs38-generic-root.ext4.gz;14;0;14;21.43 MB;1.53 MB
/releases/19.07.2/targets/brcm2708/bcm2708/openwrt-19.07.2-brcm2708-bcm2708-rpi-ext4-factory.img.gz;14;153;167;73.92 MB;453.26 KB
/snapshots/targets/octeontx/generic/openwrt-octeontx-default-rootfs.tar.gz;14;0;14;18.82 MB;1.34 MB
/releases/18.06.2/targets/sunxi/cortexa7/openwrt-18.06.2-sunxi-cortexa7-sun8i-h2-plus-orangepi-r1-ext4-sdcard.img.gz;14;15;29;69.78 MB;2.41 MB
/releases/18.06.1/targets/ar71xx/nand/openwrt-18.06.1-ar71xx-nand-z1-squashfs-sysupgrade.tar;14;0;14;6.80 MB;497.11 KB
/snapshots/targets/sunxi/cortexa7/openwrt-sunxi-cortexa7-xunlong_orangepi-pc-plus-squashfs-sdcard.img.gz;14;0;14;39.42 MB;2.82 MB
/snapshots/targets/sunxi/cortexa7/openwrt-sunxi-cortexa7-olimex_a20-olinuxino-lime2-ext4-sdcard.img.gz;14;0;14;43.66 MB;3.12 MB
/snapshots/targets/sunxi/cortexa7/openwrt-sunxi-cortexa7-linksprite_pcduino3-ext4-sdcard.img.gz;14;0;14;53.99 MB;3.86 MB
/snapshots/targets/sunxi/cortexa8/openwrt-sunxi-cortexa8-olimex_a10-olinuxino-lime-squashfs-sdcard.img.gz;14;0;14;39.35 MB;2.81 MB
/releases/18.06.1/targets/ar71xx/nand/openwrt-18.06.1-ar71xx-nand-nbg6716-squashfs-sysupgrade.tar;14;0;14;4.91 MB;359.25 KB
/snapshots/targets/sunxi/cortexa8/openwrt-sunxi-cortexa8-olimex_a13-olimex-som-ext4-sdcard.img.gz;14;0;14;48.05 MB;3.43 MB
/releases/18.06.8/targets/ar71xx/generic/openwrt-18.06.8-ar71xx-generic-vmlinux.lzma;14;0;14;4.12 MB;301.48 KB
/snapshots/targets/sunxi/cortexa7/openwrt-sunxi-cortexa7-friendlyarm_nanopi-neo-squashfs-sdcard.img.gz;14;0;14;44.59 MB;3.19 MB
/snapshots/targets/x86/generic/openwrt-x86-generic-generic-squashfs-rootfs.img.gz;14;0;14;26.70 MB;1.91 MB
/releases/18.06.1/targets/ar71xx/nand/openwrt-18.06.1-ar71xx-nand-c-60-squashfs-sysupgrade.tar;14;0;14;3.83 MB;280.25 KB
/snapshots/targets/x86/geode/openwrt-x86-geode-generic-squashfs-rootfs.img.gz;14;0;14;22.46 MB;1.60 MB
/releases/18.06.8/targets/ar71xx/nand/openwrt-18.06.8-ar71xx-nand-vmlinux.lzma;14;0;14;7.67 MB;560.98 KB
/releases/19.07.4/targets/ar71xx/generic/openwrt-19.07.4-ar71xx-generic-vmlinux.lzma;14;0;14;3.56 MB;260.44 KB
/releases/18.06.1/targets/armvirt/32/openwrt-18.06.1-armvirt-32-rootfs.cpio.gz;14;0;14;26.00 MB;1.86 MB
/snapshots/targets/ath79/nand/openwrt-ath79-nand-zyxel_nbg6716-squashfs-sysupgrade.tar;14;0;14;62.33 MB;4.45 MB
/snapshots/targets/sunxi/cortexa7/openwrt-sunxi-cortexa7-linksprite_pcduino3-squashfs-sdcard.img.gz;14;0;14;47.15 MB;3.37 MB
/releases/18.06.1/targets/ar71xx/nand/openwrt-18.06.1-ar71xx-nand-r6100-squashfs-sysupgrade.tar;14;0;14;4.83 MB;353.54 KB
/releases/18.06.1/targets/ar71xx/nand/openwrt-18.06.1-ar71xx-nand-wi2a-ac200i-squashfs-sysupgrade.tar;14;0;14;4.12 MB;301.69 KB
/releases/19.07.4/targets/rb532/generic/openwrt-19.07.4-rb532-default-rootfs.tar.gz;14;0;14;18.06 MB;1.29 MB
/snapshots/targets/mxs/generic/openwrt-mxs-root.ext4.gz;14;0;14;53.86 MB;3.85 MB
/releases/19.07.4/targets/imx6/generic/openwrt-19.07.4-imx6-ventana-squashfs-bootfs.tar.gz;14;0;14;13.06 MB;955.51 KB
/releases/19.07.4/targets/omap/generic/openwrt-19.07.4-omap-ti_omap4-panda-ext4-sdcard.img.gz;14;0;14;26.91 MB;1.92 MB
/snapshots/targets/arc770/generic/openwrt-arc770-generic-root.ext4.gz;14;0;14;21.50 MB;1.54 MB
/releases/18.06.8/targets/brcm2708/bcm2710/openwrt-18.06.8-brcm2708-bcm2710-rpi-3-squashfs-factory.img.gz;14;2;16;71.29 MB;4.46 MB
/snapshots/targets/sunxi/cortexa7/openwrt-sunxi-cortexa7-cubietech_cubietruck-ext4-sdcard.img.gz;14;0;14;52.01 MB;3.72 MB
/snapshots/targets/x86/geode/openwrt-x86-geode-generic-ext4-rootfs.img.gz;14;0;14;26.67 MB;1.90 MB
/snapshots/targets/sunxi/cortexa7/openwrt-sunxi-cortexa7-olimex_a20-olinuxino-lime-squashfs-sdcard.img.gz;14;0;14;48.32 MB;3.45 MB
/snapshots/targets/x86/geode/openwrt-x86-geode-geos-squashfs-combined.img.gz;14;0;14;56.29 MB;4.02 MB
/snapshots/targets/sunxi/cortexa7/openwrt-sunxi-cortexa7-xunlong_orangepi-plus-ext4-sdcard.img.gz;14;0;14;46.68 MB;3.33 MB
/snapshots/targets/mvebu/cortexa72/openwrt-mvebu-cortexa72-marvell_armada8040-db-squashfs-sdcard.img.gz;14;0;14;56.13 MB;4.01 MB
/snapshots/targets/sunxi/cortexa7/openwrt-sunxi-cortexa7-mele_m9-squashfs-sdcard.img.gz;13;0;13;39.78 MB;3.06 MB
/snapshots/targets/tegra/generic/openwrt-tegra-compulab_trimslice-squashfs-sdcard.img.gz;13;0;13;46.54 MB;3.58 MB
/snapshots/targets/sunxi/cortexa7/openwrt-sunxi-cortexa7-olimex_a20-olinuxino-lime2-emmc-squashfs-sdcard.img.gz;13;0;13;45.17 MB;3.47 MB
/snapshots/targets/at91/sam9x/openwrt-at91-sam9x-atmel_at91sam9g35ek-ext4-root.ubi.gz;13;0;13;17.51 MB;1.35 MB
/snapshots/targets/at91/sam9x/openwrt-at91-sam9x-atmel_at91sam9g25ek-ext4-root.ubi.gz;13;0;13;17.43 MB;1.34 MB
/snapshots/targets/sunxi/cortexa7/openwrt-sunxi-cortexa7-xunlong_orangepi-2-ext4-sdcard.img.gz;13;0;13;50.28 MB;3.87 MB
/snapshots/targets/imx6/generic/openwrt-imx6-ventana-squashfs-bootfs.tar.gz;13;0;13;23.96 MB;1.84 MB
/snapshots/targets/sunxi/cortexa7/openwrt-sunxi-cortexa7-cubietech_cubietruck-squashfs-sdcard.img.gz;13;0;13;47.29 MB;3.64 MB
/snapshots/targets/at91/sama5/openwrt-at91-sama5-microchip_sama5d27-som1-ek-ext4-root.ubi.gz;13;0;13;16.63 MB;1.28 MB
/snapshots/targets/armvirt/64/openwrt-armvirt-64-rootfs.cpio.gz;13;0;13;160 Bytes;12 Bytes
/snapshots/targets/at91/sama5/openwrt-at91-sama5-microchip_sama5d2-ptc-ek-ext4-root.ubi.gz;13;0;13;16.91 MB;1.30 MB
/snapshots/targets/pistachio/generic/openwrt-pistachio-img_creator-ci40-squashfs-sysupgrade.tar;13;0;13;41.77 MB;3.21 MB
/snapshots/targets/armvirt/32/openwrt-armvirt-32-rootfs.cpio.gz;13;0;13;140 Bytes;10 Bytes
/releases/18.06.8/targets/sunxi/cortexa7/openwrt-18.06.8-sunxi-cortexa7-sun8i-h3-orangepi-pc-squashfs-sdcard.img.gz;13;0;13;20.38 MB;1.57 MB
/snapshots/targets/at91/sam9x/openwrt-at91-sam9x-atmel_at91sam9g15ek-ext4-root.ubi.gz;13;0;13;17.43 MB;1.34 MB
/releases/19.07.2/targets/brcm2708/bcm2710/openwrt-19.07.2-brcm2708-bcm2710-rpi-3-ext4-factory.img.gz;13;9;22;171.88 MB;7.81 MB
/snapshots/targets/at91/sama5/openwrt-at91-sama5-microchip_sama5d2-ptc-ek-ext4-sdcard.img.gz;13;0;13;47.89 MB;3.68 MB
/snapshots/targets/at91/sam9x/openwrt-at91-sam9x-atmel_at91sam9x25ek-ext4-sdcard.img.gz;13;0;13;32.63 MB;2.51 MB
/releases/18.06.1/targets/armvirt/32/openwrt-18.06.1-armvirt-32-root.squashfs.gz;13;1;14;18.59 MB;1.33 MB
/releases/18.06.5/targets/ar71xx/mikrotik/openwrt-18.06.5-ar71xx-mikrotik-vmlinux.lzma;13;0;13;7.18 MB;565.84 KB
/snapshots/targets/tegra/generic/openwrt-tegra-compulab_trimslice-ext4-sdcard.img.gz;13;0;13;53.68 MB;4.13 MB
/snapshots/targets/sunxi/cortexa7/openwrt-sunxi-cortexa7-lemaker_bananapro-squashfs-sdcard.img.gz;13;0;13;48.22 MB;3.71 MB
/snapshots/targets/at91/sam9x/openwrt-at91-sam9x-atmel_at91sam9g20ek-ext4-root.ubi.gz;13;0;13;17.40 MB;1.34 MB
/releases/18.06.8/targets/brcm2708/bcm2708/openwrt-18.06.8-brcm2708-bcm2708-rpi-ext4-sysupgrade.img.gz;13;0;13;60.72 MB;4.67 MB
/snapshots/targets/oxnas/ox820/openwrt-oxnas-ox820-cloudengines_pogoplug-series-3-squashfs-sysupgrade.tar;13;1;14;40.16 MB;2.87 MB
/releases/18.06.8/targets/sunxi/cortexa7/openwrt-18.06.8-sunxi-cortexa7-sun8i-h3-nanopi-neo-squashfs-sdcard.img.gz;13;0;13;19.81 MB;1.52 MB
/releases/19.07.2/targets/x86/generic/openwrt-19.07.2-x86-generic-combined-squashfs.img.gz;13;14;27;87.06 MB;3.22 MB
/snapshots/targets/at91/sam9x/openwrt-at91-sam9x-atmel_at91sam9263ek-ext4-root.ubi.gz;13;0;13;17.54 MB;1.35 MB
/snapshots/targets/oxnas/ox820/openwrt-oxnas-ox820-mitrastar_stg-212-squashfs-sysupgrade.tar;13;0;13;43.24 MB;3.33 MB
/releases/19.07.4/targets/oxnas/ox820/openwrt-19.07.4-oxnas-ox820-mitrastar_stg-212-ubifs-sysupgrade.tar;13;0;13;37.25 MB;2.87 MB
/releases/19.07.4/targets/at91/sam9x/openwrt-19.07.4-at91-sam9x-wb45n-ext4-root.ubi.gz;13;0;13;15.18 MB;1.17 MB
/snapshots/targets/at91/sama5/openwrt-at91-sama5-microchip_sama5d2-xplained-ext4-root.ubi.gz;13;0;13;16.65 MB;1.28 MB
/releases/18.06.5/targets/ar71xx/mikrotik/openwrt-18.06.5-ar71xx-mikrotik-vmlinux-initramfs.lzma;13;0;13;18.56 MB;1.43 MB
/snapshots/targets/sunxi/cortexa7/openwrt-sunxi-cortexa7-olimex_a20-olinuxino-micro-ext4-sdcard.img.gz;13;0;13;49.97 MB;3.84 MB
/releases/18.06.8/targets/x86/64/openwrt-18.06.8-x86-64-rootfs-squashfs.img.gz;13;0;13;18.99 MB;1.46 MB
/snapshots/targets/sunxi/cortexa7/openwrt-sunxi-cortexa7-xunlong_orangepi-2-squashfs-sdcard.img.gz;13;0;13;43.38 MB;3.34 MB
/releases/18.06.1/targets/brcm2708/bcm2708/openwrt-18.06.1-brcm2708-bcm2708-rpi-ext4-factory.img.gz;13;64;77;92.31 MB;1.20 MB
/releases/19.07.2/targets/sunxi/cortexa7/openwrt-19.07.2-sunxi-cortexa7-sun8i-h2-plus-orangepi-r1-ext4-sdcard.img.gz;13;4;17;66.16 MB;3.89 MB
/releases/18.06.7/targets/ar71xx/nand/openwrt-18.06.7-ar71xx-nand-vmlinux.lzma;13;0;13;14.98 MB;1.15 MB
/releases/17.01.1/targets/octeon/generic/lede-17.01.1-octeon-erlite-squashfs-sysupgrade.tar;13;0;13;86.01 MB;6.62 MB
/snapshots/targets/at91/sam9x/openwrt-at91-sam9x-laird_wb45n-ext4-root.ubi.gz;13;0;13;30.60 MB;2.35 MB
/releases/19.07.4/targets/at91/sama5/openwrt-19.07.4-at91-sama5-rootfs.tar.gz;13;0;13;8.67 MB;683.02 KB
/snapshots/targets/oxnas/ox820/openwrt-oxnas-ox820-shuttle_kd20-ubifs-sysupgrade.tar;12;0;12;66.90 MB;5.57 MB
/snapshots/targets/x86/legacy/openwrt-x86-legacy-rootfs.tar.gz;12;0;12;21.94 MB;1.83 MB
/snapshots/targets/at91/sam9x/openwrt-at91-sam9x-atmel_at91sam9g20ek-2mmc-ext4-root.ubi.gz;12;0;12;17.33 MB;1.44 MB
/releases/17.01.6/targets/ar71xx/nand/lede-17.01.6-ar71xx-nand-vmlinux.lzma;12;0;12;8.26 MB;705.17 KB
/snapshots/targets/oxnas/ox820/openwrt-oxnas-ox820-mitrastar_stg-212-ubifs-sysupgrade.tar;12;0;12;66.03 MB;5.50 MB
/snapshots/targets/layerscape/armv7/openwrt-layerscape-armv7-fsl_ls1021a-iot-sdboot-squashfs-sdcard.img.gz;12;0;12;50.83 MB;4.24 MB
/snapshots/targets/octeon/generic/openwrt-octeon-ubnt_edgerouter-4-squashfs-sysupgrade.tar;12;1;13;102.05 MB;7.85 MB
/snapshots/targets/pistachio/generic/openwrt-pistachio-rootfs.tar.gz;12;0;12;15.00 MB;1.25 MB
/releases/17.01.7/targets/ar71xx/mikrotik/lede-17.01.7-ar71xx-mikrotik-vmlinux-initramfs.lzma;12;0;12;9.22 MB;786.46 KB
/releases/17.01.5/targets/ar71xx/mikrotik/lede-17.01.5-ar71xx-mikrotik-vmlinux-initramfs.lzma;12;0;12;15.86 MB;1.32 MB
/releases/17.01.0-rc1/targets/ath25/generic/lede-17.01.0-rc1-r3042-ec095b5-ath25-generic-kernel.lzma;12;0;12;9.22 MB;786.56 KB
/snapshots/targets/at91/sam9x/openwrt-at91-sam9x-atmel_at91sam9x35ek-ext4-root.ubi.gz;12;0;12;17.33 MB;1.44 MB
/snapshots/targets/at91/sam9x/openwrt-at91-sam9x-atmel_at91sam9m10g45ek-ext4-root.ubi.gz;12;0;12;17.33 MB;1.44 MB
/releases/18.06.8/targets/sunxi/cortexa7/openwrt-18.06.8-sunxi-cortexa7-sun7i-a20-pcduino3-ext4-sdcard.img.gz;12;0;12;30.15 MB;2.51 MB
/releases/17.01.6/targets/x86/64/lede-17.01.6-x86-64-combined-ext4.img.gz;12;20;32;49.86 MB;1.56 MB
/snapshots/targets/oxnas/ox820/openwrt-oxnas-ox820-cloudengines_pogoplugpro-ubifs-sysupgrade.tar;12;0;12;67.99 MB;5.67 MB
/releases/19.07.1/targets/ar71xx/tiny/openwrt-19.07.1-ar71xx-tiny-vmlinux.lzma;12;0;12;7.12 MB;607.66 KB
/releases/17.01.1/targets/ar71xx/generic/lede-17.01.1-ar71xx-generic-vmlinux.lzma;12;0;12;9.47 MB;807.92 KB
/snapshots/targets/at91/sam9x/openwrt-at91-sam9x-calao_tny-a9g20-ext4-factory.bin.gz;12;0;12;30.33 MB;2.53 MB
/releases/18.06.4/targets/ar71xx/nand/openwrt-18.06.4-ar71xx-nand-vmlinux.lzma;12;0;12;4.18 MB;356.91 KB
/releases/19.07.4/targets/ar71xx/nand/openwrt-19.07.4-ar71xx-nand-c-60-squashfs-sysupgrade.tar;12;0;12;21.94 MB;1.83 MB
/snapshots/targets/at91/sama5/openwrt-at91-sama5-rootfs.tar.gz;12;0;12;15.20 MB;1.27 MB
/snapshots/targets/at91/sam9x/openwrt-at91-sam9x-atmel_at91sam9x35ek-ext4-sdcard.img.gz;12;0;12;32.42 MB;2.70 MB
/releases/18.06.2/targets/x86/64/openwrt-18.06.2-x86-64-combined-squashfs.img.gz;12;9;21;52.29 MB;2.49 MB
/releases/18.06.0-rc2/targets/ar71xx/mikrotik/openwrt-18.06.0-rc2-ar71xx-mikrotik-vmlinux.lzma;12;0;12;13.51 MB;1.13 MB
/snapshots/targets/imx6/generic/openwrt-imx6-rootfs.tar.gz;12;0;12;18.89 MB;1.57 MB
/snapshots/targets/at91/sam9x/openwrt-at91-sam9x-atmel_at91sam9x25ek-ext4-root.ubi.gz;12;0;12;17.33 MB;1.44 MB
/releases/17.01.5/targets/ath25/generic/lede-17.01.5-ath25-generic-kernel.lzma;12;0;12;5.26 MB;449.14 KB
/snapshots/targets/sunxi/cortexa7/openwrt-sunxi-cortexa7-cubietech_cubieboard2-ext4-sdcard.img.gz;12;0;12;38.04 MB;3.17 MB
/releases/19.07.3/targets/armvirt/64/openwrt-19.07.3-armvirt-64-default-rootfs.tar.gz;12;0;12;24.64 MB;2.05 MB
/snapshots/targets/at91/sam9x/openwrt-at91-sam9x-calao_usb-a9g20-ext4-factory.bin.gz;12;0;12;30.33 MB;2.53 MB
/snapshots/targets/at91/sam9x/openwrt-at91-sam9x-egnite_ethernut5-ext4-root.ubi.gz;12;0;12;17.33 MB;1.44 MB
/releases/17.01.6/targets/ar71xx/mikrotik/lede-17.01.6-ar71xx-mikrotik-vmlinux-initramfs.lzma;12;0;12;2.34 MB;199.75 KB
/snapshots/targets/oxnas/ox820/openwrt-oxnas-ox820-cloudengines_pogoplug-series-3-ubifs-sysupgrade.tar;12;0;12;60.84 MB;5.07 MB
/releases/17.01.0-rc1/targets/ar71xx/nand/lede-17.01.0-rc1-r3042-ec095b5-ar71xx-nand-vmlinux.lzma;12;0;12;6.70 MB;571.83 KB
/snapshots/targets/sunxi/cortexa7/openwrt-sunxi-cortexa7-friendlyarm_zeropi-squashfs-sdcard.img.gz;12;0;12;38.79 MB;3.23 MB
/releases/18.06.8/targets/brcm2708/bcm2709/openwrt-18.06.8-brcm2708-bcm2709-rpi-2-ext4-sysupgrade.img.gz;12;0;12;33.68 MB;2.81 MB
/releases/19.07.0-rc1/targets/ath25/generic/openwrt-19.07.0-rc1-ath25-generic-kernel.lzma;12;0;12;5.14 MB;438.28 KB
/snapshots/targets/layerscape/armv7/openwrt-layerscape-armv7-fsl_ls1021a-twr-sdboot-squashfs-sdcard.img.gz;12;0;12;51.32 MB;4.28 MB
/releases/18.06.8/targets/sunxi/cortexa7/openwrt-18.06.8-sunxi-cortexa7-sun8i-h2-plus-orangepi-r1-squashfs-sdcard.img.gz;12;0;12;19.25 MB;1.60 MB
/releases/18.06.8/targets/apm821xx/nand/openwrt-18.06.8-apm821xx-nand-meraki_mr24-squashfs-sysupgrade.tar;12;0;12;23.65 MB;1.97 MB
/snapshots/targets/at91/sam9x/openwrt-at91-sam9x-calao_usb-a9263-ext4-factory.bin.gz;12;0;12;30.33 MB;2.53 MB
/releases/18.06.8/targets/x86/legacy/openwrt-18.06.8-x86-legacy-rootfs-ext4.img.gz;12;11;23;17.08 MB;760.55 KB
/snapshots/targets/at91/sam9x/openwrt-at91-sam9x-rootfs.tar.gz;12;0;12;16.28 MB;1.36 MB
/releases/18.06.8/targets/sunxi/cortexa53/openwrt-18.06.8-sunxi-cortexa53-sun50i-h5-orangepi-zero-plus-squashfs-sdcard.img.gz;12;0;12;24.69 MB;2.06 MB
/snapshots/targets/oxnas/ox820/openwrt-oxnas-ox820-akitio_mycloud-ubifs-sysupgrade.tar;12;0;12;60.88 MB;5.07 MB
/snapshots/targets/at91/sam9x/openwrt-at91-sam9x-calamp_lmu5000-ext4-factory.bin.gz;12;0;12;30.58 MB;2.55 MB
/snapshots/targets/at91/sam9x/openwrt-at91-sam9x-calao_tny-a9260-ext4-factory.bin.gz;12;0;12;30.32 MB;2.53 MB
/snapshots/targets/at91/sam9x/openwrt-at91-sam9x-calao_usb-a9260-ext4-factory.bin.gz;12;0;12;30.33 MB;2.53 MB
/snapshots/targets/at91/sam9x/openwrt-at91-sam9x-calao_tny-a9263-ext4-factory.bin.gz;12;0;12;30.32 MB;2.53 MB
/releases/17.01.2/targets/ath25/generic/lede-17.01.2-ath25-generic-kernel.lzma;11;0;11;5.25 MB;488.57 KB
/releases/18.06.8/targets/apm821xx/nand/openwrt-18.06.8-apm821xx-nand-netgear_wndr4700-squashfs-sysupgrade.tar;11;9;20;20.18 MB;1.01 MB
/releases/18.06.4/targets/brcm2708/bcm2710/openwrt-18.06.4-brcm2708-bcm2710-rpi-3-ext4-factory.img.gz;11;23;34;71.41 MB;2.10 MB
/releases/18.06.4/targets/x86/legacy/openwrt-18.06.4-x86-legacy-combined-ext4.img.gz;11;5;16;60.51 MB;3.78 MB
/snapshots/targets/at91/legacy/openwrt-at91-legacy-lmu5000-ext4-factory.bin.gz;11;0;11;31.90 MB;2.90 MB
/releases/18.06.8/targets/ar71xx/nand/openwrt-18.06.8-ar71xx-nand-wndr3700v4-squashfs-sysupgrade.tar;11;0;11;19.37 MB;1.76 MB
/snapshots/targets/layerscape/armv8_64b/openwrt-layerscape-armv8_64b-fsl_ls1043a-rdb-sdboot-squashfs-sdcard.img.gz;11;0;11;68.20 MB;6.20 MB
/releases/18.06.3/targets/ar71xx/mikrotik/openwrt-18.06.3-ar71xx-mikrotik-vmlinux-initramfs.lzma;11;0;11;9.78 MB;910.17 KB
/releases/18.06.8/targets/sunxi/cortexa8/openwrt-18.06.8-sunxi-cortexa8-sun4i-a10-olinuxino-lime-squashfs-sdcard.img.gz;11;0;11;17.99 MB;1.64 MB
/releases/18.06.8/targets/sunxi/cortexa53/openwrt-18.06.8-sunxi-cortexa53-sun50i-a64-pine64-plus-squashfs-sdcard.img.gz;11;0;11;25.80 MB;2.35 MB
/releases/18.06.8/targets/sunxi/cortexa7/openwrt-18.06.8-sunxi-cortexa7-sun7i-a20-cubietruck-squashfs-sdcard.img.gz;11;0;11;20.71 MB;1.88 MB
/releases/18.06.8/targets/oxnas/ox820/openwrt-18.06.8-oxnas-ox820-cloudengines-pogoplug-pro-squashfs-sysupgrade.tar;11;12;23;20.93 MB;931.92 KB
/releases/18.06.8/targets/ramips/mt7621/openwrt-18.06.8-ramips-mt7621-ubnt-erx-squashfs-sysupgrade.tar;11;16;27;21.45 MB;813.42 KB
/releases/18.06.2/targets/x86/64/openwrt-18.06.2-x86-64-generic-rootfs.tar.gz;11;0;11;25.30 MB;2.30 MB
/releases/19.07.2/targets/ar71xx/mikrotik/openwrt-19.07.2-ar71xx-mikrotik-vmlinux-initramfs.lzma;11;0;11;9.10 MB;847.58 KB
/releases/19.07.0-rc2/targets/x86/generic/openwrt-19.07.0-rc2-x86-generic-combined-ext4.img.gz;11;86;97;58.06 MB;612.89 KB
/releases/18.06.8/targets/sunxi/cortexa7/openwrt-18.06.8-sunxi-cortexa7-sun8i-h3-orangepi-plus-squashfs-sdcard.img.gz;11;0;11;20.56 MB;1.87 MB
/releases/18.06.8/targets/sunxi/cortexa7/openwrt-18.06.8-sunxi-cortexa7-sun8i-h2-plus-orangepi-r1-ext4-sdcard.img.gz;11;0;11;22.83 MB;2.08 MB
/releases/18.06.8/targets/sunxi/cortexa53/openwrt-18.06.8-sunxi-cortexa53-sun50i-h5-nanopi-neo-plus2-squashfs-sdcard.img.gz;11;0;11;19.63 MB;1.78 MB
/snapshots/targets/layerscape/armv8_64b/openwrt-layerscape-armv8_64b-fsl_ls1088a-rdb-sdboot-squashfs-sdcard.img.gz;11;0;11;71.41 MB;6.49 MB
/releases/18.06.8/targets/brcm2708/bcm2710/openwrt-18.06.8-brcm2708-bcm2710-rpi-3-squashfs-sysupgrade.img.gz;11;0;11;18.43 MB;1.68 MB
/snapshots/targets/sunxi/cortexa7/openwrt-sunxi-cortexa7-mele_m9-ext4-sdcard.img.gz;11;0;11;40.66 MB;3.70 MB
/releases/18.06.1/targets/ramips/mt7621/openwrt-18.06.1-ramips-mt7621-mir3g-squashfs-sysupgrade.tar;11;0;11;28.51 MB;2.59 MB
/releases/18.06.8/targets/brcm2708/bcm2708/openwrt-18.06.8-brcm2708-bcm2708-rpi-ext4-factory.img.gz;11;0;11;45.12 MB;4.10 MB
/releases/18.06.8/targets/x86/generic/openwrt-18.06.8-x86-generic-rootfs-squashfs.img.gz;11;0;11;11.44 MB;1.04 MB
/releases/18.06.1/targets/x86/64/openwrt-18.06.1-x86-64-combined-squashfs.img.gz;11;13;24;49.68 MB;2.07 MB
/releases/18.06.8/targets/sunxi/cortexa8/openwrt-18.06.8-sunxi-cortexa8-sun4i-a10-cubieboard-squashfs-sdcard.img.gz;11;0;11;22.40 MB;2.04 MB
/releases/18.06.2/targets/sunxi/cortexa7/openwrt-18.06.2-sunxi-cortexa7-sun7i-a20-lamobo-r1-ext4-sdcard.img.gz;11;0;11;61.08 MB;5.55 MB
/releases/18.06.5/targets/ramips/mt7621/openwrt-18.06.5-ramips-mt7621-r6220-squashfs-sysupgrade.tar;11;48;59;30.45 MB;528.47 KB
/releases/18.06.8/targets/sunxi/cortexa7/openwrt-18.06.8-sunxi-cortexa7-sun8i-h3-nanopi-m1-plus-ext4-sdcard.img.gz;11;0;11;26.43 MB;2.40 MB
/releases/18.06.8/targets/sunxi/cortexa7/openwrt-18.06.8-sunxi-cortexa7-sun7i-a20-olinuxino-lime2-emmc-ext4-sdcard.img.gz;11;0;11;17.22 MB;1.57 MB
/releases/18.06.8/targets/brcm2708/bcm2710/openwrt-18.06.8-brcm2708-bcm2710-rpi-3-ext4-sysupgrade.img.gz;11;8;19;60.39 MB;3.18 MB
/snapshots/targets/layerscape/armv8_64b/openwrt-layerscape-armv8_64b-fsl_ls1012a-frwy-sdboot-squashfs-sdcard.img.gz;11;0;11;65.61 MB;5.96 MB
/releases/17.01.0/targets/ar71xx/mikrotik/lede-17.01.0-r3205-59508e3-ar71xx-mikrotik-vmlinux.lzma;11;0;11;7.36 MB;684.95 KB
/releases/18.06.2/targets/ar71xx/mikrotik/openwrt-18.06.2-ar71xx-mikrotik-vmlinux.lzma;11;0;11;3.96 MB;369.04 KB
/releases/18.06.6/targets/ar71xx/mikrotik/openwrt-18.06.6-ar71xx-mikrotik-vmlinux-initramfs.lzma;11;0;11;8.45 MB;786.49 KB
/releases/18.06.8/targets/sunxi/cortexa53/openwrt-18.06.8-sunxi-cortexa53-sun50i-h5-orangepi-zero-plus-ext4-sdcard.img.gz;11;0;11;21.38 MB;1.94 MB
/releases/17.01.5/targets/ar71xx/nand/lede-17.01.5-ar71xx-nand-vmlinux.lzma;11;0;11;6.06 MB;564.16 KB
/releases/18.06.4/targets/ath25/generic/openwrt-18.06.4-ath25-generic-kernel.lzma;11;0;11;8.11 MB;754.62 KB
/releases/18.06.2/targets/ar71xx/generic/openwrt-18.06.2-ar71xx-generic-vmlinux.lzma;11;0;11;15.12 MB;1.38 MB
/releases/17.01.4/targets/ath25/generic/lede-17.01.4-ath25-generic-kernel.lzma;11;0;11;6.31 MB;587.50 KB
/releases/18.06.8/targets/sunxi/cortexa53/openwrt-18.06.8-sunxi-cortexa53-sun50i-h5-nanopi-neo-plus2-ext4-sdcard.img.gz;10;0;10;25.41 MB;2.54 MB
/releases/18.06.8/targets/at91/sama5d2/openwrt-18.06.8-at91-sama5d2-at91-sama5d2_ptc_ek-ext4-zImage.gz;10;0;10;12.42 MB;1.24 MB
/snapshots/targets/at91/legacy/openwrt-at91-legacy-usb_a9g20-ext4-factory.bin.gz;10;0;10;16.53 MB;1.65 MB
/snapshots/targets/at91/sama5d3/openwrt-at91-sama5d3-at91-sama5d3_xplained-ext4-zImage.gz;10;0;10;13.28 MB;1.33 MB
/releases/17.01.4/targets/ar71xx/generic/lede-17.01.4-ar71xx-generic-vmlinux.lzma;10;0;10;8.26 MB;846.32 KB
/releases/18.06.8/targets/mxs/generic/openwrt-18.06.8-mxs-duckbill-sdcard.img.gz;10;0;10;44.66 MB;4.47 MB
/releases/19.07.2/targets/ar71xx/tiny/openwrt-19.07.2-ar71xx-tiny-vmlinux.lzma;10;0;10;4.86 MB;497.23 KB
/releases/18.06.7/targets/ath25/generic/openwrt-18.06.7-ath25-generic-kernel.lzma;10;0;10;4.81 MB;492.43 KB
/releases/18.06.4/targets/armvirt/32/openwrt-18.06.4-armvirt-32-default-rootfs.tar.gz;10;41;51;15.50 MB;311.28 KB
/releases/18.06.8/targets/sunxi/cortexa53/openwrt-18.06.8-sunxi-cortexa53-sun50i-a64-sopine-baseboard-squashfs-sdcard.img.gz;10;0;10;21.93 MB;2.19 MB
/releases/18.06.1/targets/brcm2708/bcm2710/openwrt-18.06.1-brcm2708-bcm2710-rpi-3-squashfs-factory.img.gz;10;3;13;64.53 MB;4.96 MB
/releases/19.07.3/targets/armvirt/64/openwrt-19.07.3-armvirt-64-root.ext4.gz;10;0;10;23.19 MB;2.32 MB
/releases/18.06.8/targets/sunxi/cortexa53/openwrt-18.06.8-sunxi-cortexa53-sun50i-a64-sopine-baseboard-ext4-sdcard.img.gz;10;0;10;26.04 MB;2.60 MB
/releases/18.06.0-rc1/targets/ar71xx/tiny/openwrt-18.06.0-rc1-ar71xx-tiny-vmlinux.lzma;10;0;10;11.05 MB;1.10 MB
/releases/18.06.8/targets/sunxi/cortexa7/openwrt-18.06.8-sunxi-cortexa7-sun8i-h3-orangepi-plus-ext4-sdcard.img.gz;10;0;10;21.23 MB;2.12 MB
/releases/18.06.8/targets/at91/sama5d2/openwrt-18.06.8-at91-sama5d2-at91-sama5d2_xplained-ext4-zImage.gz;10;0;10;12.57 MB;1.26 MB
/releases/18.06.8/targets/at91/sama5d2/openwrt-18.06.8-at91-sama5d2-at91-sama5d2_xplained-ext4-sdcard.img.gz;10;0;10;22.80 MB;2.28 MB
/releases/19.07.3/targets/ar71xx/mikrotik/openwrt-19.07.3-ar71xx-mikrotik-vmlinux-initramfs.lzma;10;0;10;7.51 MB;769.19 KB
/releases/18.06.8/targets/sunxi/cortexa7/openwrt-18.06.8-sunxi-cortexa7-sun8i-h3-orangepi-2-squashfs-sdcard.img.gz;10;0;10;17.93 MB;1.79 MB
/releases/18.06.4/targets/x86/64/openwrt-18.06.4-x86-64-rootfs-ext4.img.gz;10;7;17;25.88 MB;1.52 MB
/releases/18.06.8/targets/sunxi/cortexa7/openwrt-18.06.8-sunxi-cortexa7-sun7i-a20-olinuxino-lime-squashfs-sdcard.img.gz;10;0;10;14.04 MB;1.40 MB
/releases/18.06.8/targets/sunxi/cortexa7/openwrt-18.06.8-sunxi-cortexa7-sun8i-h3-nanopi-m1-plus-squashfs-sdcard.img.gz;10;0;10;20.58 MB;2.06 MB
/releases/18.06.3/targets/ath25/generic/openwrt-18.06.3-ath25-generic-kernel.lzma;10;0;10;6.07 MB;622.03 KB
/releases/19.07.1/targets/ar71xx/nand/openwrt-19.07.1-ar71xx-nand-vmlinux.lzma;10;0;10;10.75 MB;1.07 MB
/releases/18.06.6/targets/ar71xx/mikrotik/openwrt-18.06.6-ar71xx-mikrotik-vmlinux.lzma;10;0;10;5.00 MB;511.63 KB
/releases/18.06.8/targets/at91/sama5d2/openwrt-18.06.8-at91-sama5d2-at91-sama5d2_xplained-ext4-root.ubi.gz;10;0;10;9.49 MB;972.21 KB
/releases/18.06.8/targets/omap/generic/openwrt-18.06.8-omap-am335x-boneblack-ext4-sdcard.img.gz;10;0;10;19.12 MB;1.91 MB
/releases/18.06.8/targets/sunxi/cortexa7/openwrt-18.06.8-sunxi-cortexa7-sun7i-a20-lamobo-r1-ext4-sdcard.img.gz;10;0;10;24.93 MB;2.49 MB
/snapshots/targets/at91/legacy/openwrt-at91-legacy-wb45n-ext4-root.ubi.gz;10;0;10;13.01 MB;1.30 MB
/releases/18.06.8/targets/sunxi/cortexa7/openwrt-18.06.8-sunxi-cortexa7-sun7i-a20-olinuxino-lime2-emmc-squashfs-sdcard.img.gz;10;0;10;14.76 MB;1.48 MB
/releases/18.06.8/targets/sunxi/cortexa7/openwrt-18.06.8-sunxi-cortexa7-sun7i-a20-lamobo-r1-squashfs-sdcard.img.gz;10;0;10;16.64 MB;1.66 MB
/releases/17.01.5/targets/ar71xx/mikrotik/lede-17.01.5-ar71xx-mikrotik-vmlinux.lzma;10;0;10;7.81 MB;799.88 KB
/releases/18.06.8/targets/sunxi/cortexa7/openwrt-18.06.8-sunxi-cortexa7-sun7i-a20-cubieboard2-ext4-sdcard.img.gz;10;0;10;21.63 MB;2.16 MB
/releases/19.07.3/targets/brcm2708/bcm2710/openwrt-19.07.3-brcm2708-bcm2710-rpi-3-ext4-sysupgrade.img.gz;10;0;10;57.74 MB;5.77 MB
/releases/18.06.8/targets/sunxi/cortexa8/openwrt-18.06.8-sunxi-cortexa8-sun4i-a10-pcduino-ext4-sdcard.img.gz;10;0;10;22.91 MB;2.29 MB
/snapshots/targets/at91/legacy/openwrt-at91-legacy-ethernut5-ext4-root.ubi.gz;10;0;10;7.97 MB;816.10 KB
/releases/18.06.8/targets/sunxi/cortexa7/openwrt-18.06.8-sunxi-cortexa7-sun7i-a20-olinuxino-lime2-ext4-sdcard.img.gz;10;0;10;17.50 MB;1.75 MB
/releases/18.06.8/targets/sunxi/cortexa8/openwrt-18.06.8-sunxi-cortexa8-sun4i-a10-pcduino-squashfs-sdcard.img.gz;10;0;10;19.16 MB;1.92 MB
/releases/17.01.0-rc2/targets/ar71xx/nand/lede-17.01.0-rc2-r3131-42f3c1f-ar71xx-nand-vmlinux.lzma;10;0;10;4.39 MB;449.42 KB
/releases/18.06.8/targets/sunxi/cortexa7/openwrt-18.06.8-sunxi-cortexa7-sun7i-a20-olinuxino-micro-squashfs-sdcard.img.gz;10;0;10;14.79 MB;1.48 MB
/releases/18.06.8/targets/omap/generic/openwrt-18.06.8-omap-am335x-evm-ext4-sdcard.img.gz;10;0;10;19.23 MB;1.92 MB
/releases/19.07.3/targets/x86/generic/openwrt-19.07.3-x86-generic-combined-squashfs.img.gz;10;47;57;64.78 MB;1.14 MB
/releases/18.06.8/targets/at91/sama5d2/openwrt-18.06.8-at91-sama5d2-at91-sama5d27_som1_ek-ext4-sdcard.img.gz;10;0;10;22.64 MB;2.26 MB
/releases/18.06.7/targets/ar71xx/mikrotik/openwrt-18.06.7-ar71xx-mikrotik-vmlinux-initramfs.lzma;10;0;10;9.11 MB;932.43 KB
/releases/18.06.8/targets/sunxi/cortexa7/openwrt-18.06.8-sunxi-cortexa7-sun7i-a20-cubieboard2-squashfs-sdcard.img.gz;10;0;10;14.01 MB;1.40 MB
/releases/18.06.8/targets/sunxi/cortexa7/openwrt-18.06.8-sunxi-cortexa7-sun8i-h3-orangepi-pc-ext4-sdcard.img.gz;10;0;10;21.61 MB;2.16 MB
/releases/18.06.8/targets/sunxi/cortexa7/openwrt-18.06.8-sunxi-cortexa7-sun7i-a20-olinuxino-lime2-squashfs-sdcard.img.gz;10;0;10;14.48 MB;1.45 MB
/releases/18.06.8/targets/sunxi/cortexa8/openwrt-18.06.8-sunxi-cortexa8-sun4i-a10-olinuxino-lime-ext4-sdcard.img.gz;10;0;10;21.30 MB;2.13 MB
/releases/19.07.2/targets/ar71xx/mikrotik/openwrt-19.07.2-ar71xx-mikrotik-vmlinux.lzma;10;0;10;7.95 MB;814.12 KB
/releases/18.06.8/targets/sunxi/cortexa7/openwrt-18.06.8-sunxi-cortexa7-sun7i-a20-pcduino3-squashfs-sdcard.img.gz;10;0;10;19.87 MB;1.99 MB
/releases/18.06.8/targets/apm821xx/sata/openwrt-18.06.8-apm821xx-sata-wd_mybooklive-ext4-rootfs.img.gz;10;0;10;19.65 MB;1.96 MB
/releases/18.06.8/targets/sunxi/cortexa8/openwrt-18.06.8-sunxi-cortexa8-sun4i-a10-cubieboard-ext4-sdcard.img.gz;10;0;10;26.29 MB;2.63 MB
/releases/18.06.8/targets/ramips/mt7621/openwrt-18.06.8-ramips-mt7621-r6220-squashfs-sysupgrade.tar;10;0;10;20.85 MB;2.09 MB
/releases/18.06.8/targets/x86/geode/openwrt-18.06.8-x86-geode-combined-squashfs.img.gz;10;19;29;33.55 MB;1.16 MB
/releases/18.06.6/targets/x86/64/openwrt-18.06.6-x86-64-combined-ext4.img.gz;10;4;14;39.57 MB;2.83 MB
/releases/18.06.8/targets/sunxi/cortexa7/openwrt-18.06.8-sunxi-cortexa7-sun6i-a31-m9-ext4-sdcard.img.gz;10;0;10;17.73 MB;1.77 MB
/releases/17.01.0-rc2/targets/ath25/generic/lede-17.01.0-rc2-r3131-42f3c1f-ath25-generic-kernel.lzma;10;0;10;5.15 MB;527.85 KB
/releases/17.01.6/targets/ath25/generic/lede-17.01.6-ath25-generic-kernel.lzma;9;0;9;5.64 MB;641.61 KB
/snapshots/targets/at91/sama5d4/openwrt-at91-sama5d4-at91-sama5d4_xplained-ext4-sdcard.img.gz;9;0;9;16.73 MB;1.86 MB
/releases/19.07.0/targets/ar71xx/nand/openwrt-19.07.0-ar71xx-nand-vmlinux.lzma;9;0;9;6.20 MB;705.47 KB
/releases/18.06.8/targets/omap/generic/openwrt-18.06.8-omap-omap4-panda-ubifs-sdcard.img.gz;9;0;9;12.96 MB;1.44 MB
/releases/19.07.1/targets/ar71xx/mikrotik/openwrt-19.07.1-ar71xx-mikrotik-vmlinux-initramfs.lzma;9;0;9;17.69 MB;1.97 MB
/releases/18.06.8/targets/sunxi/cortexa7/openwrt-18.06.8-sunxi-cortexa7-sun7i-a20-bananapi-ext4-sdcard.img.gz;9;0;9;16.12 MB;1.79 MB
/releases/19.07.0-rc2/targets/ar71xx/mikrotik/openwrt-19.07.0-rc2-ar71xx-mikrotik-vmlinux-initramfs.lzma;9;0;9;9.73 MB;1.08 MB
/releases/18.06.8/targets/sunxi/cortexa7/openwrt-18.06.8-sunxi-cortexa7-sun7i-a20-olinuxino-lime-ext4-sdcard.img.gz;9;0;9;16.50 MB;1.83 MB
/releases/18.06.8/targets/armvirt/64/openwrt-18.06.8-armvirt-64-root.squashfs.gz;9;0;9;4.32 MB;491.02 KB
/releases/18.06.8/targets/omap/generic/openwrt-18.06.8-omap-omap3-beagle-ext4-sdcard.img.gz;9;0;9;12.52 MB;1.39 MB
/snapshots/targets/layerscape/armv8_32b/openwrt-layerscape-armv8_32b-ls1012afrwy-ext4-firmware.bin.gz;9;0;9;1.15 MB;130.94 KB
/releases/18.06.8/targets/sunxi/cortexa8/openwrt-18.06.8-sunxi-cortexa8-sun5i-a13-olinuxino-squashfs-sdcard.img.gz;9;0;9;14.42 MB;1.60 MB
/releases/18.06.8/targets/sunxi/cortexa8/openwrt-18.06.8-sunxi-cortexa8-sun4i-a10-marsboard-squashfs-sdcard.img.gz;9;0;9;17.67 MB;1.96 MB
/releases/19.07.3/targets/ath25/generic/openwrt-19.07.3-ath25-generic-kernel.lzma;9;0;9;6.40 MB;728.53 KB
/releases/17.01.7/targets/ar71xx/mikrotik/lede-17.01.7-ar71xx-mikrotik-vmlinux.lzma;9;0;9;4.37 MB;497.58 KB
/releases/18.06.8/targets/sunxi/cortexa7/openwrt-18.06.8-sunxi-cortexa7-sun6i-a31-m9-squashfs-sdcard.img.gz;9;0;9;14.85 MB;1.65 MB
/snapshots/targets/at91/legacy/openwrt-at91-legacy-at91sam9g20ek-ext4-root.ubi.gz;9;0;9;6.20 MB;704.91 KB
/snapshots/targets/at91/legacy/openwrt-at91-legacy-at91sam9263ek-ext4-root.ubi.gz;9;0;9;6.20 MB;704.85 KB
/releases/18.06.8/targets/omap/generic/openwrt-18.06.8-omap-omap3-beagle-ubifs-sdcard.img.gz;9;0;9;12.69 MB;1.41 MB
/releases/18.06.8/targets/octeontx/generic/openwrt-18.06.8-octeontx-default-rootfs.tar.gz;9;0;9;6.09 MB;693.39 KB
/releases/18.06.8/targets/at91/sama5d3/openwrt-18.06.8-at91-sama5d3-at91-sama5d3_xplained-ext4-sdcard.img.gz;9;0;9;17.50 MB;1.94 MB
/releases/18.06.0-rc2/targets/ar71xx/nand/openwrt-18.06.0-rc2-ar71xx-nand-vmlinux.lzma;9;0;9;6.15 MB;700.14 KB
/releases/18.06.8/targets/sunxi/cortexa7/openwrt-18.06.8-sunxi-cortexa7-sun8i-h3-orangepi-2-ext4-sdcard.img.gz;9;0;9;16.24 MB;1.80 MB
/releases/19.07.2/targets/x86/legacy/openwrt-19.07.2-x86-legacy-combined-ext4.img.gz;9;2;11;59.25 MB;5.39 MB
/snapshots/targets/at91/legacy/openwrt-at91-legacy-at91sam9m10g45ek-ext4-root.ubi.gz;9;0;9;6.10 MB;694.19 KB
/releases/18.06.1/targets/ar71xx/mikrotik/openwrt-18.06.1-ar71xx-mikrotik-vmlinux.lzma;9;0;9;4.32 MB;492.09 KB
/releases/18.06.8/targets/armvirt/32/openwrt-18.06.8-armvirt-32-rootfs.cpio.gz;9;0;9;80 Bytes;8 Bytes
/releases/18.06.8/targets/sunxi/cortexa7/openwrt-18.06.8-sunxi-cortexa7-sun8i-h3-nanopi-neo-ext4-sdcard.img.gz;9;0;9;15.90 MB;1.77 MB
/snapshots/targets/malta/le/kernel-debug.tar.bz2;9;0;9;28.73 MB;3.19 MB
/snapshots/targets/at91/sama5d3/kernel-debug.tar.bz2;9;0;9;37.47 MB;4.16 MB
/releases/18.06.8/targets/brcm2708/bcm2708/openwrt-18.06.8-brcm2708-bcm2708-rpi-squashfs-factory.img.gz;9;0;9;23.62 MB;2.62 MB
/releases/18.06.8/targets/brcm2708/bcm2709/openwrt-18.06.8-brcm2708-bcm2709-rpi-2-squashfs-sysupgrade.img.gz;9;0;9;24.13 MB;2.68 MB
/releases/18.06.8/targets/armvirt/64/openwrt-18.06.8-armvirt-64-default-rootfs.tar.gz;9;0;9;7.00 MB;796.30 KB
/releases/18.06.8/targets/at91/sama5d2/openwrt-18.06.8-at91-sama5d2-at91-sama5d2_ptc_ek-ext4-root.ubi.gz;9;0;9;7.41 MB;843.40 KB
/releases/18.06.1/targets/ath25/generic/openwrt-18.06.1-ath25-generic-kernel.lzma;9;0;9;3.42 MB;388.93 KB
/releases/18.06.6/targets/ath25/generic/openwrt-18.06.6-ath25-generic-kernel.lzma;9;0;9;6.83 MB;776.58 KB
/releases/18.06.8/targets/apm821xx/sata/openwrt-18.06.8-apm821xx-sata-wd_mybooklive-duo-ext4-rootfs.img.gz;9;0;9;16.00 MB;1.78 MB
/releases/18.06.8/targets/oxnas/ox820/openwrt-18.06.8-oxnas-ox820-cloudengines-pogoplug-pro-ubifs-sysupgrade.tar;9;16;25;26.16 MB;1.05 MB
/releases/19.07.0/targets/x86/generic/openwrt-19.07.0-x86-generic-combined-squashfs.img.gz;9;4;13;47.20 MB;3.63 MB
/releases/18.06.8/targets/ar71xx/nand/openwrt-18.06.8-ar71xx-nand-rambutan-squashfs-sysupgrade.tar;9;0;9;8.97 MB;1020.34 KB
/releases/18.06.1/targets/mvebu/cortexa9/omnia-medkit-openwrt-18.06.1-mvebu-cortexa9-turris-omnia-initramfs.tar.gz;9;0;9;13.00 MB;1.44 MB
/releases/19.07.3/targets/x86/64/openwrt-19.07.3-x86-64-rootfs-squashfs.img.gz;9;2;11;20.34 MB;1.85 MB
/releases/18.06.8/targets/x86/geode/openwrt-18.06.8-x86-geode-rootfs-squashfs.img.gz;9;0;9;10.91 MB;1.21 MB
/releases/18.06.2/targets/ath25/generic/openwrt-18.06.2-ath25-generic-kernel.lzma;9;0;9;4.50 MB;511.64 KB
/releases/18.06.8/targets/omap/generic/openwrt-18.06.8-omap-am335x-evm-ubifs-sdcard.img.gz;9;0;9;13.57 MB;1.51 MB
/releases/19.07.0-rc2/targets/ar71xx/nand/openwrt-19.07.0-rc2-ar71xx-nand-vmlinux.lzma;9;0;9;3.15 MB;358.65 KB
/releases/19.07.0-rc2/targets/ar71xx/tiny/openwrt-19.07.0-rc2-ar71xx-tiny-vmlinux.lzma;9;0;9;5.28 MB;600.58 KB
/releases/18.06.8/targets/sunxi/cortexa7/openwrt-18.06.8-sunxi-cortexa7-sun7i-a20-cubietruck-ext4-sdcard.img.gz;9;0;9;18.58 MB;2.06 MB
/releases/18.06.8/targets/imx6/generic/openwrt-18.06.8-imx6-rootfs.tar.gz;9;0;9;6.26 MB;711.88 KB
/releases/18.06.9/targets/x86/64/openwrt-18.06.9-x86-64-combined-squashfs.img.gz;9;21;30;60.06 MB;2.00 MB
/releases/18.06.8/targets/armvirt/64/openwrt-18.06.8-armvirt-64-root.ext4.gz;9;0;9;5.91 MB;672.13 KB
/snapshots/targets/at91/legacy/openwrt-at91-legacy-at91sam9x35ek-ext4-root.ubi.gz;9;0;9;6.07 MB;690.62 KB
/releases/18.06.8/targets/sunxi/cortexa7/openwrt-18.06.8-sunxi-cortexa7-sun7i-a20-bananapro-squashfs-sdcard.img.gz;9;0;9;16.32 MB;1.81 MB
/releases/18.06.2/targets/brcm2708/bcm2710/openwrt-18.06.2-brcm2708-bcm2710-rpi-3-ext4-factory.img.gz;9;0;9;48.18 MB;5.35 MB
/releases/18.06.8/targets/at91/sama5d3/openwrt-18.06.8-at91-sama5d3-at91-sama5d3_xplained-ext4-root.ubi.gz;9;0;9;7.60 MB;864.71 KB
/releases/18.06.8/targets/mvebu/cortexa72/openwrt-18.06.8-mvebu-cortexa72-armada-macchiatobin-ext4-sdcard.img.gz;9;0;9;12.96 MB;1.44 MB
/snapshots/targets/at91/legacy/openwrt-at91-legacy-at91sam9263ek-ext4-zImage.gz;9;0;9;10.26 MB;1.14 MB
/releases/19.07.1/targets/x86/64/openwrt-19.07.1-x86-64-combined-squashfs.img.gz;9;0;9;40.56 MB;4.51 MB
/snapshots/targets/at91/legacy/openwrt-at91-legacy-at91sam9g20ek_2mmc-ext4-zImage.gz;9;0;9;10.14 MB;1.13 MB
/releases/18.06.8/targets/apm821xx/nand/openwrt-18.06.8-apm821xx-nand-meraki_mx60-squashfs-sysupgrade.tar;9;0;9;12.37 MB;1.37 MB
/releases/18.06.8/targets/pistachio/generic/openwrt-18.06.8-pistachio-rootfs.tar.gz;9;0;9;4.46 MB;507.67 KB
/snapshots/targets/at91/sama5d4/openwrt-at91-sama5d4-at91-sama5d4_xplained-ext4-zImage.gz;9;0;9;10.24 MB;1.14 MB
/releases/18.06.8/targets/omap/generic/openwrt-18.06.8-omap-rootfs.tar.gz;9;0;9;4.73 MB;538.33 KB
/releases/18.06.5/targets/ar71xx/nand/openwrt-18.06.5-ar71xx-nand-vmlinux.lzma;9;0;9;3.34 MB;380.04 KB
/releases/18.06.8/targets/arc770/generic/openwrt-18.06.8-arc770-generic-Default-sdcard-vfat-ext4.img.gz;9;0;9;15.82 MB;1.76 MB
/snapshots/targets/at91/sama5d2/openwrt-at91-sama5d2-at91-sama5d27_som1_ek-ext4-zImage.gz;9;0;9;9.94 MB;1.10 MB
/releases/18.06.7/targets/ar71xx/mikrotik/openwrt-18.06.7-ar71xx-mikrotik-vmlinux.lzma;9;0;9;6.00 MB;682.36 KB
/releases/18.06.8/targets/mvebu/cortexa72/openwrt-18.06.8-mvebu-cortexa72-armada-macchiatobin-squashfs-sdcard.img.gz;9;0;9;11.33 MB;1.26 MB
/snapshots/targets/at91/legacy/openwrt-at91-legacy-at91sam9g15ek-ext4-root.ubi.gz;9;0;9;6.01 MB;683.35 KB
/snapshots/targets/layerscape/armv8_32b/kernel-debug.tar.bz2;9;0;9;282.51 MB;31.39 MB
/releases/18.06.8/targets/at91/sama5d2/openwrt-18.06.8-at91-sama5d2-at91-sama5d27_som1_ek-ext4-root.ubi.gz;9;0;9;7.30 MB;830.96 KB
/snapshots/targets/at91/legacy/openwrt-at91-legacy-at91sam9g20ek-ext4-zImage.gz;9;0;9;9.94 MB;1.10 MB
/releases/18.06.8/targets/at91/legacy/openwrt-18.06.8-at91-legacy-at91sam9m10g45ek-ext4-root.ubi.gz;9;0;9;5.34 MB;607.24 KB
/snapshots/targets/at91/legacy/openwrt-at91-legacy-at91sam9g25ek-ext4-root.ubi.gz;9;0;9;4.19 MB;476.39 KB
/snapshots/targets/malta/be/openwrt-malta-be-rootfs.cpio.gz;9;0;9;80 Bytes;8 Bytes
/releases/18.06.4/targets/ar71xx/mikrotik/openwrt-18.06.4-ar71xx-mikrotik-vmlinux.lzma;9;0;9;6.94 MB;789.08 KB
/releases/18.06.8/targets/ar71xx/nand/openwrt-18.06.8-ar71xx-nand-r6100-squashfs-sysupgrade.tar;9;0;9;10.98 MB;1.22 MB
/releases/18.06.8/targets/at91/sama5d2/openwrt-18.06.8-at91-sama5d2-at91-sama5d27_som1_ek-ext4-zImage.gz;9;0;9;9.66 MB;1.07 MB
/snapshots/targets/at91/legacy/openwrt-at91-legacy-tny_a9260-ext4-factory.bin.gz;9;0;9;15.97 MB;1.77 MB
/releases/18.06.8/targets/ar71xx/nand/openwrt-18.06.8-ar71xx-nand-c-60-squashfs-sysupgrade.tar;9;0;9;8.36 MB;951.01 KB
/releases/18.06.8/targets/sunxi/cortexa7/openwrt-18.06.8-sunxi-cortexa7-sun7i-a20-olinuxino-micro-ext4-sdcard.img.gz;9;0;9;16.50 MB;1.83 MB
/releases/18.06.8/targets/sunxi/cortexa7/openwrt-18.06.8-sunxi-cortexa7-sun7i-a20-bananapi-squashfs-sdcard.img.gz;9;0;9;14.14 MB;1.57 MB
/releases/18.06.8/targets/sunxi/cortexa8/openwrt-18.06.8-sunxi-cortexa8-sun4i-a10-marsboard-ext4-sdcard.img.gz;9;0;9;21.02 MB;2.34 MB
/releases/18.06.8/targets/x86/generic/openwrt-18.06.8-x86-generic-rootfs-ext4.img.gz;9;0;9;12.03 MB;1.34 MB
/releases/18.06.8/targets/ar71xx/nand/openwrt-18.06.8-ar71xx-nand-hiveap-121-squashfs-sysupgrade.tar;9;0;9;8.25 MB;939.01 KB
/releases/18.06.8/targets/mvebu/cortexa9/omnia-medkit-openwrt-18.06.8-mvebu-cortexa9-turris-omnia-initramfs.tar.gz;9;0;9;12.12 MB;1.35 MB
/releases/18.06.8/targets/ar71xx/nand/openwrt-18.06.8-ar71xx-nand-nbg6716-squashfs-sysupgrade.tar;9;0;9;10.45 MB;1.16 MB
/releases/18.06.8/targets/sunxi/cortexa7/openwrt-18.06.8-sunxi-cortexa7-sun7i-a20-bananapro-ext4-sdcard.img.gz;9;0;9;19.03 MB;2.11 MB
/snapshots/targets/at91/legacy/openwrt-at91-legacy-at91sam9g20ek_2mmc-ext4-root.ubi.gz;9;0;9;4.19 MB;476.38 KB
/releases/17.01.0-rc2/targets/ar71xx/mikrotik/lede-17.01.0-rc2-r3131-42f3c1f-ar71xx-mikrotik-vmlinux-initramfs.lzma;9;0;9;6.14 MB;698.47 KB
/releases/18.06.8/targets/rb532/generic/openwrt-18.06.8-rb532-default-rootfs.tar.gz;8;0;8;10.20 MB;1.27 MB
/releases/18.06.8/targets/at91/legacy/openwrt-18.06.8-at91-legacy-at91sam9g15ek-ext4-root.ubi.gz;8;0;8;4.74 MB;607.22 KB
/releases/18.06.8/targets/oxnas/ox820/openwrt-18.06.8-oxnas-ox820-mitrastar-stg212-squashfs-sysupgrade.tar;8;0;8;9.79 MB;1.22 MB
/snapshots/targets/at91/legacy/openwrt-at91-legacy-rootfs.tar.gz;8;0;8;3.45 MB;441.86 KB
/releases/17.01.7/targets/x86/64/lede-17.01.7-x86-64-combined-ext4.img.gz;8;97;105;48.32 MB;471.28 KB
/snapshots/targets/at91/legacy/openwrt-at91-legacy-tny_a9263-ext4-factory.bin.gz;8;0;8;12.41 MB;1.55 MB
/releases/18.06.8/targets/mvebu/cortexa53/openwrt-18.06.8-mvebu-cortexa53-globalscale-espressobin-squashfs-sdcard.img.gz;8;0;8;11.17 MB;1.40 MB
/releases/18.06.8/targets/x86/legacy/openwrt-18.06.8-x86-legacy-rootfs-squashfs.img.gz;8;0;8;6.92 MB;886.35 KB
/releases/18.06.8/targets/at91/sama5d4/openwrt-18.06.8-at91-sama5d4-rootfs.tar.gz;8;0;8;5.06 MB;648.09 KB
/snapshots/targets/at91/sama5d3/openwrt-at91-sama5d3-at91-sama5d3_xplained-ext4-sdcard.img.gz;8;0;8;11.14 MB;1.39 MB
/snapshots/targets/at91/legacy/openwrt-at91-legacy-at91sam9g35ek-ext4-root.ubi.gz;8;0;8;4.12 MB;527.94 KB
/releases/18.06.8/targets/sunxi/cortexa8/openwrt-18.06.8-sunxi-cortexa8-sun5i-a13-olinuxino-ext4-sdcard.img.gz;8;0;8;17.16 MB;2.15 MB
/snapshots/targets/at91/sama5d4/openwrt-at91-sama5d4-rootfs.tar.gz;8;0;8;3.72 MB;475.61 KB
/snapshots/targets/mpc85xx/generic/kernel-debug.tar.bz2;8;0;8;183.86 MB;22.98 MB
/snapshots/targets/at91/sama5d3/openwrt-at91-sama5d3-rootfs.tar.gz;8;0;8;3.46 MB;442.98 KB
/releases/18.06.8/targets/ar71xx/nand/openwrt-18.06.8-ar71xx-nand-wi2a-ac200i-squashfs-sysupgrade.tar;8;0;8;8.15 MB;1.02 MB
/releases/18.06.8/targets/at91/legacy/openwrt-18.06.8-at91-legacy-at91sam9g20ek-ext4-zImage.gz;8;0;8;6.27 MB;803.13 KB
/snapshots/targets/at91/sama5d4/openwrt-at91-sama5d4-at91-sama5d4_xplained-ext4-root.ubi.gz;8;0;8;4.41 MB;564.62 KB
/releases/18.06.8/targets/oxnas/ox820/openwrt-18.06.8-oxnas-ox820-cloudengines-pogoplug-series-3-ubifs-sysupgrade.tar;8;0;8;16.14 MB;2.02 MB
/releases/18.06.8/targets/oxnas/ox820/openwrt-18.06.8-oxnas-ox820-cloudengines-pogoplug-series-3-squashfs-sysupgrade.tar;8;0;8;9.75 MB;1.22 MB
/releases/19.07.0-rc2/targets/ath25/generic/openwrt-19.07.0-rc2-ath25-generic-kernel.lzma;8;0;8;6.26 MB;801.77 KB
/releases/18.06.6/targets/ar71xx/nand/openwrt-18.06.6-ar71xx-nand-vmlinux.lzma;8;0;8;3.70 MB;473.60 KB
/releases/18.06.8/targets/gemini/generic/openwrt-18.06.8-gemini-nas4220b-hddapp.tgz;8;0;8;20.74 MB;2.59 MB
/releases/18.06.8/targets/at91/sama5d2/openwrt-18.06.8-at91-sama5d2-at91-sama5d2_ptc_ek-ext4-sdcard.img.gz;8;0;8;12.16 MB;1.52 MB
/snapshots/targets/at91/sama5d4/kernel-debug.tar.bz2;8;0;8;26.36 MB;3.29 MB
/releases/18.06.8/targets/at91/legacy/openwrt-18.06.8-at91-legacy-ethernut5-ext4-root.ubi.gz;8;0;8;4.75 MB;607.48 KB
/snapshots/targets/at91/legacy/openwrt-at91-legacy-tny_a9g20-ext4-factory.bin.gz;8;0;8;10.78 MB;1.35 MB
/releases/18.06.8/targets/oxnas/ox820/openwrt-18.06.8-oxnas-ox820-mitrastar-stg212-ubifs-sysupgrade.tar;8;0;8;16.57 MB;2.07 MB
/releases/18.06.8/targets/at91/legacy/openwrt-18.06.8-at91-legacy-at91sam9g25ek-ext4-root.ubi.gz;8;0;8;5.70 MB;729.23 KB
/releases/18.06.8/targets/omap/generic/openwrt-18.06.8-omap-omap4-panda-ext4-sdcard.img.gz;8;0;8;11.77 MB;1.47 MB
/releases/18.06.0-rc1/targets/ar71xx/mikrotik/openwrt-18.06.0-rc1-ar71xx-mikrotik-vmlinux-initramfs.lzma;8;0;8;15.67 MB;1.96 MB
/releases/18.06.4/targets/ar71xx/mikrotik/openwrt-18.06.4-ar71xx-mikrotik-vmlinux-initramfs.lzma;8;0;8;8.84 MB;1.11 MB
/releases/18.06.8/targets/sunxi/cortexa8/openwrt-18.06.8-sunxi-cortexa8-sun5i-a13-olimex-som-squashfs-sdcard.img.gz;8;0;8;14.24 MB;1.78 MB
/releases/18.06.8/targets/armvirt/32/openwrt-18.06.8-armvirt-32-root.squashfs.gz;8;0;8;4.06 MB;520.26 KB
/releases/18.06.8/targets/archs38/generic/openwrt-18.06.8-archs38-generic-Default-sdcard-vfat-ext4.img.gz;8;0;8;12.59 MB;1.57 MB
/releases/18.06.8/targets/archs38/generic/openwrt-18.06.8-archs38-generic-root.ext4.gz;8;0;8;6.54 MB;836.56 KB
/releases/18.06.8/targets/armvirt/32/openwrt-18.06.8-armvirt-32-default-rootfs.tar.gz;8;0;8;4.44 MB;568.87 KB
/snapshots/targets/at91/sama5d2/openwrt-at91-sama5d2-at91-sama5d2_ptc_ek-ext4-root.ubi.gz;8;0;8;4.03 MB;515.28 KB
/releases/17.01.0-rc1/targets/ar71xx/mikrotik/lede-17.01.0-rc1-r3042-ec095b5-ar71xx-mikrotik-vmlinux-initramfs.lzma;8;0;8;11.01 MB;1.38 MB
/releases/18.06.8/targets/omap/generic/openwrt-18.06.8-omap-am335x-boneblack-ubifs-sdcard.img.gz;8;0;8;12.06 MB;1.51 MB
/releases/18.06.8/targets/oxnas/ox820/openwrt-18.06.8-oxnas-ox820-akitio-mycloud-squashfs-sysupgrade.tar;8;0;8;10.43 MB;1.30 MB
/releases/19.07.3/targets/ar71xx/mikrotik/openwrt-19.07.3-ar71xx-mikrotik-vmlinux.lzma;8;0;8;4.65 MB;595.65 KB
/releases/18.06.4/targets/brcm2708/bcm2710/openwrt-18.06.4-brcm2708-bcm2710-rpi-3-squashfs-factory.img.gz;8;38;46;44.47 MB;989.89 KB
/releases/18.06.8/targets/at91/sama5d4/openwrt-18.06.8-at91-sama5d4-at91-sama5d4_xplained-ext4-sdcard.img.gz;8;0;8;12.68 MB;1.58 MB
/releases/18.06.3/targets/ar71xx/nand/openwrt-18.06.3-ar71xx-nand-vmlinux.lzma;8;0;8;5.22 MB;667.71 KB
/releases/18.06.8/targets/mxs/generic/openwrt-18.06.8-mxs-root.ext4.gz;8;0;8;10.96 MB;1.37 MB
/snapshots/targets/at91/legacy/openwrt-at91-legacy-usb_a9263-ext4-factory.bin.gz;8;0;8;11.41 MB;1.43 MB
/releases/18.06.8/targets/brcm2708/bcm2708/openwrt-18.06.8-brcm2708-bcm2708-rpi-squashfs-sysupgrade.img.gz;8;0;8;16.46 MB;2.06 MB
/releases/18.06.8/targets/octeon/generic/openwrt-18.06.8-octeon-er-squashfs-sysupgrade.tar;8;0;8;17.82 MB;2.23 MB
/releases/19.07.0/targets/ar71xx/tiny/openwrt-19.07.0-ar71xx-tiny-vmlinux.lzma;8;0;8;7.55 MB;965.83 KB
/releases/18.06.8/targets/at91/sama5d4/openwrt-18.06.8-at91-sama5d4-at91-sama5d4_xplained-ext4-zImage.gz;8;0;8;6.91 MB;885.04 KB
/releases/19.07.0/targets/brcm2708/bcm2710/openwrt-19.07.0-brcm2708-bcm2710-rpi-3-squashfs-sysupgrade.img.gz;8;86;94;62.88 MB;685.01 KB
/snapshots/targets/layerscape/armv8_32b/openwrt-layerscape-armv8_32b-ls1012afrwy-ext4-sdcard.img.gz;8;0;8;19.72 MB;2.47 MB
/releases/18.06.8/targets/mvebu/cortexa9/openwrt-18.06.8-mvebu-cortexa9-turris-omnia-sysupgrade.img.gz;8;0;8;10.53 MB;1.32 MB
/releases/18.06.8/targets/at91/sama5d3/openwrt-18.06.8-at91-sama5d3-at91-sama5d3_xplained-ext4-zImage.gz;8;0;8;6.90 MB;883.10 KB
/releases/18.06.8/targets/oxnas/ox820/openwrt-18.06.8-oxnas-ox820-shuttle-kd20-ubifs-sysupgrade.tar;8;0;8;18.53 MB;2.32 MB
/releases/18.06.8/targets/at91/sama5d4/openwrt-18.06.8-at91-sama5d4-at91-sama5d4_xplained-ext4-root.ubi.gz;8;0;8;5.38 MB;688.39 KB
/releases/18.06.8/targets/gemini/generic/openwrt-18.06.8-gemini-dns313-bootpart.tar.gz;8;0;8;5.56 MB;712.23 KB
/releases/18.06.8/targets/oxnas/ox820/openwrt-18.06.8-oxnas-ox820-akitio-mycloud-ubifs-sysupgrade.tar;8;0;8;16.75 MB;2.09 MB
/releases/17.01.2/targets/ar71xx/nand/lede-17.01.2-ar71xx-nand-vmlinux.lzma;8;0;8;3.84 MB;491.81 KB
/releases/18.06.8/targets/brcm2708/bcm2709/openwrt-18.06.8-brcm2708-bcm2709-rpi-2-squashfs-factory.img.gz;8;0;8;16.87 MB;2.11 MB
/snapshots/targets/at91/legacy/openwrt-at91-legacy-at91sam9x25ek-ext4-root.ubi.gz;8;0;8;4.22 MB;539.93 KB
/releases/18.06.8/targets/armvirt/64/openwrt-18.06.8-armvirt-64-rootfs.cpio.gz;8;0;8;60 Bytes;7 Bytes
/releases/18.06.8/targets/ramips/mt7621/openwrt-18.06.8-ramips-mt7621-ubnt-erx-sfp-squashfs-sysupgrade.tar;8;0;8;10.17 MB;1.27 MB
/releases/18.06.8/targets/at91/legacy/openwrt-18.06.8-at91-legacy-at91sam9263ek-ext4-zImage.gz;8;0;8;6.27 MB;803.13 KB
/releases/17.01.3/targets/ar71xx/mikrotik/lede-17.01.3-ar71xx-mikrotik-vmlinux.lzma;8;0;8;6.00 MB;767.91 KB
/releases/19.07.1/targets/ath25/generic/openwrt-19.07.1-ath25-generic-kernel.lzma;8;0;8;6.44 MB;823.71 KB
/snapshots/targets/gemini/wiligear/kernel-debug.tar.bz2;8;0;8;18.43 MB;2.30 MB
/releases/18.06.8/targets/ar71xx/nand/openwrt-18.06.8-ar71xx-nand-z1-squashfs-sysupgrade.tar;8;0;8;13.54 MB;1.69 MB
/releases/18.06.0/targets/ar71xx/mikrotik/openwrt-18.06.0-ar71xx-mikrotik-vmlinux-initramfs.lzma;8;0;8;10.31 MB;1.29 MB
/releases/19.07.0/targets/brcm2708/bcm2710/openwrt-19.07.0-brcm2708-bcm2710-rpi-3-ext4-sysupgrade.img.gz;8;67;75;64.04 MB;874.41 KB
/snapshots/targets/at91/legacy/openwrt-at91-legacy-usb_a9260-ext4-factory.bin.gz;8;0;8;10.91 MB;1.36 MB
/releases/18.06.8/targets/arc770/generic/openwrt-18.06.8-arc770-generic-root.ext4.gz;8;0;8;6.85 MB;876.42 KB
/releases/18.06.8/targets/sunxi/cortexa8/openwrt-18.06.8-sunxi-cortexa8-sun5i-a13-olimex-som-ext4-sdcard.img.gz;8;0;8;17.07 MB;2.13 MB
/snapshots/targets/gemini/raidsonic/openwrt-gemini-raidsonic-nas4220-hddapp.tgz;8;0;8;20.19 MB;2.52 MB
/releases/18.06.3/targets/ar71xx/mikrotik/openwrt-18.06.3-ar71xx-mikrotik-vmlinux.lzma;8;0;8;3.64 MB;465.60 KB
/releases/18.06.8/targets/oxnas/ox820/openwrt-18.06.8-oxnas-ox820-shuttle-kd20-factory.tar.gz;8;0;8;14.28 MB;1.79 MB
/snapshots/targets/at91/sama5d3/openwrt-at91-sama5d3-at91-sama5d3_xplained-ext4-root.ubi.gz;8;0;8;4.12 MB;527.09 KB
/releases/17.01.0-rc1/targets/ar71xx/mikrotik/lede-17.01.0-rc1-r3042-ec095b5-ar71xx-mikrotik-vmlinux.lzma;8;0;8;5.28 MB;675.87 KB
/releases/18.06.8/targets/oxnas/ox820/openwrt-18.06.8-oxnas-ox820-shuttle-kd20-squashfs-sysupgrade.tar;8;0;8;10.90 MB;1.36 MB
/releases/18.06.8/targets/at91/legacy/openwrt-18.06.8-at91-legacy-at91sam9g35ek-ext4-root.ubi.gz;8;0;8;5.37 MB;687.18 KB
/releases/19.07.0-rc1/targets/ar71xx/mikrotik/openwrt-19.07.0-rc1-ar71xx-mikrotik-vmlinux.lzma;8;0;8;4.67 MB;597.60 KB
/releases/18.06.8/targets/ar71xx/nand/openwrt-18.06.8-ar71xx-nand-mr18-squashfs-sysupgrade.tar;8;0;8;13.60 MB;1.70 MB
/releases/19.07.0-rc2/targets/ar71xx/mikrotik/openwrt-19.07.0-rc2-ar71xx-mikrotik-vmlinux.lzma;8;0;8;4.87 MB;623.65 KB
/releases/18.06.8/targets/imx6/generic/openwrt-18.06.8-imx6-ventana-squashfs-bootfs.tar.gz;8;0;8;5.45 MB;697.67 KB
/snapshots/targets/gemini/raidsonic/openwrt-gemini-raidsonic-sysupgrade-ib4220.tar.gz;8;0;8;17.66 MB;2.21 MB
/releases/18.06.8/targets/armvirt/32/openwrt-18.06.8-armvirt-32-root.ext4.gz;8;0;8;5.38 MB;688.33 KB
/releases/18.06.0/targets/ar71xx/nand/openwrt-18.06.0-ar71xx-nand-vmlinux.lzma;8;0;8;6.01 MB;769.71 KB
/releases/17.01.4/targets/x86/generic/lede-17.01.4-x86-generic-combined-ext4.img.gz;8;0;8;42.34 MB;5.29 MB
/releases/18.06.0/targets/x86/generic/openwrt-18.06.0-x86-generic-combined-squashfs.img.gz;8;12;20;22.22 MB;1.11 MB
/releases/17.01.0/targets/x86/generic/lede-17.01.0-r3205-59508e3-x86-generic-generic-rootfs.tar.gz;8;0;8;18.95 MB;2.37 MB
/releases/18.06.8/targets/at91/sama5d2/openwrt-18.06.8-at91-sama5d2-rootfs.tar.gz;8;0;8;4.28 MB;548.10 KB
/releases/19.07.1/targets/ar71xx/mikrotik/openwrt-19.07.1-ar71xx-mikrotik-vmlinux.lzma;8;0;8;11.81 MB;1.48 MB
/releases/18.06.8/targets/at91/legacy/openwrt-18.06.8-at91-legacy-at91sam9x25ek-ext4-root.ubi.gz;8;0;8;5.21 MB;667.09 KB
/snapshots/targets/at91/sama5d2/openwrt-at91-sama5d2-at91-sama5d2_ptc_ek-ext4-sdcard.img.gz;8;0;8;13.67 MB;1.71 MB
/snapshots/targets/malta/le64/kernel-debug.tar.bz2;8;0;8;20.99 MB;2.62 MB
/releases/19.07.0-rc1/targets/ar71xx/tiny/openwrt-19.07.0-rc1-ar71xx-tiny-vmlinux.lzma;8;0;8;4.31 MB;551.66 KB
/releases/18.06.8/targets/gemini/generic/openwrt-18.06.8-gemini-nas4220b-rd.gz;8;0;8;12.97 MB;1.62 MB
/snapshots/targets/gemini/raidsonic/openwrt-gemini-raidsonic-nas4220-rd.gz;8;0;8;7.91 MB;1011.94 KB
/releases/18.06.8/targets/at91/sama5d3/openwrt-18.06.8-at91-sama5d3-rootfs.tar.gz;8;0;8;4.69 MB;600.03 KB
/snapshots/targets/malta/be64/kernel-debug.tar.bz2;8;0;8;20.47 MB;2.56 MB
/releases/17.01.6/targets/brcm2708/bcm2710/lede-17.01.6-brcm2708-bcm2710-rpi-3-ext4-sdcard.img.gz;8;62;70;43.60 MB;637.85 KB
/releases/19.07-SNAPSHOT/targets/imx6/generic/openwrt-19.07-snapshot-r11239-733a482733-imx6-rootfs.tar.gz;8;50;58;7.35 MB;129.69 KB
/releases/18.06.0/targets/x86/generic/openwrt-18.06.0-x86-generic-combined-ext4.img.gz;8;30;38;25.23 MB;679.94 KB
/releases/18.06.8/targets/ath25/generic/openwrt-18.06.8-ath25-generic-kernel.gz;8;0;8;4.86 MB;621.94 KB
/releases/18.06.8/targets/x86/legacy/openwrt-18.06.8-x86-legacy-generic-rootfs.tar.gz;8;0;8;8.25 MB;1.03 MB
/releases/18.06.8/targets/sunxi/cortexa53/openwrt-18.06.8-sunxi-cortexa53-sun50i-a64-pine64-plus-ext4-sdcard.img.gz;8;0;8;19.19 MB;2.40 MB
/snapshots/targets/at91/legacy/kernel-debug.tar.bz2;8;0;8;24.46 MB;3.06 MB
/releases/19.07.0/targets/ath25/generic/openwrt-19.07.0-ath25-generic-kernel.lzma;8;0;8;4.23 MB;541.66 KB
/releases/18.06.8/targets/mvebu/cortexa9/openwrt-18.06.8-mvebu-cortexa9-armada-388-clearfog-base-squashfs-sdcard.img.gz;8;0;8;13.59 MB;1.70 MB
/snapshots/targets/gemini/raidsonic/kernel-debug.tar.bz2;8;0;8;18.86 MB;2.36 MB
/snapshots/targets/at91/sama5d2/openwrt-at91-sama5d2-at91-sama5d27_som1_ek-ext4-root.ubi.gz;7;0;7;3.93 MB;575.27 KB
/releases/18.06.4/targets/brcm2708/bcm2708/openwrt-18.06.4-brcm2708-bcm2708-rpi-squashfs-factory.img.gz;7;37;44;31.55 MB;734.27 KB
/snapshots/faillogs/x86_64/packages/frr/host-compile.txt;7;0;7;79.50 KB;11.36 KB
/releases/18.06.8/targets/at91/legacy/openwrt-18.06.8-at91-legacy-at91sam9g20ek_2mmc-ext4-zImage.gz;7;0;7;6.20 MB;906.50 KB
/releases/18.06.2/targets/ar71xx/nand/openwrt-18.06.2-ar71xx-nand-vmlinux.lzma;7;0;7;2.76 MB;404.18 KB
/releases/18.06.8/targets/at91/legacy/openwrt-18.06.8-at91-legacy-at91sam9g20ek-ext4-root.ubi.gz;7;0;7;4.71 MB;689.41 KB
/releases/19.07.3/targets/x86/64/openwrt-19.07.3-x86-64-generic-rootfs.tar.gz;7;1;8;13.02 MB;1.63 MB
/releases/19.07.0/targets/brcm2708/bcm2708/openwrt-19.07.0-brcm2708-bcm2708-rpi-ext4-sysupgrade.img.gz;7;1;8;69.10 MB;8.64 MB
/snapshots/targets/at91/sama5d2/openwrt-at91-sama5d2-at91-sama5d2_ptc_ek-ext4-zImage.gz;7;0;7;6.53 MB;954.56 KB
/releases/18.06.8/targets/at91/legacy/openwrt-18.06.8-at91-legacy-at91sam9x35ek-ext4-root.ubi.gz;7;0;7;4.71 MB;689.58 KB
/releases/17.01.6/targets/x86/generic/lede-17.01.6-x86-generic-combined-ext4.img.gz;7;11;18;40.55 MB;2.25 MB
/releases/18.06.8/targets/at91/legacy/openwrt-18.06.8-at91-legacy-usb_a9263-ext4-factory.bin.gz;7;0;7;10.96 MB;1.57 MB
/releases/18.06.7/targets/x86/generic/openwrt-18.06.7-x86-generic-combined-squashfs.img.gz;7;5;12;17.05 MB;1.42 MB
/releases/18.06.8/targets/brcm63xx/generic/openwrt-18.06.8-brcm63xx-generic-livebox-vmlinux.gz;7;0;7;3.88 MB;566.86 KB
/releases/18.06.2/targets/ar71xx/mikrotik/openwrt-18.06.2-ar71xx-mikrotik-vmlinux-initramfs.lzma;7;0;7;10.94 MB;1.56 MB
/releases/18.06.8/targets/gemini/generic/openwrt-18.06.8-gemini-sysupgrade-ib4220b.tar.gz;7;0;7;21.01 MB;3.00 MB
/releases/19.07.2/targets/x86/64/openwrt-19.07.2-x86-64-rootfs-ext4.img.gz;7;0;7;23.59 MB;3.37 MB
/releases/18.06.4/targets/gemini/generic/openwrt-18.06.4-gemini-nas4220b-rd.gz;7;0;7;36.16 MB;5.17 MB
/releases/18.06.8/targets/pistachio/generic/openwrt-18.06.8-pistachio-marduk-squashfs-sysupgrade.tar;7;0;7;9.49 MB;1.36 MB
/releases/18.06.8/targets/at91/legacy/openwrt-18.06.8-at91-legacy-tny_a9263-ext4-factory.bin.gz;7;0;7;10.96 MB;1.57 MB
/snapshots/targets/at91/sama5d2/openwrt-at91-sama5d2-at91-sama5d2_xplained-ext4-sdcard.img.gz;7;0;7;10.79 MB;1.54 MB
/releases/18.06.8/targets/at91/legacy/openwrt-18.06.8-at91-legacy-usb_a9g20-ext4-factory.bin.gz;7;0;7;10.96 MB;1.57 MB
/releases/18.06.8/targets/at91/legacy/openwrt-18.06.8-at91-legacy-tny_a9260-ext4-factory.bin.gz;7;0;7;10.96 MB;1.57 MB
/releases/18.06.8/targets/at91/legacy/openwrt-18.06.8-at91-legacy-at91sam9263ek-ext4-root.ubi.gz;7;0;7;4.71 MB;689.53 KB
/releases/19.07.1/targets/x86/generic/openwrt-19.07.1-x86-generic-combined-squashfs.img.gz;7;9;16;18.86 MB;1.18 MB
/releases/18.06.8/targets/at91/legacy/openwrt-18.06.8-at91-legacy-rootfs.tar.gz;7;0;7;3.99 MB;584.19 KB
/releases/18.06.8/targets/mvebu/cortexa9/openwrt-18.06.8-mvebu-cortexa9-armada-388-clearfog-pro-squashfs-sdcard.img.gz;7;0;7;9.07 MB;1.30 MB
/releases/17.01.4/targets/brcm2708/bcm2709/lede-17.01.4-brcm2708-bcm2709-rpi-2-ext4-sdcard.img.gz;7;2;9;37.23 MB;4.14 MB
/snapshots/targets/at91/sama5d2/openwrt-at91-sama5d2-at91-sama5d2_xplained-ext4-root.ubi.gz;7;0;7;3.93 MB;575.14 KB
/releases/18.06.8/targets/at91/legacy/openwrt-18.06.8-at91-legacy-lmu5000-ext4-factory.bin.gz;7;0;7;11.00 MB;1.57 MB
/releases/18.06.2/targets/oxnas/ox820/openwrt-18.06.2-oxnas-ox820-shuttle-kd20-factory.tar.gz;7;0;7;36.35 MB;5.19 MB
/releases/18.06.0/targets/brcm2708/bcm2708/openwrt-18.06.0-brcm2708-bcm2708-rpi-ext4-factory.img.gz;7;129;136;61.95 MB;466.42 KB
/releases/19.07.0-rc2/targets/brcm2708/bcm2710/openwrt-19.07.0-rc2-brcm2708-bcm2710-rpi-3-ext4-factory.img.gz;7;0;7;69.54 MB;9.93 MB
/releases/17.01.0-rc2/targets/ar71xx/generic/lede-17.01.0-rc2-r3131-42f3c1f-ar71xx-generic-vmlinux.lzma;7;0;7;4.25 MB;621.57 KB
/releases/18.06.8/targets/x86/geode/openwrt-18.06.8-x86-geode-rootfs-ext4.img.gz;7;0;7;9.03 MB;1.29 MB
/releases/18.06.8/targets/at91/legacy/openwrt-18.06.8-at91-legacy-wb45n-ext4-root.ubi.gz;7;0;7;7.13 MB;1.02 MB
/snapshots/targets/at91/sama5d2/openwrt-at91-sama5d2-at91-sama5d2_xplained-ext4-zImage.gz;7;0;7;6.53 MB;954.56 KB
/snapshots/faillogs/aarch64_generic/packages/frr/host-compile.txt;7;0;7;95.40 KB;13.63 KB
/releases/18.06.8/targets/at91/legacy/openwrt-18.06.8-at91-legacy-tny_a9g20-ext4-factory.bin.gz;7;0;7;10.96 MB;1.57 MB
/snapshots/targets/at91/sama5d2/openwrt-at91-sama5d2-at91-sama5d27_som1_ek-ext4-sdcard.img.gz;7;0;7;10.79 MB;1.54 MB
/snapshots/targets/at91/sama5d2/kernel-debug.tar.bz2;7;0;7;24.92 MB;3.56 MB
/releases/17.01.0/targets/ar71xx/generic/lede-17.01.0-r3205-59508e3-ar71xx-generic-vmlinux.lzma;7;0;7;3.51 MB;514.14 KB
/releases/17.01.0/targets/apm821xx/sata/lede-17.01.0-r3205-59508e3-apm821xx-sata-MyBookLiveDuo-ext4-rootfs.img.gz;7;5;12;16.90 MB;1.41 MB
/releases/18.06.8/targets/at91/legacy/openwrt-18.06.8-at91-legacy-usb_a9260-ext4-factory.bin.gz;7;0;7;10.96 MB;1.57 MB
/releases/19.07.3/targets/armvirt/32/openwrt-19.07.3-armvirt-32-root.ext4.gz;7;0;7;11.61 MB;1.66 MB
/snapshots/targets/at91/sama5d2/openwrt-at91-sama5d2-rootfs.tar.gz;7;0;7;3.22 MB;470.49 KB
/releases/18.06.4/targets/mvebu/cortexa9/omnia-medkit-openwrt-18.06.4-mvebu-cortexa9-turris-omnia-initramfs.tar.gz;7;0;7;18.89 MB;2.70 MB
/releases/17.01.7/targets/ath25/generic/lede-17.01.7-ath25-generic-kernel.lzma;7;0;7;3.78 MB;552.96 KB
/snapshots/targets/sunxi/cortexa53/openwrt-sunxi-cortexa53-libretech_all-h3-cc-h5-ext4-sdcard.img.gz;7;0;7;40.72 MB;5.82 MB
/releases/18.06.8/targets/at91/legacy/openwrt-18.06.8-at91-legacy-at91sam9g20ek_2mmc-ext4-root.ubi.gz;7;0;7;4.71 MB;689.55 KB
/releases/18.06.8/targets/octeon/generic/openwrt-18.06.8-octeon-erlite-squashfs-sysupgrade.tar;7;0;7;17.68 MB;2.53 MB
/snapshots/targets/sunxi/cortexa53/openwrt-sunxi-cortexa53-libretech_all-h3-cc-h5-squashfs-sdcard.img.gz;7;0;7;37.03 MB;5.29 MB
/releases/18.06.0-rc1/targets/ar71xx/nand/openwrt-18.06.0-rc1-ar71xx-nand-vmlinux.lzma;7;0;7;4.86 MB;710.53 KB
/releases/18.06.8/targets/brcm63xx/smp/openwrt-18.06.8-brcm63xx-smp-livebox-vmlinux.gz;7;0;7;4.25 MB;621.71 KB
/releases/19.07.1/targets/imx6/generic/openwrt-19.07.1-imx6-rootfs.tar.gz;6;27;33;9.84 MB;305.32 KB
/releases/18.06.2/targets/x86/64/openwrt-18.06.2-x86-64-rootfs-squashfs.img.gz;6;0;6;10.04 MB;1.67 MB
/releases/18.06.0-rc1/targets/ar71xx/mikrotik/openwrt-18.06.0-rc1-ar71xx-mikrotik-vmlinux.lzma;6;0;6;4.81 MB;821.10 KB
/releases/18.06.2/targets/brcm2708/bcm2710/openwrt-18.06.2-brcm2708-bcm2710-rpi-3-ext4-sysupgrade.img.gz;6;0;6;44.26 MB;7.38 MB
/releases/17.01.7/targets/brcm2708/bcm2710/lede-17.01.7-brcm2708-bcm2710-rpi-3-ext4-sdcard.img.gz;6;11;17;44.77 MB;2.63 MB
/releases/18.06.4/targets/gemini/generic/openwrt-18.06.4-gemini-sysupgrade-ib4220b.tar.gz;6;0;6;52.68 MB;8.78 MB
/releases/18.06.6/targets/x86/64/openwrt-18.06.6-x86-64-combined-squashfs.img.gz;6;15;21;17.85 MB;870.41 KB
/releases/19.07.0/targets/x86/64/openwrt-19.07.0-x86-64-rootfs-squashfs.img.gz;6;0;6;11.60 MB;1.93 MB
/releases/17.01.0/targets/ar71xx/nand/lede-17.01.0-r3205-59508e3-ar71xx-nand-wndr4300-squashfs-sysupgrade.tar;6;0;6;12.46 MB;2.08 MB
/releases/19.07.3/targets/brcm2708/bcm2710/openwrt-19.07.3-brcm2708-bcm2710-rpi-3-squashfs-factory.img.gz;6;0;6;61.28 MB;10.21 MB
/releases/19.07.3/targets/armvirt/64/openwrt-19.07.3-armvirt-64-root.squashfs.gz;6;0;6;9.89 MB;1.65 MB
/releases/19.07.3/targets/gemini/generic/openwrt-19.07.3-gemini-dlink_dns-313-ext4-factory.bin.gz;6;0;6;12.06 MB;2.01 MB
/releases/18.06.0/targets/x86/64/openwrt-18.06.0-x86-64-combined-squashfs.img.gz;6;0;6;12.03 MB;2.01 MB
/releases/19.07.3/targets/x86/geode/openwrt-19.07.3-x86-geode-combined-ext4.img.gz;6;0;6;29.92 MB;4.99 MB
/releases/19.07.2/targets/brcm2708/bcm2710/openwrt-19.07.2-brcm2708-bcm2710-rpi-3-squashfs-factory.img.gz;6;0;6;53.77 MB;8.96 MB
/releases/18.06.2/targets/ramips/mt7621/openwrt-18.06.2-ramips-mt7621-r6220-squashfs-sysupgrade.tar;6;2;8;13.24 MB;1.66 MB
/releases/19.07.3/targets/at91/sam9x/openwrt-19.07.3-at91-sam9x-rootfs.tar.gz;6;0;6;4.85 MB;827.07 KB
/releases/17.01.3/targets/ar71xx/nand/lede-17.01.3-ar71xx-nand-wndr3700v4-squashfs-sysupgrade.tar;6;0;6;9.37 MB;1.56 MB
/releases/18.06.5/targets/ar71xx/nand/openwrt-18.06.5-ar71xx-nand-r6100-squashfs-sysupgrade.tar;6;339;345;46.42 MB;137.78 KB
/releases/18.06.5/targets/ath25/generic/openwrt-18.06.5-ath25-generic-kernel.lzma;6;0;6;4.75 MB;810.44 KB
/releases/17.01.5/targets/ar71xx/nand/lede-17.01.5-ar71xx-nand-z1-squashfs-sysupgrade.tar;6;0;6;10.17 MB;1.70 MB
/releases/19.07.0/targets/sunxi/cortexa7/openwrt-19.07.0-sunxi-cortexa7-sun8i-h3-nanopi-neo-squashfs-sdcard.img.gz;6;0;6;19.22 MB;3.20 MB
/releases/19.07.0/targets/x86/64/openwrt-19.07.0-x86-64-rootfs-ext4.img.gz;6;0;6;16.45 MB;2.74 MB
/releases/19.07.0-rc1/targets/ar71xx/mikrotik/openwrt-19.07.0-rc1-ar71xx-mikrotik-vmlinux-initramfs.lzma;6;0;6;5.70 MB;972.95 KB
/releases/18.06.1/targets/at91/legacy/openwrt-18.06.1-at91-legacy-at91sam9g20ek_2mmc-ext4-root.ubi.gz;6;1;7;8.56 MB;1.22 MB
/releases/17.01.4/targets/omap/generic/lede-17.01.4-omap-default-rootfs.tar.gz;6;0;6;4.71 MB;803.49 KB
/releases/18.06.1/targets/x86/64/openwrt-18.06.1-x86-64-rootfs-ext4.img.gz;6;0;6;14.17 MB;2.36 MB
/releases/18.06.5/targets/x86/64/openwrt-18.06.5-x86-64-combined-squashfs.img.gz;6;0;6;28.56 MB;4.76 MB
/releases/19.07.3/targets/sunxi/cortexa53/openwrt-19.07.3-sunxi-cortexa53-sun50i-h5-nanopi-neo-plus2-ext4-sdcard.img.gz;6;3;9;21.88 MB;2.43 MB
/releases/18.06.1/targets/brcm2708/bcm2710/openwrt-18.06.1-brcm2708-bcm2710-rpi-3-ext4-sysupgrade.img.gz;6;0;6;21.42 MB;3.57 MB
/releases/18.06.1/targets/x86/64/openwrt-18.06.1-x86-64-generic-rootfs.tar.gz;6;0;6;13.22 MB;2.20 MB
/releases/17.01.4/targets/kirkwood/generic/lede-17.01.4-kirkwood-linksys-audi-squashfs-sysupgrade.tar;6;0;6;19.36 MB;3.23 MB
/releases/18.06.9/targets/ramips/mt7621/openwrt-18.06.9-ramips-mt7621-mir3g-squashfs-sysupgrade.tar;6;0;6;17.44 MB;2.91 MB
/releases/17.01.0/targets/ar71xx/nand/lede-17.01.0-r3205-59508e3-ar71xx-nand-wndr3700v4-squashfs-sysupgrade.tar;6;0;6;11.85 MB;1.97 MB
/releases/17.01.7/targets/x86/generic/lede-17.01.7-x86-generic-combined-ext4.img.gz;6;2;8;35.44 MB;4.43 MB
/releases/19.07.3/targets/ar71xx/generic/openwrt-19.07.3-ar71xx-generic-vmlinux.lzma;6;0;6;5.01 MB;855.69 KB
/releases/17.01.7/targets/ar71xx/generic/lede-17.01.7-ar71xx-generic-vmlinux.lzma;6;0;6;1.95 MB;333.08 KB
/releases/18.06.4/targets/brcm2708/bcm2708/openwrt-18.06.4-brcm2708-bcm2708-rpi-ext4-sysupgrade.img.gz;6;0;6;35.46 MB;5.91 MB
/releases/18.06.2/targets/mvebu/cortexa9/openwrt-18.06.2-mvebu-cortexa9-turris-omnia-sysupgrade.img.gz;6;0;6;17.11 MB;2.85 MB
/releases/18.06.1/targets/ar71xx/mikrotik/openwrt-18.06.1-ar71xx-mikrotik-vmlinux-initramfs.lzma;6;0;6;10.92 MB;1.82 MB
/releases/18.06.4/targets/brcm2708/bcm2708/openwrt-18.06.4-brcm2708-bcm2708-rpi-ext4-factory.img.gz;5;0;5;34.99 MB;7.00 MB
/releases/17.01.0/targets/x86/64/lede-17.01.0-r3205-59508e3-x86-64-rootfs-ext4.img.gz;5;0;5;6.35 MB;1.27 MB
/releases/18.06.2/targets/ar71xx/nand/openwrt-18.06.2-ar71xx-nand-z1-squashfs-sysupgrade.tar;5;0;5;7.06 MB;1.41 MB
/releases/19.07.0/targets/x86/legacy/openwrt-19.07.0-x86-legacy-combined-squashfs.img.gz;5;0;5;18.91 MB;3.78 MB
/releases/17.01.0/targets/ar71xx/nand/lede-17.01.0-r3205-59508e3-ar71xx-nand-z1-squashfs-sysupgrade.tar;5;0;5;9.60 MB;1.92 MB
/releases/19.07.2/targets/brcm2708/bcm2710/openwrt-19.07.2-brcm2708-bcm2710-rpi-3-squashfs-sysupgrade.img.gz;5;0;5;43.01 MB;8.60 MB
/releases/17.01.7/targets/apm821xx/nand/lede-17.01.7-apm821xx-nand-mr24-squashfs-sysupgrade.tar;5;0;5;8.91 MB;1.78 MB
/releases/19.07.3/targets/at91/sama5/openwrt-19.07.3-at91-sama5-at91-sama5d2_xplained-ext4-root.ubi.gz;5;0;5;5.32 MB;1.06 MB
/releases/17.01.1/targets/apm821xx/sata/lede-17.01.1-apm821xx-sata-MyBookLiveSingle-ext4-rootfs.img.gz;5;0;5;9.16 MB;1.83 MB
/releases/19.07.3/targets/at91/sam9x/openwrt-19.07.3-at91-sam9x-at91sam9g20ek_2mmc-ext4-root.ubi.gz;5;0;5;5.48 MB;1.10 MB
/releases/19.07.2/targets/brcm2708/bcm2708/openwrt-19.07.2-brcm2708-bcm2708-rpi-ext4-sysupgrade.img.gz;5;0;5;45.77 MB;9.15 MB
/releases/18.06.4/targets/brcm2708/bcm2710/openwrt-18.06.4-brcm2708-bcm2710-rpi-3-ext4-sysupgrade.img.gz;5;0;5;18.32 MB;3.66 MB
/releases/17.01.5/targets/ar71xx/nand/lede-17.01.5-ar71xx-nand-wndr3700v4-squashfs-sysupgrade.tar;5;0;5;8.29 MB;1.66 MB
/releases/19.07.0-rc2/targets/x86/64/openwrt-19.07.0-rc2-x86-64-generic-rootfs.tar.gz;5;0;5;18.21 MB;3.64 MB
/releases/17.01.7/targets/x86/64/lede-17.01.7-x86-64-generic-rootfs.tar.gz;5;1;6;11.24 MB;1.87 MB
/releases/18.06.1/targets/sunxi/cortexa7/openwrt-18.06.1-sunxi-cortexa7-sun7i-a20-bananapi-ext4-sdcard.img.gz;5;0;5;16.33 MB;3.27 MB
/releases/17.01.0/targets/x86/64/lede-17.01.0-r3205-59508e3-x86-64-generic-rootfs.tar.gz;5;0;5;11.07 MB;2.21 MB
/releases/19.07.3/targets/brcm2708/bcm2708/openwrt-19.07.3-brcm2708-bcm2708-rpi-ext4-factory.img.gz;5;0;5;35.10 MB;7.02 MB
/releases/17.01.1/targets/ar71xx/nand/lede-17.01.1-ar71xx-nand-z1-squashfs-sysupgrade.tar;5;0;5;9.14 MB;1.83 MB
/releases/19.07.2/targets/sunxi/cortexa53/openwrt-19.07.2-sunxi-cortexa53-sun50i-h5-nanopi-neo-plus2-ext4-sdcard.img.gz;5;0;5;33.90 MB;6.78 MB
/releases/18.06.9/targets/mvebu/cortexa9/openwrt-18.06.9-mvebu-cortexa9-turris-omnia-sysupgrade.img.gz;5;0;5;25.99 MB;5.20 MB
/releases/19.07.3/targets/omap/generic/openwrt-19.07.3-omap-ti_am335x-evm-ext4-sdcard.img.gz;5;0;5;13.93 MB;2.79 MB
/releases/17.01.2/targets/ar71xx/nand/lede-17.01.2-ar71xx-nand-mr18-squashfs-sysupgrade.tar;5;0;5;9.68 MB;1.94 MB
/releases/19.07.0/targets/ar71xx/mikrotik/openwrt-19.07.0-ar71xx-mikrotik-vmlinux-initramfs.lzma;5;0;5;8.50 MB;1.70 MB
/releases/19.07.2/targets/ar71xx/nand/openwrt-19.07.2-ar71xx-nand-vmlinux.lzma;5;0;5;5.33 MB;1.07 MB
/releases/17.01.1/targets/ar71xx/nand/lede-17.01.1-ar71xx-nand-mr18-squashfs-sysupgrade.tar;5;0;5;9.25 MB;1.85 MB
/releases/17.01.4/targets/ar71xx/nand/lede-17.01.4-ar71xx-nand-wndr3700v4-squashfs-sysupgrade.tar;5;0;5;5.12 MB;1.02 MB
/releases/19.07.0/targets/sunxi/cortexa7/openwrt-19.07.0-sunxi-cortexa7-sun8i-h3-orangepi-plus-squashfs-sdcard.img.gz;5;0;5;19.28 MB;3.86 MB
/releases/19.07.0/targets/zynq/generic/openwrt-19.07.0-zynq-digilent_zynq-zybo-squashfs-sdcard.img.gz;5;0;5;17.83 MB;3.57 MB
/releases/18.06.4/targets/mvebu/cortexa9/openwrt-18.06.4-mvebu-cortexa9-armada-388-clearfog-base-squashfs-sdcard.img.gz;5;0;5;17.79 MB;3.56 MB
/releases//19.07.3/targets/armvirt/64/openwrt-19.07.3-armvirt-64-default-rootfs.tar.gz;5;0;5;10.27 MB;2.05 MB
/releases/17.01.1/targets/ath25/generic/lede-17.01.1-ath25-generic-kernel.lzma;5;0;5;3.53 MB;723.15 KB
/releases/19.07.3/targets/sunxi/cortexa8/openwrt-19.07.3-sunxi-cortexa8-sun4i-a10-cubieboard-squashfs-sdcard.img.gz;5;0;5;13.25 MB;2.65 MB
/releases/17.01.5/targets/ar71xx/generic/lede-17.01.5-ar71xx-generic-vmlinux.lzma;5;0;5;3.03 MB;620.65 KB
/releases/faillogs-19.07/arm_arm926ej-s/packages/node/host-compile.txt;5;0;5;18.61 MB;3.72 MB
/releases/18.06.1/targets/sunxi/cortexa7/openwrt-18.06.1-sunxi-cortexa7-sun8i-h3-orangepi-plus-ext4-sdcard.img.gz;5;0;5;14.17 MB;2.83 MB
/releases/18.06.2/targets/ar71xx/nand/openwrt-18.06.2-ar71xx-nand-mr18-squashfs-sysupgrade.tar;5;0;5;26.44 MB;5.29 MB
/releases/18.06.5/targets/brcm2708/bcm2708/openwrt-18.06.5-brcm2708-bcm2708-rpi-ext4-factory.img.gz;5;2;7;36.53 MB;5.22 MB
/releases/18.06.1/targets/omap/generic/openwrt-18.06.1-omap-rootfs.tar.gz;5;0;5;6.19 MB;1.24 MB
/releases/19.07.3/targets/x86/geode/openwrt-19.07.3-x86-geode-combined-squashfs.img.gz;5;0;5;25.73 MB;5.15 MB
/releases/19.07.3/targets/at91/sam9x/openwrt-19.07.3-at91-sam9x-at91sam9g35ek-ext4-root.ubi.gz;5;0;5;5.39 MB;1.08 MB
/releases/17.01.1/targets/brcm2708/bcm2710/lede-17.01.1-brcm2708-bcm2710-rpi-3-ext4-sdcard.img.gz;5;0;5;20.09 MB;4.02 MB
/releases/18.06.6/targets/brcm2708/bcm2710/openwrt-18.06.6-brcm2708-bcm2710-rpi-3-ext4-factory.img.gz;5;18;23;30.74 MB;1.34 MB
/releases/19.07.3/targets/sunxi/cortexa7/openwrt-19.07.3-sunxi-cortexa7-sun8i-h2-plus-orangepi-zero-ext4-sdcard.img.gz;5;14;19;16.95 MB;913.49 KB
/releases/19.07.0/targets/sunxi/cortexa7/openwrt-19.07.0-sunxi-cortexa7-sun8i-h3-orangepi-one-squashfs-sdcard.img.gz;5;0;5;19.30 MB;3.86 MB
/releases/19.07.2/targets/brcm2708/bcm2709/openwrt-19.07.2-brcm2708-bcm2709-rpi-2-ext4-sysupgrade.img.gz;5;0;5;56.13 MB;11.23 MB
/releases/18.06.2/targets/ar71xx/nand/openwrt-18.06.2-ar71xx-nand-wndr3700v4-squashfs-sysupgrade.tar;5;0;5;9.32 MB;1.86 MB
/releases/19.07.2/targets/sunxi/cortexa53/openwrt-19.07.2-sunxi-cortexa53-sun50i-a64-sopine-baseboard-ext4-sdcard.img.gz;5;0;5;27.23 MB;5.45 MB
/releases/17.01.0/targets/ar71xx/nand/lede-17.01.0-r3205-59508e3-ar71xx-nand-c-60-squashfs-sysupgrade.tar;5;0;5;6.57 MB;1.31 MB
/releases/18.06.4/targets/mvebu/cortexa9/openwrt-18.06.4-mvebu-cortexa9-armada-388-clearfog-pro-squashfs-sdcard.img.gz;5;0;5;13.99 MB;2.80 MB
/releases/18.06.9/targets/brcm2708/bcm2710/openwrt-18.06.9-brcm2708-bcm2710-rpi-3-ext4-factory.img.gz;5;0;5;44.26 MB;8.85 MB
/releases/18.06.0/targets/ar71xx/mikrotik/openwrt-18.06.0-ar71xx-mikrotik-vmlinux.lzma;5;0;5;3.48 MB;713.23 KB
/releases/18.06.0/targets/omap/generic/openwrt-18.06.0-omap-omap4-panda-ubifs-sdcard.img.gz;5;0;5;12.39 MB;2.48 MB
/releases/19.07.2/targets/brcm2708/bcm2709/openwrt-19.07.2-brcm2708-bcm2709-rpi-2-squashfs-sysupgrade.img.gz;5;0;5;53.67 MB;10.73 MB
/releases/17.01.1/targets/ar71xx/nand/lede-17.01.1-ar71xx-nand-wndr4300-squashfs-sysupgrade.tar;5;0;5;6.92 MB;1.38 MB
/releases/19.07.3/targets/at91/sama5/openwrt-19.07.3-at91-sama5-at91-sama5d3_xplained-ext4-root.ubi.gz;5;0;5;5.24 MB;1.05 MB
/releases/18.06.1/targets/sunxi/cortexa8/openwrt-18.06.1-sunxi-cortexa8-sun5i-a13-olinuxino-ext4-sdcard.img.gz;5;0;5;14.43 MB;2.89 MB
/releases/17.01.3/targets/ar71xx/nand/lede-17.01.3-ar71xx-nand-z1-squashfs-sysupgrade.tar;5;0;5;6.96 MB;1.39 MB
/releases/18.06.0/targets/x86/generic/openwrt-18.06.0-x86-generic-rootfs-squashfs.img.gz;5;46;51;6.78 MB;136.17 KB
/releases/17.01.0/targets/apm821xx/nand/lede-17.01.0-r3205-59508e3-apm821xx-nand-WNDR4700-squashfs-sysupgrade.tar;5;0;5;7.59 MB;1.52 MB
/releases/17.01.0/targets/ar71xx/nand/lede-17.01.0-r3205-59508e3-ar71xx-nand-r6100-squashfs-sysupgrade.tar;5;0;5;7.67 MB;1.53 MB
/releases/18.06.2/targets/ar71xx/nand/openwrt-18.06.2-ar71xx-nand-wi2a-ac200i-squashfs-sysupgrade.tar;5;2;7;16.14 MB;2.31 MB
/releases/17.01.1/targets/ar71xx/nand/lede-17.01.1-ar71xx-nand-r6100-squashfs-sysupgrade.tar;5;0;5;7.48 MB;1.50 MB
/releases/17.01.0/targets/x86/generic/lede-17.01.0-r3205-59508e3-x86-generic-rootfs-ext4.img.gz;5;10;15;13.12 MB;895.83 KB
/releases/17.01.0/targets/ar71xx/nand/lede-17.01.0-r3205-59508e3-ar71xx-nand-nbg6716-squashfs-sysupgrade.tar;5;0;5;7.64 MB;1.53 MB
/releases/17.01.2/targets/x86/64/lede-17.01.2-x86-64-combined-ext4.img.gz;5;0;5;2.95 MB;604.55 KB
/releases/18.06.1/targets/brcm2708/bcm2710/openwrt-18.06.1-brcm2708-bcm2710-rpi-3-squashfs-sysupgrade.img.gz;5;0;5;31.34 MB;6.27 MB
/releases/19.07.3/targets/x86/generic/openwrt-19.07.3-x86-generic-rootfs-ext4.img.gz;5;0;5;16.07 MB;3.21 MB
/releases/19.07.3/targets/mvebu/cortexa9/openwrt-19.07.3-mvebu-cortexa9-solidrun_clearfog-pro-a1-squashfs-sdcard.img.gz;5;0;5;18.99 MB;3.80 MB
/releases/17.01.0-rc1/targets/ar71xx/nand/lede-17.01.0-rc1-r3042-ec095b5-ar71xx-nand-mr18-squashfs-sysupgrade.tar;5;0;5;15.64 MB;3.13 MB
/releases/19.07.2/targets/brcm2708/bcm2709/openwrt-19.07.2-brcm2708-bcm2709-rpi-2-ext4-factory.img.gz;5;0;5;36.58 MB;7.32 MB
/releases/17.01.1/targets/ar71xx/nand/lede-17.01.1-ar71xx-nand-nbg6716-squashfs-sysupgrade.tar;4;0;4;7.54 MB;1.88 MB
/releases/17.01.2/targets/sunxi/generic/lede-17.01.2-sunxi-sun8i-h3-orangepi-plus-ext4-sdcard.img.gz;4;0;4;5.21 MB;1.30 MB
/releases/faillogs-18.06/arm_cortex-a5_vfpv4/packages/boost/host-compile.txt;4;0;4;4.62 KB;1.16 KB
/releases/17.01.3/targets/x86/64/lede-17.01.3-x86-64-combined-ext4.img.gz;4;0;4;11.68 MB;2.92 MB
/releases/17.01.4/targets/at91/legacy/lede-17.01.4-at91-legacy-default-rootfs.tar.gz;4;0;4;4.29 MB;1.07 MB
/releases/19.07.3/targets/omap/generic/openwrt-19.07.3-omap-ti_am335x-bone-black-ext4-sdcard.img.gz;4;0;4;7.09 MB;1.77 MB
/releases/19.07.3/targets/gemini/generic/openwrt-19.07.3-gemini-dlink_dir-685-ext4-sysupgrade.bin.gz;4;0;4;9.73 MB;2.43 MB
/releases/19.07.3/targets/at91/sam9x/openwrt-19.07.3-at91-sam9x-usb_a9g20-ext4-factory.bin.gz;4;0;4;13.68 MB;3.42 MB
/releases/19.07.3/targets/imx6/generic/openwrt-19.07.3-imx6-ventana-squashfs-bootfs.tar.gz;4;0;4;2.93 MB;749.82 KB
/releases/17.01.2/targets/ath25/generic/lede-17.01.2-ath25-generic-kernel.gz;4;0;4;1.91 MB;487.87 KB
/releases/17.01.3/targets/sunxi/generic/lede-17.01.3-sunxi-sun7i-a20-olinuxino-micro-squashfs-sdcard.img.gz;4;0;4;4.44 MB;1.11 MB
/releases/17.01.4/targets/kirkwood/generic/lede-17.01.4-kirkwood-linksys-viper-squashfs-sysupgrade.tar;4;0;4;3.22 MB;823.75 KB
/releases/17.01.5/targets/ar71xx/nand/lede-17.01.5-ar71xx-nand-c-60-squashfs-sysupgrade.tar;4;0;4;6.72 MB;1.68 MB
/releases/19.07.3/targets/x86/legacy/openwrt-19.07.3-x86-legacy-combined-squashfs.img.gz;4;9;13;13.15 MB;1.01 MB
/releases/19.07.2/targets/sunxi/cortexa53/openwrt-19.07.2-sunxi-cortexa53-sun50i-h5-orangepi-zero-plus-ext4-sdcard.img.gz;4;0;4;27.12 MB;6.78 MB
/releases/19.07.3/targets/at91/sama5/openwrt-19.07.3-at91-sama5-at91-sama5d3_xplained-ext4-sdcard.img.gz;4;0;4;6.50 MB;1.63 MB
/releases/17.01.0-rc1/targets/ar71xx/nand/lede-17.01.0-rc1-r3042-ec095b5-ar71xx-nand-wndr3700v4-squashfs-sysupgrade.tar;4;0;4;7.52 MB;1.88 MB
/releases/19.07.0/targets/sunxi/cortexa7/openwrt-19.07.0-sunxi-cortexa7-sun8i-h3-nanopi-neo-ext4-sdcard.img.gz;4;0;4;22.33 MB;5.58 MB
/releases/19.07.1/targets/x86/64/openwrt-19.07.1-x86-64-generic-rootfs.tar.gz;4;0;4;7.76 MB;1.94 MB
/releases/17.01.2/targets/brcm2708/bcm2708/lede-17.01.2-brcm2708-bcm2708-rpi-ext4-sdcard.img.gz;4;0;4;8.71 MB;2.18 MB
/releases/19.07.3/targets/at91/sam9x/openwrt-19.07.3-at91-sam9x-usb_a9260-ext4-factory.bin.gz;4;0;4;12.05 MB;3.01 MB
/releases/17.01.3/targets/sunxi/generic/lede-17.01.3-sunxi-sun7i-a20-olinuxino-micro-ext4-sdcard.img.gz;4;0;4;5.18 MB;1.30 MB
/releases/19.07.1/targets/at91/sam9x/openwrt-19.07.1-at91-sam9x-wb45n-ext4-root.ubi.gz;4;0;4;7.75 MB;1.94 MB
/releases/18.06.0-rc2/targets/ramips/mt7621/openwrt-18.06.0-rc2-ramips-mt7621-mir3g-squashfs-sysupgrade.tar;4;0;4;11.61 MB;2.90 MB
/releases/18.06.2/targets/sunxi/cortexa7/openwrt-18.06.2-sunxi-cortexa7-sun8i-h3-nanopi-neo-squashfs-sdcard.img.gz;4;0;4;9.23 MB;2.31 MB
/releases/18.06.2/targets/ar71xx/nand/openwrt-18.06.2-ar71xx-nand-c-60-squashfs-sysupgrade.tar;4;0;4;4.14 MB;1.03 MB
/releases/19.07.1/targets/omap/generic/openwrt-19.07.1-omap-ti_omap3-beagle-squashfs-sdcard.img.gz;4;0;4;17.52 MB;4.38 MB
/snapshots/targets//rockchip/armv8/openwrt-rockchip-armv8-friendlyarm_nanopi-r2s-ext4-sysupgrade.img.gz;4;0;4;34.48 MB;8.62 MB
/releases/18.06.0/targets/ar71xx/nand/openwrt-18.06.0-ar71xx-nand-r6100-squashfs-sysupgrade.tar;4;0;4;9.98 MB;2.49 MB
/releases/19.07.2/targets/sunxi/cortexa7/openwrt-19.07.2-sunxi-cortexa7-sun8i-h3-bananapi-m2-plus-squashfs-sdcard.img.gz;4;0;4;17.68 MB;4.42 MB
/releases/17.01.2/targets/ar71xx/nand/lede-17.01.2-ar71xx-nand-nbg6716-squashfs-sysupgrade.tar;4;0;4;4.84 MB;1.21 MB
/releases/17.01.2/targets/armvirt/generic/lede-17.01.2-armvirt-default-rootfs.tar.gz;4;0;4;3.86 MB;987.13 KB
/releases/17.01.2/targets/sunxi/generic/lede-17.01.2-sunxi-sun4i-a10-olinuxino-lime-squashfs-sdcard.img.gz;4;0;4;702.99 KB;175.75 KB
/releases/18.06.0/targets/at91/sama5d2/openwrt-18.06.0-at91-sama5d2-at91-sama5d2_ptc_ek-ext4-root.ubi.gz;4;0;4;2.83 MB;724.63 KB
/releases/19.07.0/targets/zynq/generic/openwrt-19.07.0-zynq-xlnx_zynq-zc702-squashfs-sdcard.img.gz;4;0;4;17.77 MB;4.44 MB
/releases/17.01.3/targets/zynq/generic/lede-17.01.3-zynq-zc702-uramdisk.image.gz;4;0;4;2.17 MB;556.65 KB
/releases/17.01.0-rc1/targets/ar71xx/nand/lede-17.01.0-rc1-r3042-ec095b5-ar71xx-nand-c-60-squashfs-sysupgrade.tar;4;0;4;6.46 MB;1.62 MB
/releases/17.01.5/targets/kirkwood/generic/lede-17.01.5-kirkwood-linksys-audi-squashfs-sysupgrade.tar;4;0;4;10.16 MB;2.54 MB
/releases/17.01.0/targets/at91/legacy/lede-17.01.0-r3205-59508e3-at91-legacy-default-rootfs.tar.gz;4;0;4;2.51 MB;641.60 KB
/releases/18.06.0/targets/omap/generic/openwrt-18.06.0-omap-omap3-beagle-ubifs-sdcard.img.gz;4;0;4;6.43 MB;1.61 MB
/releases/17.01.7/targets/x86/geode/lede-17.01.7-x86-geode-combined-ext4.img.gz;4;0;4;20.51 MB;5.13 MB
/releases/19.07.3/targets/at91/sam9x/openwrt-19.07.3-at91-sam9x-at91sam9m10g45ek-ext4-root.ubi.gz;4;0;4;3.08 MB;787.49 KB
/releases/19.07.3/targets/at91/sama5/openwrt-19.07.3-at91-sama5-rootfs.tar.gz;4;0;4;2.78 MB;712.55 KB
/releases/18.06.1/targets/omap/generic/openwrt-18.06.1-omap-omap4-panda-ubifs-sdcard.img.gz;4;0;4;9.69 MB;2.42 MB
/releases/17.01.5/targets/ar71xx/nand/lede-17.01.5-ar71xx-nand-r6100-squashfs-sysupgrade.tar;4;0;4;8.01 MB;2.00 MB
/releases/17.01.1/targets/ar71xx/nand/lede-17.01.1-ar71xx-nand-c-60-squashfs-sysupgrade.tar;4;0;4;6.39 MB;1.60 MB
/releases/17.01.0-rc1/targets/ar71xx/nand/lede-17.01.0-rc1-r3042-ec095b5-ar71xx-nand-nbg6716-squashfs-sysupgrade.tar;4;0;4;7.66 MB;1.91 MB
/releases/17.01.3/targets/sunxi/generic/lede-17.01.3-sunxi-sun5i-a13-olimex-som-ext4-sdcard.img.gz;4;0;4;5.44 MB;1.36 MB
/releases/18.06.1/targets/omap/generic/openwrt-18.06.1-omap-am335x-evm-ubifs-sdcard.img.gz;4;0;4;8.70 MB;2.18 MB
/releases/18.06.1/targets/omap/generic/openwrt-18.06.1-omap-omap3-beagle-ext4-sdcard.img.gz;4;0;4;7.37 MB;1.84 MB
/releases/19.07.0/targets/sunxi/cortexa7/openwrt-19.07.0-sunxi-cortexa7-sun7i-a20-olinuxino-lime-ext4-sdcard.img.gz;4;0;4;17.07 MB;4.27 MB
/releases/19.07.3/targets/sunxi/cortexa8/openwrt-19.07.3-sunxi-cortexa8-sun4i-a10-olinuxino-lime-ext4-sdcard.img.gz;4;0;4;6.03 MB;1.51 MB
/releases/17.01.0/targets/oxnas/generic/lede-17.01.0-r3205-59508e3-oxnas-akitio-ubifs-sysupgrade.tar;4;0;4;3.45 MB;883.75 KB
/releases/17.01.1/targets/x86/generic/lede-17.01.1-x86-generic-combined-ext4.img.gz;4;0;4;15.46 MB;3.87 MB
/releases/19.07.2/targets/mvebu/cortexa9/openwrt-19.07.2-mvebu-cortexa9-cznic_turris-omnia-sysupgrade.img.gz;4;0;4;9.27 MB;2.32 MB
/releases/19.07.0/targets/mvebu/cortexa9/omnia-medkit-openwrt-19.07.0-mvebu-cortexa9-cznic_turris-omnia-initramfs.tar.gz;4;0;4;15.30 MB;3.83 MB
/snapshots/faillogs/arm_arm1176jzf-s_vfp/packages/frr/host-compile.txt;4;0;4;47.70 KB;11.92 KB
/releases/19.07.2/targets/brcm2708/bcm2709/openwrt-19.07.2-brcm2708-bcm2709-rpi-2-squashfs-factory.img.gz;4;0;4;42.97 MB;10.74 MB
/releases/17.01.1/targets/sunxi/generic/lede-17.01.1-sunxi-sun6i-a31-m9-ext4-sdcard.img.gz;4;0;4;7.88 MB;1.97 MB
/releases/17.01.4/targets/apm821xx/sata/lede-17.01.4-apm821xx-sata-MyBookLiveDuo-ext4-rootfs.img.gz;4;0;4;15.97 MB;3.99 MB
/releases//19.07.3/targets/x86/64/openwrt-19.07.3-x86-64-generic-rootfs.tar.gz;4;3;7;20.06 MB;2.87 MB
/releases/17.01.4/targets/ar71xx/nand/lede-17.01.4-ar71xx-nand-r6100-squashfs-sysupgrade.tar;4;0;4;5.08 MB;1.27 MB
/releases/18.06.2/targets/at91/sama5d3/openwrt-18.06.2-at91-sama5d3-rootfs.tar.gz;4;0;4;2.34 MB;599.07 KB
/releases/19.07.1/targets/oxnas/ox820/openwrt-19.07.1-oxnas-ox820-cloudengines_pogoplugpro-squashfs-sysupgrade.tar;4;0;4;16.62 MB;4.16 MB
/releases/17.01.1/targets/sunxi/generic/lede-17.01.1-sunxi-sun7i-a20-olinuxino-micro-squashfs-sdcard.img.gz;4;0;4;4.50 MB;1.13 MB
/releases/18.06.1/targets/sunxi/cortexa7/openwrt-18.06.1-sunxi-cortexa7-sun7i-a20-cubieboard2-ext4-sdcard.img.gz;4;0;4;11.06 MB;2.77 MB
/releases/18.06.0-rc2/targets/ar71xx/nand/openwrt-18.06.0-rc2-ar71xx-nand-wndr4300-squashfs-sysupgrade.tar;4;0;4;12.21 MB;3.05 MB
/releases/18.06.2/targets/mvebu/cortexa9/omnia-medkit-openwrt-18.06.2-mvebu-cortexa9-turris-omnia-initramfs.tar.gz;4;6;10;5.71 MB;584.60 KB
/releases/19.07.3/targets/sunxi/cortexa7/openwrt-19.07.3-sunxi-cortexa7-sun7i-a20-olinuxino-micro-ext4-sdcard.img.gz;4;0;4;6.23 MB;1.56 MB
/releases/19.07.1/targets/at91/sam9x/openwrt-19.07.1-at91-sam9x-lmu5000-ext4-factory.bin.gz;4;0;4;12.02 MB;3.01 MB
/releases/19.07.0/targets/sunxi/cortexa7/openwrt-19.07.0-sunxi-cortexa7-sun8i-h3-orangepi-plus-ext4-sdcard.img.gz;4;0;4;22.41 MB;5.60 MB
/releases/18.06.1/targets/sunxi/cortexa8/openwrt-18.06.1-sunxi-cortexa8-sun4i-a10-marsboard-ext4-sdcard.img.gz;4;0;4;10.93 MB;2.73 MB
/releases/17.01.4/targets/apm821xx/nand/lede-17.01.4-apm821xx-nand-mr24-squashfs-sysupgrade.tar;4;0;4;7.56 MB;1.89 MB
/releases/17.01.3/targets/sunxi/generic/lede-17.01.3-sunxi-sun8i-h3-orangepi-plus-ext4-sdcard.img.gz;4;0;4;5.12 MB;1.28 MB
/releases/17.01.3/targets/oxnas/generic/lede-17.01.3-oxnas-pogoplug-v3-squashfs-sysupgrade.tar;4;0;4;4.67 MB;1.17 MB
/releases/17.01.3/targets/brcm2708/bcm2710/lede-17.01.3-brcm2708-bcm2710-rpi-3-ext4-sdcard.img.gz;4;0;4;16.38 MB;4.09 MB
/releases/17.01.3/targets/mediatek/generic/lede-17.01.3-mediatek-NAND-squashfs-sysupgrade.tar;4;0;4;8.28 MB;2.07 MB
/releases/18.06.4/targets/gemini/generic/openwrt-18.06.4-gemini-nas4220b-hddapp.tgz;4;0;4;30.45 MB;7.61 MB
/releases/18.06.1/targets/ramips/mt7621/openwrt-18.06.1-ramips-mt7621-ubnt-erx-sfp-squashfs-sysupgrade.tar;4;0;4;9.36 MB;2.34 MB
/releases/17.01.4/targets/ar71xx/nand/lede-17.01.4-ar71xx-nand-mr18-squashfs-sysupgrade.tar;4;0;4;6.66 MB;1.66 MB
/releases/17.01.3/targets/at91/sama5d3/lede-17.01.3-at91-sama5d3-at91sama5d3xplained-rootfs.tar.gz;4;0;4;2.39 MB;611.51 KB
/releases/18.06.0-rc2/targets/ar71xx/nand/openwrt-18.06.0-rc2-ar71xx-nand-rambutan-squashfs-sysupgrade.tar;4;0;4;7.41 MB;1.85 MB
/releases/17.01.0-rc2/targets/ar71xx/nand/lede-17.01.0-rc2-r3131-42f3c1f-ar71xx-nand-mr18-squashfs-sysupgrade.tar;4;0;4;12.76 MB;3.19 MB
/releases/17.01.3/targets/omap/generic/lede-17.01.3-omap-default-rootfs.tar.gz;4;0;4;2.17 MB;556.57 KB
/releases/17.01.3/targets/ar71xx/nand/lede-17.01.3-ar71xx-nand-r6100-squashfs-sysupgrade.tar;4;0;4;5.26 MB;1.31 MB
/releases/19.07.1/targets/x86/legacy/openwrt-19.07.1-x86-legacy-combined-squashfs.img.gz;4;3;7;19.67 MB;2.81 MB
/releases/19.07.2/targets/sunxi/cortexa53/openwrt-19.07.2-sunxi-cortexa53-sun50i-h5-nanopi-neo2-squashfs-sdcard.img.gz;4;0;4;23.98 MB;5.99 MB
/releases/19.07.3/targets/oxnas/ox820/openwrt-19.07.3-oxnas-ox820-mitrastar_stg-212-squashfs-sysupgrade.tar;4;0;4;16.37 MB;4.09 MB
/releases/17.01.3/targets/kirkwood/generic/lede-17.01.3-kirkwood-pogo_e02-squashfs-sysupgrade.tar;4;0;4;3.54 MB;907.37 KB
/releases/18.06.0-rc2/targets/ar71xx/nand/openwrt-18.06.0-rc2-ar71xx-nand-c-60-squashfs-sysupgrade.tar;4;0;4;7.16 MB;1.79 MB
/releases/18.06.7/targets/x86/64/openwrt-18.06.7-x86-64-rootfs-ext4.img.gz;4;0;4;7.59 MB;1.90 MB
/releases/19.07.0/targets/arc770/generic/openwrt-19.07.0-arc770-generic-Default-sdcard-vfat-ext4.img.gz;4;0;4;17.61 MB;4.40 MB
/releases/17.01.4/targets/at91/sama5d3/lede-17.01.4-at91-sama5d3-at91sama5d3xplained-rootfs.tar.gz;4;0;4;2.55 MB;651.63 KB
/releases/17.01.2/targets/brcm2708/bcm2709/lede-17.01.2-brcm2708-bcm2709-rpi-2-ext4-sdcard.img.gz;4;0;4;7.32 MB;1.83 MB
/releases/17.01.3/targets/x86/64/lede-17.01.3-x86-64-rootfs-ext4.img.gz;4;0;4;3.45 MB;882.08 KB
/releases/17.01.1/targets/brcm2708/bcm2708/lede-17.01.1-brcm2708-bcm2708-rpi-ext4-sdcard.img.gz;4;0;4;15.93 MB;3.98 MB
/releases/17.01.0-rc1/targets/ar71xx/nand/lede-17.01.0-rc1-r3042-ec095b5-ar71xx-nand-z1-squashfs-sysupgrade.tar;4;0;4;9.67 MB;2.42 MB
/releases/17.01.0-rc1/targets/ar71xx/nand/lede-17.01.0-rc1-r3042-ec095b5-ar71xx-nand-wndr4300-squashfs-sysupgrade.tar;4;0;4;7.60 MB;1.90 MB
/releases/19.07.3/targets/apm821xx/sata/openwrt-19.07.3-apm821xx-sata-wd_mybooklive-ext4-factory.img.gz;4;0;4;19.82 MB;4.96 MB
/releases/17.01.0/targets/apm821xx/nand/lede-17.01.0-r3205-59508e3-apm821xx-nand-mr24-squashfs-sysupgrade.tar;4;0;4;6.77 MB;1.69 MB
/releases/19.07.3/targets/x86/generic/openwrt-19.07.3-x86-generic-rootfs-squashfs.img.gz;4;0;4;8.77 MB;2.19 MB
/releases/18.06.1/targets/sunxi/cortexa7/openwrt-18.06.1-sunxi-cortexa7-sun8i-h2-plus-orangepi-r1-ext4-sdcard.img.gz;4;0;4;15.96 MB;3.99 MB
/releases/17.01.4/targets/ar71xx/nand/lede-17.01.4-ar71xx-nand-c-60-squashfs-sysupgrade.tar;4;0;4;3.98 MB;1018.87 KB
/releases/17.01.2/targets/brcm2708/bcm2710/lede-17.01.2-brcm2708-bcm2710-rpi-3-ext4-sdcard.img.gz;4;0;4;16.64 MB;4.16 MB
/snapshots/faillogs/arm_cortex-a7_neon-vfpv4/packages/frr/host-compile.txt;4;0;4;47.70 KB;11.93 KB
/releases/17.01.2/targets/sunxi/generic/lede-17.01.2-sunxi-sun7i-a20-lamobo-r1-squashfs-sdcard.img.gz;4;0;4;5.18 MB;1.30 MB
/releases/17.01.3/targets/brcm2708/bcm2709/lede-17.01.3-brcm2708-bcm2709-rpi-2-ext4-sdcard.img.gz;4;0;4;7.20 MB;1.80 MB
/releases/19.07.0/targets/brcm2708/bcm2708/openwrt-19.07.0-brcm2708-bcm2708-rpi-ext4-factory.img.gz;4;14;18;35.66 MB;1.98 MB
/releases/19.07.0-rc1/targets/ar71xx/nand/openwrt-19.07.0-rc1-ar71xx-nand-vmlinux.lzma;4;0;4;2.90 MB;743.65 KB
/releases/18.06.4/targets/gemini/generic/openwrt-18.06.4-gemini-dns313-bootpart.tar.gz;4;0;4;6.98 MB;1.75 MB
/releases/19.07.2/targets/mvebu/cortexa72/openwrt-19.07.2-mvebu-cortexa72-marvell_armada7040-db-squashfs-sdcard.img.gz;4;0;4;13.43 MB;3.36 MB
/releases/17.01.3/targets/mvebu/generic/lede-17.01.3-mvebu-armada-388-clearfog-sdcard.img.gz;4;0;4;4.45 MB;1.11 MB
/releases/18.06.9/targets/brcm2708/bcm2710/openwrt-18.06.9-brcm2708-bcm2710-rpi-3-squashfs-factory.img.gz;4;0;4;31.25 MB;7.81 MB
/releases/19.07.3/targets/at91/sama5/openwrt-19.07.3-at91-sama5-at91-sama5d2_ptc_ek-ext4-root.ubi.gz;4;0;4;2.79 MB;714.17 KB
/releases/19.07.1/targets/x86/64/openwrt-19.07.1-x86-64-rootfs-ext4.img.gz;4;0;4;8.20 MB;2.05 MB
/releases/17.01.3/targets/ar71xx/nand/lede-17.01.3-ar71xx-nand-wndr4300-squashfs-sysupgrade.tar;4;0;4;4.71 MB;1.18 MB
/releases/19.07.0/targets/sunxi/cortexa7/openwrt-19.07.0-sunxi-cortexa7-sun8i-h2-plus-orangepi-r1-squashfs-sdcard.img.gz;4;0;4;19.06 MB;4.77 MB
/releases/17.01.3/targets/imx6/generic/lede-17.01.3-imx6-rootfs.tar.gz;4;0;4;2.42 MB;620.68 KB
/releases/18.06.1/targets/omap/generic/openwrt-18.06.1-omap-omap4-panda-ext4-sdcard.img.gz;4;0;4;9.50 MB;2.37 MB
/releases/19.07.0/targets/zynq/generic/openwrt-19.07.0-zynq-avnet_zynq-zed-squashfs-sdcard.img.gz;4;0;4;17.70 MB;4.43 MB
/releases/19.07.3/targets/oxnas/ox820/openwrt-19.07.3-oxnas-ox820-mitrastar_stg-212-ubifs-sysupgrade.tar;4;0;4;27.23 MB;6.81 MB
/releases/19.07.2/targets/brcm2708/bcm2710/openwrt-19.07.2-brcm2708-bcm2710-rpi-3-ext4-sysupgrade.img.gz;4;24;28;29.33 MB;1.05 MB
/releases/18.06.2/targets/sunxi/cortexa7/openwrt-18.06.2-sunxi-cortexa7-sun7i-a20-pcduino3-squashfs-sdcard.img.gz;4;0;4;14.61 MB;3.65 MB
/releases/18.06.4/targets/mvebu/cortexa9/openwrt-18.06.4-mvebu-cortexa9-turris-omnia-sysupgrade.img.gz;4;0;4;11.42 MB;2.86 MB
/releases/17.01.3/targets/oxnas/generic/lede-17.01.3-oxnas-kd20-squashfs-sysupgrade.tar;4;0;4;4.47 MB;1.12 MB
/releases/17.01.3/targets/oxnas/generic/lede-17.01.3-oxnas-akitio-ubifs-sysupgrade.tar;4;0;4;6.75 MB;1.69 MB
/releases/19.07.3/targets/omap/generic/openwrt-19.07.3-omap-ti_omap3-beagle-squashfs-sdcard.img.gz;4;0;4;6.31 MB;1.58 MB
/releases/17.01.0/targets/at91/sama5d3/lede-17.01.0-r3205-59508e3-at91-sama5d3-at91sama5d3xplained-rootfs.tar.gz;4;0;4;4.27 MB;1.07 MB
/releases/19.07.2/targets/ath25/generic/openwrt-19.07.2-ath25-generic-kernel.lzma;4;0;4;3.66 MB;935.77 KB
/releases/17.01.0/targets/oxnas/generic/lede-17.01.0-r3205-59508e3-oxnas-kd20-squashfs-sysupgrade.tar;4;0;4;3.58 MB;915.75 KB
/releases/18.06.0/targets/ar71xx/nand/openwrt-18.06.0-ar71xx-nand-mr18-squashfs-sysupgrade.tar;4;0;4;13.64 MB;3.41 MB
/releases/17.01.3/targets/imx6/generic/lede-17.01.3-imx6-ventana-squashfs-bootfs.tar.gz;4;0;4;2.31 MB;590.72 KB
/releases/18.06.6/targets/at91/sama5d2/openwrt-18.06.6-at91-sama5d2-at91-sama5d2_xplained-ext4-sdcard.img.gz;4;0;4;11.44 MB;2.86 MB
/releases/17.01.1/targets/armvirt/generic/lede-17.01.1-armvirt-root.squashfs.gz;4;0;4;2.87 MB;734.74 KB
/releases/17.01.7/targets/sunxi/generic/lede-17.01.7-sunxi-sun4i-a10-cubieboard-squashfs-sdcard.img.gz;4;0;4;8.34 MB;2.09 MB
/releases/17.01.3/targets/sunxi/generic/lede-17.01.3-sunxi-sun7i-a20-bananapi-squashfs-sdcard.img.gz;4;0;4;4.23 MB;1.06 MB
/releases/19.07.1/targets/at91/sam9x/openwrt-19.07.1-at91-sam9x-at91sam9g20ek_2mmc-ext4-zImage.gz;4;0;4;6.99 MB;1.75 MB
/releases/18.06.6/targets/x86/legacy/openwrt-18.06.6-x86-legacy-generic-rootfs.tar.gz;4;0;4;3.26 MB;835.48 KB
/releases/17.01.5/targets/ar71xx/nand/lede-17.01.5-ar71xx-nand-wndr4300-squashfs-sysupgrade.tar;4;0;4;10.32 MB;2.58 MB
/releases/18.06.0-rc2/targets/ar71xx/nand/openwrt-18.06.0-rc2-ar71xx-nand-wndr3700v4-squashfs-sysupgrade.tar;4;0;4;7.89 MB;1.97 MB
/releases/19.07.0-rc2/targets/x86/64/openwrt-19.07.0-rc2-x86-64-rootfs-squashfs.img.gz;4;0;4;11.30 MB;2.83 MB
/releases/17.01.0/targets/apm821xx/nand/lede-17.01.0-r3205-59508e3-apm821xx-nand-mx60w-squashfs-sysupgrade.tar;4;0;4;7.56 MB;1.89 MB
/releases/18.06.7/targets/x86/64/openwrt-18.06.7-x86-64-rootfs-squashfs.img.gz;4;0;4;4.04 MB;1.01 MB
/releases/19.07.3/targets/sunxi/cortexa7/openwrt-19.07.3-sunxi-cortexa7-sun7i-a20-olinuxino-lime2-emmc-ext4-sdcard.img.gz;4;0;4;6.13 MB;1.53 MB
/releases/17.01.1/targets/armvirt/generic/lede-17.01.1-armvirt-rootfs.cpio.gz;4;0;4;3.85 MB;986.50 KB
/snapshots/faillogs/arm_cortex-a15_neon-vfpv4/packages/node/host-compile.txt;4;0;4;8.74 MB;2.19 MB
/releases/17.01.3/targets/oxnas/generic/lede-17.01.3-oxnas-pogoplug-pro-squashfs-sysupgrade.tar;4;0;4;3.80 MB;972.37 KB
/releases/19.07.2/targets/apm821xx/sata/openwrt-19.07.2-apm821xx-sata-wd_mybooklive-ext4-factory.img.gz;4;0;4;26.18 MB;6.55 MB
/releases/17.01.3/targets/brcm63xx/generic/lede-17.01.3-brcm63xx-generic-livebox-vmlinux.gz;4;0;4;1.83 MB;467.94 KB
/releases/18.06.6/targets/x86/generic/openwrt-18.06.6-x86-generic-combined-ext4.img.gz;4;0;4;15.61 MB;3.90 MB
/releases/17.01.3/targets/oxnas/generic/lede-17.01.3-oxnas-kd20-factory.tar.gz;4;0;4;4.77 MB;1.19 MB
/releases/17.01.3/targets/oxnas/generic/lede-17.01.3-oxnas-kd20-ubifs-sysupgrade.tar;4;0;4;7.86 MB;1.96 MB
/releases/19.07.3/targets/omap/generic/openwrt-19.07.3-omap-ti_am335x-evm-squashfs-sdcard.img.gz;4;0;4;6.48 MB;1.62 MB
/snapshots/faillogs/mipsel_74kc/packages/frr/host-compile.txt;4;0;4;47.70 KB;11.92 KB
/releases/18.06.0/targets/at91/sama5d2/openwrt-18.06.0-at91-sama5d2-at91-sama5d2_ptc_ek-ext4-zImage.gz;4;0;4;3.67 MB;938.32 KB
/releases/18.06.0-rc1/targets/ramips/mt7621/openwrt-18.06.0-rc1-ramips-mt7621-ubnt-erx-squashfs-sysupgrade.tar;4;0;4;6.54 MB;1.64 MB
/releases/19.07.3/targets/sunxi/cortexa7/openwrt-19.07.3-sunxi-cortexa7-sun8i-h2-plus-orangepi-r1-ext4-sdcard.img.gz;4;11;15;16.47 MB;1.10 MB
/releases/17.01.3/targets/sunxi/generic/lede-17.01.3-sunxi-sun4i-a10-pcduino-squashfs-sdcard.img.gz;4;0;4;4.55 MB;1.14 MB
/releases/17.01.3/targets/oxnas/generic/lede-17.01.3-oxnas-akitio-squashfs-sysupgrade.tar;4;0;4;3.78 MB;966.87 KB
/releases/18.06.2/targets/ar71xx/nand/openwrt-18.06.2-ar71xx-nand-hiveap-121-squashfs-sysupgrade.tar;4;0;4;5.69 MB;1.42 MB
/releases/18.06.1/targets/at91/legacy/openwrt-18.06.1-at91-legacy-usb_a9260-ext4-factory.bin.gz;4;0;4;8.42 MB;2.11 MB
/releases/19.07.3/targets/at91/sam9x/openwrt-19.07.3-at91-sam9x-lmu5000-ext4-factory.bin.gz;4;0;4;6.35 MB;1.59 MB
/releases/18.06.0-rc2/targets/brcm2708/bcm2709/openwrt-18.06.0-rc2-brcm2708-bcm2709-rpi-2-ext4-sdcard.img.gz;4;18;22;18.68 MB;869.40 KB
/releases/18.06.1/targets/mvebu/cortexa53/openwrt-18.06.1-mvebu-cortexa53-globalscale-espressobin-ext4-sdcard.img.gz;4;0;4;18.50 MB;4.63 MB
/releases/19.07.2/targets/sunxi/cortexa53/openwrt-19.07.2-sunxi-cortexa53-sun50i-a64-pine64-plus-ext4-sdcard.img.gz;4;0;4;20.45 MB;5.11 MB
/releases/18.06.2/targets/x86/geode/openwrt-18.06.2-x86-geode-combined-squashfs.img.gz;4;0;4;18.80 MB;4.70 MB
/releases/17.01.4/targets/apm821xx/nand/lede-17.01.4-apm821xx-nand-WNDR4700-squashfs-sysupgrade.tar;4;0;4;7.26 MB;1.81 MB
/releases/19.07.0/targets/sunxi/cortexa7/openwrt-19.07.0-sunxi-cortexa7-sun7i-a20-olinuxino-micro-ext4-sdcard.img.gz;4;0;4;17.09 MB;4.27 MB
/releases/18.06.0/targets/at91/sama5d3/openwrt-18.06.0-at91-sama5d3-at91-sama5d3_xplained-ext4-sdcard.img.gz;4;0;4;16.98 MB;4.24 MB
/releases/18.06.1/targets/mvebu/cortexa9/openwrt-18.06.1-mvebu-cortexa9-armada-388-clearfog-pro-squashfs-sdcard.img.gz;4;0;4;9.43 MB;2.36 MB
/releases/17.01.3/targets/oxnas/generic/lede-17.01.3-oxnas-pogoplug-v3-ubifs-sysupgrade.tar;4;0;4;6.74 MB;1.68 MB
/releases/18.06.0/targets/ar71xx/nand/openwrt-18.06.0-ar71xx-nand-wndr3700v4-squashfs-sysupgrade.tar;4;0;4;13.68 MB;3.42 MB
/releases/19.07.0-rc2/targets/x86/generic/openwrt-19.07.0-rc2-x86-generic-combined-squashfs.img.gz;4;0;4;27.64 MB;6.91 MB
/releases/17.01.4/targets/ar71xx/nand/lede-17.01.4-ar71xx-nand-wndr4300-squashfs-sysupgrade.tar;4;0;4;9.10 MB;2.28 MB
/releases/17.01.3/targets/oxnas/generic/lede-17.01.3-oxnas-stg212-squashfs-sysupgrade.tar;4;0;4;3.95 MB;1012.37 KB
/releases/18.06.3/targets/x86/legacy/openwrt-18.06.3-x86-legacy-combined-squashfs.img.gz;4;32;36;20.13 MB;572.58 KB
/releases/19.07.3/targets/sunxi/cortexa7/openwrt-19.07.3-sunxi-cortexa7-sun8i-h3-orangepi-pc-plus-ext4-sdcard.img.gz;4;0;4;11.44 MB;2.86 MB
/releases/17.01.0/targets/ramips/mt7621/lede-17.01.0-r3205-59508e3-ramips-mt7621-ubnt-erx-squashfs-sysupgrade.tar;4;0;4;6.00 MB;1.50 MB
/releases/17.01.3/targets/zynq/generic/lede-17.01.3-zynq-rootfs.tar.gz;4;0;4;2.02 MB;517.17 KB
/releases/19.07.3/targets/omap/generic/openwrt-19.07.3-omap-ti_am335x-bone-black-squashfs-sdcard.img.gz;4;0;4;6.11 MB;1.53 MB
/releases/18.06.3/targets/sunxi/cortexa8/openwrt-18.06.3-sunxi-cortexa8-sun5i-a13-olinuxino-squashfs-sdcard.img.gz;4;0;4;9.80 MB;2.45 MB
/releases/18.06.7/targets/at91/legacy/openwrt-18.06.7-at91-legacy-at91sam9263ek-ext4-zImage.gz;4;0;4;9.61 MB;2.40 MB
/releases/19.07.3/targets/at91/sam9x/openwrt-19.07.3-at91-sam9x-at91sam9263ek-ext4-root.ubi.gz;4;0;4;3.17 MB;811.53 KB
/releases/18.06.1/targets/omap/generic/openwrt-18.06.1-omap-am335x-boneblack-ext4-sdcard.img.gz;4;0;4;13.87 MB;3.47 MB
/releases/18.06.0/targets/ar71xx/nand/openwrt-18.06.0-ar71xx-nand-wndr4300-squashfs-sysupgrade.tar;4;0;4;13.60 MB;3.40 MB
/releases/19.07.3/targets/sunxi/cortexa7/openwrt-19.07.3-sunxi-cortexa7-sun7i-a20-cubietruck-squashfs-sdcard.img.gz;4;0;4;8.58 MB;2.14 MB
/releases/19.07.3/targets/sunxi/cortexa7/openwrt-19.07.3-sunxi-cortexa7-sun8i-h3-nanopi-m1-plus-ext4-sdcard.img.gz;4;0;4;9.85 MB;2.46 MB
/releases/19.07.3/targets/ar71xx/nand/openwrt-19.07.3-ar71xx-nand-wndr4300-squashfs-sysupgrade.tar;4;0;4;13.77 MB;3.44 MB
/releases/19.07.0/targets/sunxi/cortexa53/openwrt-19.07.0-sunxi-cortexa53-sun50i-a64-sopine-baseboard-ext4-sdcard.img.gz;4;0;4;27.09 MB;6.77 MB
/releases/18.06.5/targets/mvebu/cortexa9/openwrt-18.06.5-mvebu-cortexa9-turris-omnia-sysupgrade.img.gz;4;0;4;10.85 MB;2.71 MB
/releases/17.01.2/targets/sunxi/generic/lede-17.01.2-sunxi-sun5i-a13-olimex-som-squashfs-sdcard.img.gz;4;0;4;654.99 KB;163.75 KB
/releases/17.01.0/targets/oxnas/generic/lede-17.01.0-r3205-59508e3-oxnas-stg212-ubifs-sysupgrade.tar;4;0;4;3.70 MB;947.75 KB
/releases/19.07.3/targets/at91/sama5/openwrt-19.07.3-at91-sama5-at91-sama5d4_xplained-ext4-root.ubi.gz;4;0;4;5.03 MB;1.26 MB
/releases/19.07.0/targets/brcm2708/bcm2708/openwrt-19.07.0-brcm2708-bcm2708-rpi-squashfs-sysupgrade.img.gz;4;0;4;31.28 MB;7.82 MB
/releases/18.06.0-rc2/targets/x86/64/openwrt-18.06.0-rc2-x86-64-combined-squashfs.img.gz;4;0;4;22.41 MB;5.60 MB
/releases/18.06.0/targets/at91/sama5d2/openwrt-18.06.0-at91-sama5d2-at91-sama5d2_ptc_ek-ext4-sdcard.img.gz;4;0;4;6.41 MB;1.60 MB
/releases/17.01.3/targets/ramips/mt7621/lede-17.01.3-ramips-mt7621-ubnt-erx-squashfs-sysupgrade.tar;4;0;4;3.34 MB;853.91 KB
/releases/19.07.0/targets/zynq/generic/openwrt-19.07.0-zynq-digilent_zynq-zybo-z7-squashfs-sdcard.img.gz;4;0;4;17.68 MB;4.42 MB
/releases/19.07.3/targets/mvebu/cortexa9/openwrt-19.07.3-mvebu-cortexa9-solidrun_clearfog-base-a1-squashfs-sdcard.img.gz;4;0;4;9.83 MB;2.46 MB
/releases/17.01.0-rc2/targets/apm821xx/sata/lede-17.01.0-rc2-r3131-42f3c1f-apm821xx-sata-MyBookLiveDuo-ext4-rootfs.img.gz;4;0;4;8.61 MB;2.15 MB
/releases/18.06.1/targets/sunxi/cortexa7/openwrt-18.06.1-sunxi-cortexa7-sun8i-h3-nanopi-m1-plus-squashfs-sdcard.img.gz;4;0;4;8.77 MB;2.19 MB
/releases/17.01.3/targets/ar71xx/nand/lede-17.01.3-ar71xx-nand-nbg6716-squashfs-sysupgrade.tar;4;0;4;4.78 MB;1.19 MB
/releases/19.07.3/targets/omap/generic/openwrt-19.07.3-omap-ti_omap4-panda-squashfs-sdcard.img.gz;4;0;4;6.04 MB;1.51 MB
/releases/17.01.4/targets/apm821xx/nand/lede-17.01.4-apm821xx-nand-mx60-squashfs-sysupgrade.tar;4;0;4;6.32 MB;1.58 MB
/releases/19.07.2/targets/ar71xx/generic/openwrt-19.07.2-ar71xx-generic-vmlinux.lzma;4;0;4;1.62 MB;415.54 KB
/releases/18.06.2/targets/ar71xx/nand/openwrt-18.06.2-ar71xx-nand-nbg6716-squashfs-sysupgrade.tar;4;0;4;5.10 MB;1.27 MB
/releases/17.01.1/targets/at91/legacy/lede-17.01.1-at91-legacy-default-rootfs.tar.gz;4;0;4;4.32 MB;1.08 MB
/releases/18.06.2/targets/x86/generic/openwrt-18.06.2-x86-generic-combined-squashfs.img.gz;4;0;4;14.11 MB;3.53 MB
/snapshots/faillogs/arm_xscale/packages/frr/host-compile.txt;4;0;4;47.70 KB;11.92 KB
/releases/19.07.2/targets/x86/legacy/openwrt-19.07.2-x86-legacy-combined-squashfs.img.gz;4;0;4;18.86 MB;4.72 MB
/releases/18.06.0-rc2/targets/x86/64/openwrt-18.06.0-rc2-x86-64-combined-ext4.img.gz;4;12;16;33.58 MB;2.10 MB
/releases/17.01.1/targets/ar71xx/nand/lede-17.01.1-ar71xx-nand-wndr3700v4-squashfs-sysupgrade.tar;4;0;4;4.78 MB;1.19 MB
/releases/18.06.4/targets/x86/64/openwrt-18.06.4-x86-64-rootfs-squashfs.img.gz;4;0;4;2.78 MB;710.93 KB
/releases/19.07.2/targets/brcm2708/bcm2708/openwrt-19.07.2-brcm2708-bcm2708-rpi-squashfs-factory.img.gz;4;0;4;41.37 MB;10.34 MB
/releases/17.01.3/targets/oxnas/generic/lede-17.01.3-oxnas-pogoplug-pro-ubifs-sysupgrade.tar;4;0;4;6.72 MB;1.68 MB
/releases/19.07.3/targets/sunxi/cortexa7/openwrt-19.07.3-sunxi-cortexa7-sun7i-a20-olinuxino-lime2-ext4-sdcard.img.gz;4;0;4;6.34 MB;1.58 MB
/releases/17.01.3/targets/brcm2708/bcm2708/lede-17.01.3-brcm2708-bcm2708-rpi-ext4-sdcard.img.gz;4;0;4;8.62 MB;2.16 MB
/releases/17.01.0/targets/apm821xx/nand/lede-17.01.0-r3205-59508e3-apm821xx-nand-mx60-squashfs-sysupgrade.tar;4;0;4;6.99 MB;1.75 MB
/releases/faillogs-19.07/arm_cortex-a9_vfpv3/packages/perl-parse-recdescent/host-compile.txt;4;0;4;1.68 KB;429 Bytes
/releases/19.07.0/targets/sunxi/cortexa7/openwrt-19.07.0-sunxi-cortexa7-sun7i-a20-lamobo-r1-ext4-sdcard.img.gz;4;0;4;19.62 MB;4.90 MB
/releases/18.06.1/targets/ar71xx/generic/packages/Packages.gz;4;0;4;276.36 KB;69.09 KB
/releases/19.07.3/targets/layerscape/armv8_64b/openwrt-19.07.3-layerscape-armv8_64b-ls1012afrwy-ext4-firmware.bin.gz;4;0;4;1.08 MB;276.34 KB
/releases/19.07.3/targets/at91/sam9x/openwrt-19.07.3-at91-sam9x-tny_a9260-ext4-factory.bin.gz;4;0;4;6.22 MB;1.55 MB
/releases/18.06.0/targets/mvebu/cortexa53/openwrt-18.06.0-mvebu-cortexa53-globalscale-espressobin-ext4-sdcard.img.gz;4;0;4;7.25 MB;1.81 MB
/releases/19.07.0/targets/sunxi/cortexa7/openwrt-19.07.0-sunxi-cortexa7-sun8i-h3-orangepi-pc-squashfs-sdcard.img.gz;4;0;4;14.44 MB;3.61 MB
/releases/19.07.1/targets/at91/sam9x/openwrt-19.07.1-at91-sam9x-at91sam9g35ek-ext4-root.ubi.gz;4;0;4;5.37 MB;1.34 MB
/releases/17.01.0/targets/ar71xx/nand/lede-17.01.0-r3205-59508e3-ar71xx-nand-mr18-squashfs-sysupgrade.tar;4;0;4;9.38 MB;2.35 MB
/releases/17.01.0-rc1/targets/ar71xx/nand/lede-17.01.0-rc1-r3042-ec095b5-ar71xx-nand-r6100-squashfs-sysupgrade.tar;4;0;4;7.44 MB;1.86 MB
/releases/17.01.3/targets/oxnas/generic/lede-17.01.3-oxnas-stg212-ubifs-sysupgrade.tar;4;0;4;7.32 MB;1.83 MB
/releases/17.01.0/targets/armvirt/generic/lede-17.01.0-r3205-59508e3-armvirt-default-rootfs.tar.gz;4;0;4;2.35 MB;602.68 KB
/snapshots/faillogs/arm_arm1176jzf-s_vfp/packages/node/host-compile.txt;4;0;4;10.65 MB;2.66 MB
/releases/17.01.4/targets/ath25/generic/lede-17.01.4-ath25-generic-kernel.gz;4;0;4;3.36 MB;859.94 KB
/releases/19.07.3/targets/x86/legacy/openwrt-19.07.3-x86-legacy-combined-ext4.img.gz;4;1;5;14.26 MB;2.85 MB
/releases/19.07.3/targets/sunxi/cortexa8/openwrt-19.07.3-sunxi-cortexa8-sun4i-a10-cubieboard-ext4-sdcard.img.gz;4;0;4;11.60 MB;2.90 MB
/releases/17.01.3/targets/zynq/generic/lede-17.01.3-zynq-zybo-uramdisk.image.gz;4;0;4;2.03 MB;520.65 KB
/releases/19.07.3/targets/at91/sama5/openwrt-19.07.3-at91-sama5-at91-sama5d4_xplained-ext4-sdcard.img.gz;4;0;4;6.39 MB;1.60 MB
/releases/19.07.0-rc1/targets/x86/64/openwrt-19.07.0-rc1-x86-64-combined-ext4.img.gz;4;1;5;31.05 MB;6.21 MB
/releases/18.06.0/targets/ar71xx/nand/openwrt-18.06.0-ar71xx-nand-c-60-squashfs-sysupgrade.tar;4;0;4;7.79 MB;1.95 MB
/releases/19.07.2/targets/imx6/generic/openwrt-19.07.2-imx6-ventana-squashfs-bootfs.tar.gz;4;0;4;7.82 MB;1.95 MB
/releases/19.07.3/targets/sunxi/cortexa7/openwrt-19.07.3-sunxi-cortexa7-sun8i-h3-nanopi-neo-ext4-sdcard.img.gz;4;0;4;8.81 MB;2.20 MB
/releases/17.01.1/targets/at91/sama5d3/lede-17.01.1-at91-sama5d3-at91sama5d3xplained-rootfs.tar.gz;4;0;4;4.31 MB;1.08 MB
/releases/17.01.4/targets/ar71xx/nand/lede-17.01.4-ar71xx-nand-z1-squashfs-sysupgrade.tar;4;0;4;6.85 MB;1.71 MB
/releases/19.07.0/targets/ar71xx/mikrotik/openwrt-19.07.0-ar71xx-mikrotik-vmlinux.lzma;4;0;4;3.69 MB;943.77 KB
/releases/17.01.3/targets/rb532/generic/lede-17.01.3-rb532-default-rootfs.tar.gz;4;0;4;3.58 MB;916.33 KB
/releases/17.01.3/targets/kirkwood/generic/lede-17.01.3-kirkwood-ib62x0-squashfs-sysupgrade.tar;4;0;4;3.50 MB;895.37 KB
/releases/19.07.2/targets/archs38/generic/openwrt-19.07.2-archs38-generic-Default-sdcard-vfat-ext4.img.gz;4;0;4;23.13 MB;5.78 MB
/releases/17.01.2/targets/sunxi/generic/lede-17.01.2-sunxi-sun7i-a20-olinuxino-micro-ext4-sdcard.img.gz;4;0;4;5.11 MB;1.28 MB
/releases/17.01.0/targets/arc770/generic/lede-17.01.0-r3205-59508e3-arc770-generic-Default-sdcard-vfat-ext4.img.gz;4;0;4;5.73 MB;1.43 MB
/releases/19.07.0/targets/sunxi/cortexa7/openwrt-19.07.0-sunxi-cortexa7-sun8i-h3-orangepi-one-ext4-sdcard.img.gz;4;0;4;22.38 MB;5.59 MB
/releases/18.06.1/targets/at91/sama5d2/openwrt-18.06.1-at91-sama5d2-rootfs.tar.gz;4;0;4;4.22 MB;1.06 MB
/releases/19.07.3/targets/at91/sam9x/openwrt-19.07.3-at91-sam9x-ethernut5-ext4-root.ubi.gz;4;0;4;5.19 MB;1.30 MB
/releases/17.01.3/targets/zynq/generic/lede-17.01.3-zynq-zed-uramdisk.image.gz;4;0;4;2.13 MB;544.65 KB
/releases/18.06.1/targets/at91/sama5d4/openwrt-18.06.1-at91-sama5d4-at91-sama5d4_xplained-ext4-sdcard.img.gz;4;2;6;13.46 MB;2.24 MB
/releases/18.06.0-rc2/targets/brcm2708/bcm2709/openwrt-18.06.0-rc2-brcm2708-bcm2709-rpi-2-squashfs-sdcard.img.gz;4;35;39;16.15 MB;424.07 KB
/releases/17.01.4/targets/ar71xx/nand/lede-17.01.4-ar71xx-nand-nbg6716-squashfs-sysupgrade.tar;4;0;4;5.07 MB;1.27 MB
/snapshots/faillogs/arc_arc700/packages/frr/host-compile.txt;4;0;4;47.70 KB;11.92 KB
/releases/18.06.4/targets/at91/sama5d3/openwrt-18.06.4-at91-sama5d3-at91-sama5d3_xplained-ext4-zImage.gz;4;0;4;6.46 MB;1.61 MB
/releases/19.07.2/targets/sunxi/cortexa53/openwrt-19.07.2-sunxi-cortexa53-sun50i-h5-orangepi-pc2-squashfs-sdcard.img.gz;4;0;4;24.07 MB;6.02 MB
/releases/17.01.3/targets/brcm63xx/smp/lede-17.01.3-brcm63xx-smp-livebox-vmlinux.gz;4;0;4;2.06 MB;527.94 KB
/releases/17.01.0-rc2/targets/apm821xx/nand/lede-17.01.0-rc2-r3131-42f3c1f-apm821xx-nand-mx60w-squashfs-sysupgrade.tar;3;0;3;4.43 MB;1.48 MB
/releases/17.01.3/targets/apm821xx/nand/lede-17.01.3-apm821xx-nand-WNDR4700-squashfs-sysupgrade.tar;3;0;3;4.80 MB;1.60 MB
/releases/17.01.0-rc1/targets/apm821xx/sata/lede-17.01.0-rc1-r3042-ec095b5-apm821xx-sata-MyBookLiveDuo-ext4-rootfs.img.gz;3;0;3;5.34 MB;1.78 MB
/releases/19.07.3/targets/mvebu/cortexa72/openwrt-19.07.3-mvebu-cortexa72-marvell_armada8040-db-ext4-sdcard.img.gz;3;0;3;6.65 MB;2.22 MB
/releases/19.07.0/targets/sunxi/cortexa7/openwrt-19.07.0-sunxi-cortexa7-sun8i-h3-orangepi-pc-plus-ext4-sdcard.img.gz;3;0;3;16.82 MB;5.61 MB
/releases/19.07.0/targets/sunxi/cortexa7/openwrt-19.07.0-sunxi-cortexa7-sun7i-a20-cubietruck-ext4-sdcard.img.gz;3;0;3;19.28 MB;6.43 MB
/releases/19.07.1/targets/omap/generic/openwrt-19.07.1-omap-ti_am335x-bone-black-ext4-sdcard.img.gz;3;0;3;6.89 MB;2.30 MB
/releases/19.07.1/targets/omap/generic/openwrt-19.07.1-omap-ti_am335x-evm-squashfs-sdcard.img.gz;3;0;3;6.03 MB;2.01 MB
/releases/18.06.6/targets/at91/legacy/openwrt-18.06.6-at91-legacy-at91sam9g20ek-ext4-zImage.gz;3;0;3;3.35 MB;1.12 MB
/releases/19.07.0/targets/at91/sama5/openwrt-19.07.0-at91-sama5-at91-sama5d2_ptc_ek-ext4-zImage.gz;3;0;3;7.02 MB;2.34 MB
/releases/18.06.1/targets/ath25/generic/openwrt-18.06.1-ath25-generic-kernel.gz;3;0;3;4.14 MB;1.38 MB
/releases/18.06.6/targets/x86/geode/openwrt-18.06.6-x86-geode-rootfs-ext4.img.gz;3;0;3;4.93 MB;1.64 MB
/releases/17.01.0-rc2/targets/at91/sama5d3/lede-17.01.0-rc2-r3131-42f3c1f-at91-sama5d3-at91sama5d3xplained-rootfs.tar.gz;3;0;3;2.21 MB;754.71 KB
/releases/19.07.1/targets/at91/sam9x/openwrt-19.07.1-at91-sam9x-at91sam9g25ek-ext4-root.ubi.gz;3;0;3;5.12 MB;1.71 MB
/releases/17.01.1/targets/armvirt/generic/lede-17.01.1-armvirt-root.ext4.gz;3;0;3;2.18 MB;744.19 KB
/releases/17.01.2/targets/x86/legacy/lede-17.01.2-x86-legacy-rootfs-ext4.img.gz;3;0;3;2.95 MB;1007.75 KB
/releases/19.07.3/targets/omap/generic/openwrt-19.07.3-omap-rootfs.tar.gz;3;0;3;3.02 MB;1.01 MB
/releases/18.06.7/targets/brcm2708/bcm2708/openwrt-18.06.7-brcm2708-bcm2708-rpi-ext4-factory.img.gz;3;10;13;18.49 MB;1.42 MB
/releases/18.06.1/targets/ramips/mt7621/openwrt-18.06.1-ramips-mt7621-r6220-squashfs-sysupgrade.tar;3;0;3;4.57 MB;1.52 MB
/releases/18.06.4/targets/at91/sama5d3/openwrt-18.06.4-at91-sama5d3-at91-sama5d3_xplained-ext4-root.ubi.gz;3;0;3;4.82 MB;1.61 MB
/releases/18.06.7/targets/x86/geode/openwrt-18.06.7-x86-geode-combined-ext4.img.gz;3;0;3;8.54 MB;2.85 MB
/releases/19.07.1/targets/x86/geode/openwrt-19.07.1-x86-geode-combined-squashfs.img.gz;3;0;3;6.75 MB;2.25 MB
/releases/17.01.3/targets/sunxi/generic/lede-17.01.3-sunxi-sun4i-a10-olinuxino-lime-ext4-sdcard.img.gz;3;0;3;4.91 MB;1.64 MB
/releases/17.01.3/targets/ipq806x/generic/lede-17.01.3-ipq806x-AP148-squashfs-nand-sysupgrade.tar;3;0;3;5.41 MB;1.80 MB
/releases/17.01.3/targets/kirkwood/generic/lede-17.01.3-kirkwood-linksys-viper-squashfs-sysupgrade.tar;3;0;3;4.15 MB;1.38 MB
/releases/18.06.4/targets/ramips/mt7621/openwrt-18.06.4-ramips-mt7621-ubnt-erx-squashfs-sysupgrade.tar;3;0;3;5.98 MB;1.99 MB
/releases/18.06.3/targets/sunxi/cortexa8/openwrt-18.06.3-sunxi-cortexa8-sun5i-a13-olimex-som-ext4-sdcard.img.gz;3;0;3;6.01 MB;2.00 MB
/releases/18.06.1/targets/sunxi/cortexa7/openwrt-18.06.1-sunxi-cortexa7-sun7i-a20-bananapro-squashfs-sdcard.img.gz;3;0;3;10.30 MB;3.43 MB
/releases/18.06.5/targets/mvebu/cortexa9/omnia-medkit-openwrt-18.06.5-mvebu-cortexa9-turris-omnia-initramfs.tar.gz;3;0;3;4.05 MB;1.35 MB
/releases/19.07.0/targets/sunxi/cortexa8/openwrt-19.07.0-sunxi-cortexa8-sun4i-a10-marsboard-ext4-sdcard.img.gz;3;0;3;16.69 MB;5.56 MB
/releases/17.01.0/targets/x86/geode/lede-17.01.0-r3205-59508e3-x86-geode-combined-ext4.img.gz;3;36;39;20.45 MB;536.91 KB
/releases/19.07.0/targets/gemini/generic/openwrt-19.07.0-gemini-dlink_dns-313-ext4-factory.bin.gz;3;0;3;17.11 MB;5.70 MB
/releases/19.07.0/targets/sunxi/cortexa7/openwrt-19.07.0-sunxi-cortexa7-sun7i-a20-pcduino3-squashfs-sdcard.img.gz;3;0;3;15.44 MB;5.15 MB
/releases/19.07.0/targets/sunxi/cortexa7/openwrt-19.07.0-sunxi-cortexa7-sun7i-a20-bananapi-squashfs-sdcard.img.gz;3;0;3;14.36 MB;4.79 MB
/releases/17.01.4/targets/armvirt/generic/lede-17.01.4-armvirt-default-rootfs.tar.gz;3;0;3;1.87 MB;639.78 KB
/releases/19.07.2/targets/sunxi/cortexa53/openwrt-19.07.2-sunxi-cortexa53-sun50i-a64-sopine-baseboard-squashfs-sdcard.img.gz;3;0;3;17.98 MB;5.99 MB
/releases/17.01.0-rc1/targets/oxnas/generic/lede-17.01.0-rc1-r3042-ec095b5-oxnas-stg212-squashfs-sysupgrade.tar;3;0;3;3.39 MB;1.13 MB
/releases/17.01.0/targets/mvebu/generic/lede-17.01.0-r3205-59508e3-mvebu-armada-388-clearfog-sdcard.img.gz;3;0;3;8.28 MB;2.76 MB
/releases/19.07.0/targets/x86/legacy/openwrt-19.07.0-x86-legacy-rootfs-squashfs.img.gz;3;0;3;4.97 MB;1.66 MB
/releases/19.07.3/targets/armvirt/32/openwrt-19.07.3-armvirt-32-default-rootfs.tar.gz;3;0;3;4.24 MB;1.41 MB
/releases/19.07.3/targets/at91/sam9x/openwrt-19.07.3-at91-sam9x-at91sam9x25ek-ext4-root.ubi.gz;3;0;3;2.76 MB;943.45 KB
/releases/19.07.3/targets/gemini/generic/openwrt-19.07.3-gemini-raidsonic_ib-4220-b-ext4-factory.bin.gz;3;0;3;16.66 MB;5.55 MB
/releases/17.01.3/targets/kirkwood/generic/lede-17.01.3-kirkwood-iconnect-squashfs-sysupgrade.tar;3;0;3;3.50 MB;1.17 MB
/releases/17.01.0-rc1/targets/ipq806x/generic/lede-17.01.0-rc1-r3042-ec095b5-ipq806x-AP148-legacy-ubifs-nand-sysupgrade.tar;3;0;3;5.80 MB;1.93 MB
/releases/19.07.0/targets/mvebu/cortexa53/openwrt-19.07.0-mvebu-cortexa53-globalscale_espressobin-emmc-squashfs-sdcard.img.gz;3;0;3;11.30 MB;3.77 MB
/releases/19.07.0/targets/sunxi/cortexa7/openwrt-19.07.0-sunxi-cortexa7-sun7i-a20-olinuxino-lime2-ext4-sdcard.img.gz;3;0;3;17.20 MB;5.73 MB
/releases/18.06.0/targets/sunxi/cortexa7/openwrt-18.06.0-sunxi-cortexa7-sun7i-a20-pcduino3-squashfs-sdcard.img.gz;3;0;3;9.74 MB;3.25 MB
/releases/17.01.3/targets/x86/generic/lede-17.01.3-x86-generic-generic-rootfs.tar.gz;3;0;3;2.93 MB;999.95 KB
/releases/17.01.3/targets/sunxi/generic/lede-17.01.3-sunxi-sun8i-h3-orangepi-plus-squashfs-sdcard.img.gz;3;0;3;4.11 MB;1.37 MB
/releases/19.07.0/targets/sunxi/cortexa7/openwrt-19.07.0-sunxi-cortexa7-sun7i-a20-bananapi-ext4-sdcard.img.gz;3;0;3;16.90 MB;5.63 MB
/releases/19.07.3/targets/at91/sam9x/openwrt-19.07.3-at91-sam9x-at91sam9g20ek-ext4-root.ubi.gz;3;0;3;2.70 MB;922.11 KB
/releases/19.07.2/targets/sunxi/cortexa7/openwrt-19.07.2-sunxi-cortexa7-sun8i-h3-nanopi-neo-squashfs-sdcard.img.gz;3;0;3;14.24 MB;4.75 MB
/releases/17.01.1/targets/sunxi/generic/lede-17.01.1-sunxi-sun7i-a20-lamobo-r1-squashfs-sdcard.img.gz;3;0;3;4.95 MB;1.65 MB
/releases/18.06.5/targets/sunxi/cortexa7/openwrt-18.06.5-sunxi-cortexa7-sun8i-h3-nanopi-neo-squashfs-sdcard.img.gz;3;0;3;4.72 MB;1.57 MB
/releases/17.01.2/targets/sunxi/generic/lede-17.01.2-sunxi-sun7i-a20-cubieboard2-squashfs-sdcard.img.gz;3;0;3;591.24 KB;197.08 KB
/releases/19.07.0/targets/at91/sam9x/openwrt-19.07.0-at91-sam9x-at91sam9x25ek-ext4-root.ubi.gz;3;0;3;5.10 MB;1.70 MB
/releases/18.06.0/targets/sunxi/cortexa7/openwrt-18.06.0-sunxi-cortexa7-sun7i-a20-pcduino3-ext4-sdcard.img.gz;3;0;3;6.08 MB;2.03 MB
/releases/18.06.5/targets/at91/sama5d2/openwrt-18.06.5-at91-sama5d2-at91-sama5d2_xplained-ext4-sdcard.img.gz;3;0;3;6.06 MB;2.02 MB
/snapshots/faillogs/arm_cortex-a8_vfpv3/packages/node/host-compile.txt;3;0;3;8.10 MB;2.70 MB
/releases/19.07.3/targets/sunxi/cortexa7/openwrt-19.07.3-sunxi-cortexa7-sun7i-a20-cubieboard2-ext4-sdcard.img.gz;3;0;3;6.17 MB;2.06 MB
/releases/17.01.4/targets/imx6/generic/lede-17.01.4-imx6-rootfs.tar.gz;3;0;3;2.30 MB;785.03 KB
/releases/17.01.0/targets/ath25/generic/lede-17.01.0-r3205-59508e3-ath25-generic-kernel.gz;3;0;3;1.72 MB;586.58 KB
/releases/18.06.6/targets/mvebu/cortexa9/openwrt-18.06.6-mvebu-cortexa9-armada-388-clearfog-pro-squashfs-sdcard.img.gz;3;0;3;5.05 MB;1.68 MB
/releases/18.06.6/targets/x86/legacy/openwrt-18.06.6-x86-legacy-combined-squashfs.img.gz;3;0;3;6.26 MB;2.09 MB
/releases/19.07.0/targets/gemini/generic/openwrt-19.07.0-gemini-raidsonic_ib-4220-b-ext4-factory.bin.gz;3;0;3;16.57 MB;5.52 MB
/releases/19.07.3/targets/x86/geode/openwrt-19.07.3-x86-geode-rootfs-ext4.img.gz;3;0;3;9.71 MB;3.24 MB
/releases/18.06.0-rc2/targets/ar71xx/nand/openwrt-18.06.0-rc2-ar71xx-nand-mr18-squashfs-sysupgrade.tar;3;0;3;9.75 MB;3.25 MB
/releases/17.01.3/targets/sunxi/generic/lede-17.01.3-sunxi-sun7i-a20-lamobo-r1-squashfs-sdcard.img.gz;3;0;3;4.73 MB;1.58 MB
/releases/17.01.2/targets/apm821xx/nand/lede-17.01.2-apm821xx-nand-WNDR4700-squashfs-sysupgrade.tar;3;0;3;4.68 MB;1.56 MB
/releases/17.01.2/targets/armvirt/generic/lede-17.01.2-armvirt-root.squashfs.gz;3;0;3;1.47 MB;503.44 KB
/releases/19.07.3/targets/apm821xx/sata/openwrt-19.07.3-apm821xx-sata-wd_mybooklive-ext4-sysupgrade.img.gz;3;0;3;13.16 MB;4.39 MB
/releases/19.07.3/targets/omap/generic/openwrt-19.07.3-omap-ti_omap4-panda-ext4-sdcard.img.gz;3;0;3;6.94 MB;2.31 MB
/releases/17.01.3/targets/sunxi/generic/lede-17.01.3-sunxi-sun4i-a10-cubieboard-ext4-sdcard.img.gz;3;0;3;5.02 MB;1.67 MB
/releases/19.07.1/targets/sunxi/cortexa7/openwrt-19.07.1-sunxi-cortexa7-sun8i-h2-plus-orangepi-zero-squashfs-sdcard.img.gz;3;0;3;9.67 MB;3.22 MB
/releases/19.07.0/targets/mxs/generic/openwrt-19.07.0-mxs-duckbill-sdcard.img.gz;3;0;3;22.73 MB;7.58 MB
/releases/17.01.4/targets/sunxi/generic/lede-17.01.4-sunxi-sun5i-a13-olinuxino-ext4-sdcard.img.gz;3;0;3;5.52 MB;1.84 MB
/releases/19.07.3/targets/armvirt/64/openwrt-19.07.3-armvirt-64-rootfs.cpio.gz;3;0;3;60 Bytes;20 Bytes
/releases/18.06.7/targets/armvirt/32/openwrt-18.06.7-armvirt-32-root.squashfs.gz;3;0;3;3.06 MB;1.02 MB
/releases/17.01.0-rc1/targets/apm821xx/sata/lede-17.01.0-rc1-r3042-ec095b5-apm821xx-sata-MyBookLiveSingle-ext4-rootfs.img.gz;3;0;3;5.10 MB;1.70 MB
/releases/19.07.3/targets/sunxi/cortexa8/openwrt-19.07.3-sunxi-cortexa8-sun4i-a10-marsboard-ext4-sdcard.img.gz;3;0;3;11.34 MB;3.78 MB
/releases/18.06.6/targets/mvebu/cortexa9/openwrt-18.06.6-mvebu-cortexa9-turris-omnia-sysupgrade.img.gz;3;0;3;5.65 MB;1.88 MB
/releases/17.01.3/targets/archs38/generic/lede-17.01.3-archs38-generic-root.ext4.gz;3;0;3;2.88 MB;983.07 KB
/releases/18.06.2/targets/ar71xx/nand/openwrt-18.06.2-ar71xx-nand-wndr4300-squashfs-sysupgrade.tar;3;0;3;4.76 MB;1.59 MB
/releases/19.07.0/targets/mvebu/cortexa53/openwrt-19.07.0-mvebu-cortexa53-globalscale_espressobin-ext4-sdcard.img.gz;3;0;3;12.96 MB;4.32 MB
/releases/17.01.3/targets/sunxi/generic/lede-17.01.3-sunxi-sun6i-a31-m9-ext4-sdcard.img.gz;3;0;3;5.38 MB;1.79 MB
/snapshots/faillogs/arm_mpcore/packages/node/host-compile.txt;3;0;3;8.06 MB;2.69 MB
/releases/19.07.0-rc1/targets/apm821xx/sata/openwrt-19.07.0-rc1-apm821xx-sata-wd_mybooklive-ext4-sysupgrade.img.gz;3;0;3;13.14 MB;4.38 MB
/releases/18.06.3/targets/x86/64/openwrt-18.06.3-x86-64-combined-squashfs.img.gz;3;0;3;8.98 MB;2.99 MB
/releases/17.01.0-rc1/targets/ar71xx/generic/lede-17.01.0-rc1-r3042-ec095b5-ar71xx-generic-vmlinux.lzma;3;0;3;2.50 MB;853.33 KB
/releases/17.01.5/targets/mxs/generic/lede-17.01.5-mxs-duckbill-sdcard.img.gz;3;0;3;19.47 MB;6.49 MB
/releases/17.01.0-rc1/targets/apm821xx/nand/lede-17.01.0-rc1-r3042-ec095b5-apm821xx-nand-mr24-squashfs-sysupgrade.tar;3;0;3;7.36 MB;2.45 MB
/releases/18.06.2/targets/x86/geode/openwrt-18.06.2-x86-geode-combined-ext4.img.gz;3;0;3;14.36 MB;4.79 MB
/releases/17.01.5/targets/ipq806x/generic/lede-17.01.5-ipq806x-D7800-squashfs-sysupgrade.tar;3;0;3;5.06 MB;1.69 MB
/releases/17.01.3/targets/ipq806x/generic/lede-17.01.3-ipq806x-EA8500-squashfs-sysupgrade.tar;3;0;3;4.66 MB;1.55 MB
/releases/17.01.2/targets/sunxi/generic/lede-17.01.2-sunxi-sun4i-a10-olinuxino-lime-ext4-sdcard.img.gz;3;0;3;527.24 KB;175.75 KB
/releases/17.01.0-rc1/targets/apm821xx/nand/lede-17.01.0-rc1-r3042-ec095b5-apm821xx-nand-mx60-squashfs-sysupgrade.tar;3;0;3;7.42 MB;2.47 MB
/releases/18.06.3/targets/x86/legacy/openwrt-18.06.3-x86-legacy-rootfs-ext4.img.gz;3;0;3;6.11 MB;2.04 MB
/releases/17.01.0-rc1/targets/octeon/generic/lede-17.01.0-rc1-r3042-ec095b5-octeon-er-squashfs-sysupgrade.tar;3;0;3;5.48 MB;1.83 MB
/releases/17.01.4/targets/archs38/generic/lede-17.01.4-archs38-generic-Default-sdcard-vfat-ext4.img.gz;3;0;3;7.57 MB;2.52 MB
/releases/19.07.3/targets/ar71xx/nand/openwrt-19.07.3-ar71xx-nand-mr18-squashfs-sysupgrade.tar;3;0;3;15.09 MB;5.03 MB
/snapshots/faillogs/arc_archs/packages/frr/host-compile.txt;3;0;3;31.80 KB;10.60 KB
/releases/17.01.5/targets/oxnas/generic/lede-17.01.5-oxnas-akitio-ubifs-sysupgrade.tar;3;0;3;10.04 MB;3.35 MB
/releases/18.06.3/targets/sunxi/cortexa7/openwrt-18.06.3-sunxi-cortexa7-sun7i-a20-olinuxino-lime2-emmc-squashfs-sdcard.img.gz;3;0;3;9.26 MB;3.09 MB
/releases/17.01.3/targets/sunxi/generic/lede-17.01.3-sunxi-sun7i-a20-bananapi-ext4-sdcard.img.gz;3;0;3;4.91 MB;1.64 MB
/releases/18.06.0-rc1/targets/sunxi/cortexa53/openwrt-18.06.0-rc1-sunxi-cortexa53-sun50i-h5-orangepi-zero-plus-squashfs-sdcard.img.gz;3;0;3;15.89 MB;5.30 MB
/releases/19.07.3/targets/sunxi/cortexa7/openwrt-19.07.3-sunxi-cortexa7-sun8i-h3-bananapi-m2-plus-squashfs-sdcard.img.gz;3;0;3;6.08 MB;2.03 MB
/releases/18.06.0/targets/at91/sama5d2/openwrt-18.06.0-at91-sama5d2-at91-sama5d2_xplained-ext4-root.ubi.gz;3;0;3;2.57 MB;875.58 KB
/releases/18.06.2/targets/sunxi/cortexa7/openwrt-18.06.2-sunxi-cortexa7-sun7i-a20-olinuxino-lime-squashfs-sdcard.img.gz;3;0;3;9.26 MB;3.09 MB
/releases/17.01.4/targets/imx6/generic/lede-17.01.4-imx6-ventana-squashfs-bootfs.tar.gz;3;0;3;495.24 KB;165.08 KB
/releases/17.01.0-rc1/targets/ipq806x/generic/lede-17.01.0-rc1-r3042-ec095b5-ipq806x-AP148-ubifs-nand-sysupgrade.tar;3;0;3;5.69 MB;1.90 MB
/releases/17.01.5/targets/oxnas/generic/lede-17.01.5-oxnas-stg212-squashfs-sysupgrade.tar;3;0;3;6.68 MB;2.23 MB
/releases/17.01.0-rc1/targets/ipq806x/generic/lede-17.01.0-rc1-r3042-ec095b5-ipq806x-D7800-squashfs-sysupgrade.tar;3;0;3;5.97 MB;1.99 MB
/releases/19.07.3/targets/sunxi/cortexa7/openwrt-19.07.3-sunxi-cortexa7-sun6i-a31-m9-ext4-sdcard.img.gz;3;0;3;12.34 MB;4.11 MB
/releases/18.06.0/targets/ar71xx/nand/openwrt-18.06.0-ar71xx-nand-nbg6716-squashfs-sysupgrade.tar;3;0;3;9.67 MB;3.22 MB
/releases/17.01.1/targets/arc770/generic/lede-17.01.1-arc770-generic-Default-sdcard-vfat-ext4.img.gz;3;0;3;5.53 MB;1.84 MB
/releases/17.01.4/targets/ramips/mt7621/lede-17.01.4-ramips-mt7621-ubnt-erx-squashfs-sysupgrade.tar;3;0;3;6.17 MB;2.06 MB
/releases/17.01.3/targets/sunxi/generic/lede-17.01.3-sunxi-sun7i-a20-pcduino3-ext4-sdcard.img.gz;3;0;3;5.37 MB;1.79 MB
/releases/19.07.1/targets/at91/sam9x/openwrt-19.07.1-at91-sam9x-usb_a9g20-ext4-factory.bin.gz;3;0;3;6.17 MB;2.06 MB
/releases/18.06.1/targets/brcm2708/bcm2708/openwrt-18.06.1-brcm2708-bcm2708-rpi-squashfs-factory.img.gz;3;0;3;17.97 MB;5.99 MB
/releases/18.06.2/targets/at91/sama5d3/openwrt-18.06.2-at91-sama5d3-at91-sama5d3_xplained-ext4-zImage.gz;3;0;3;3.25 MB;1.08 MB
/releases/18.06.4/targets/at91/legacy/openwrt-18.06.4-at91-legacy-at91sam9m10g45ek-ext4-root.ubi.gz;3;0;3;2.78 MB;947.46 KB
/releases/18.06.2/targets/sunxi/cortexa7/openwrt-18.06.2-sunxi-cortexa7-sun8i-h3-orangepi-pc-squashfs-sdcard.img.gz;3;0;3;4.66 MB;1.55 MB
/releases/18.06.0/targets/at91/sama5d4/openwrt-18.06.0-at91-sama5d4-at91-sama5d4_xplained-ext4-zImage.gz;3;0;3;3.42 MB;1.14 MB
/releases/19.07.0/targets/at91/sam9x/openwrt-19.07.0-at91-sam9x-usb_a9260-ext4-factory.bin.gz;3;0;3;11.92 MB;3.97 MB
/releases/19.07.1/targets/at91/sam9x/openwrt-19.07.1-at91-sam9x-at91sam9m10g45ek-ext4-root.ubi.gz;3;0;3;3.14 MB;1.05 MB
/releases/17.01.2/targets/sunxi/generic/lede-17.01.2-sunxi-sun5i-a13-olinuxino-ext4-sdcard.img.gz;3;0;3;5.57 MB;1.86 MB
/releases/17.01.0-rc2/targets/ar71xx/nand/lede-17.01.0-rc2-r3131-42f3c1f-ar71xx-nand-nbg6716-squashfs-sysupgrade.tar;3;0;3;4.61 MB;1.54 MB
/releases/19.07.0/targets/at91/sama5/openwrt-19.07.0-at91-sama5-rootfs.tar.gz;3;0;3;4.47 MB;1.49 MB
/releases/17.01.5/targets/oxnas/generic/lede-17.01.5-oxnas-pogoplug-v3-squashfs-sysupgrade.tar;3;0;3;6.74 MB;2.25 MB
/snapshots/faillogs/mipsel_24kc_24kf/packages/frr/host-compile.txt;3;0;3;31.80 KB;10.60 KB
/releases/17.01.5/targets/x86/generic/lede-17.01.5-x86-generic-rootfs-ext4.img.gz;3;0;3;3.32 MB;1.11 MB
/releases/17.01.1/targets/apm821xx/sata/lede-17.01.1-apm821xx-sata-MyBookLiveDuo-ext4-rootfs.img.gz;3;0;3;5.44 MB;1.81 MB
/releases/19.07.0/targets/at91/sam9x/openwrt-19.07.0-at91-sam9x-tny_a9263-ext4-factory.bin.gz;3;0;3;11.86 MB;3.95 MB
/releases/17.01.0-rc1/targets/octeon/generic/lede-17.01.0-rc1-r3042-ec095b5-octeon-erlite-squashfs-sysupgrade.tar;3;0;3;5.97 MB;1.99 MB
/releases/19.07.0/targets/layerscape/armv7/openwrt-19.07.0-layerscape-armv7-ls1021aiot-sdboot-ext4-sdcard.img.gz;3;4;7;13.78 MB;1.97 MB
/releases/17.01.4/targets/oxnas/generic/lede-17.01.4-oxnas-stg212-squashfs-sysupgrade.tar;3;0;3;623.24 KB;207.75 KB
/releases/18.06.7/targets/omap/generic/openwrt-18.06.7-omap-omap4-panda-ext4-sdcard.img.gz;3;0;3;11.63 MB;3.88 MB
/releases/18.06.1/targets/at91/sama5d2/openwrt-18.06.1-at91-sama5d2-at91-sama5d2_xplained-ext4-zImage.gz;3;0;3;6.21 MB;2.07 MB
/releases/18.06.5/targets/at91/legacy/openwrt-18.06.5-at91-legacy-rootfs.tar.gz;3;0;3;2.32 MB;792.97 KB
/releases/19.07.3/targets/at91/sama5/openwrt-19.07.3-at91-sama5-at91-sama5d2_xplained-ext4-sdcard.img.gz;3;0;3;6.24 MB;2.08 MB
/releases/18.06.5/targets/at91/sama5d2/openwrt-18.06.5-at91-sama5d2-at91-sama5d2_ptc_ek-ext4-zImage.gz;3;0;3;3.30 MB;1.10 MB
/releases/18.06.4/targets/at91/sama5d2/openwrt-18.06.4-at91-sama5d2-rootfs.tar.gz;3;0;3;2.20 MB;750.87 KB
/releases/17.01.2/targets/sunxi/generic/lede-17.01.2-sunxi-sun7i-a20-olinuxino-lime-ext4-sdcard.img.gz;3;0;3;527.24 KB;175.75 KB
/releases/19.07.0/targets/at91/sam9x/openwrt-19.07.0-at91-sam9x-at91sam9g20ek-ext4-zImage.gz;3;0;3;6.85 MB;2.28 MB
/releases/17.01.5/targets/oxnas/generic/lede-17.01.5-oxnas-pogoplug-pro-squashfs-sysupgrade.tar;3;0;3;7.07 MB;2.36 MB
/releases/17.01.4/targets/gemini/raidsonic/lede-17.01.4-gemini-raidsonic-nas4220-rd.gz;3;0;3;6.62 MB;2.21 MB
/releases/17.01.2/targets/sunxi/generic/lede-17.01.2-sunxi-sun4i-a10-pcduino-squashfs-sdcard.img.gz;3;0;3;607.24 KB;202.41 KB
/releases/17.01.0-rc2/targets/arc770/generic/lede-17.01.0-rc2-r3131-42f3c1f-arc770-generic-root.ext4.gz;3;0;3;2.95 MB;1007.44 KB
/releases/17.01.4/targets/armvirt/generic/lede-17.01.4-armvirt-rootfs.cpio.gz;3;0;3;1.87 MB;638.81 KB
/snapshots/faillogs/mipsel_24kc_24kf/packages/node/host-compile.txt;3;0;3;8.04 MB;2.68 MB
/releases/18.06.6/targets/x86/generic/openwrt-18.06.6-x86-generic-combined-squashfs.img.gz;3;0;3;7.34 MB;2.45 MB
/releases/19.07.3/targets/at91/sam9x/openwrt-19.07.3-at91-sam9x-usb_a9263-ext4-factory.bin.gz;3;0;3;6.21 MB;2.07 MB
/releases/17.01.0/targets/x86/legacy/lede-17.01.0-r3205-59508e3-x86-legacy-combined-ext4.img.gz;3;7;10;13.03 MB;1.30 MB
/releases/18.06.0/targets/sunxi/cortexa7/openwrt-18.06.0-sunxi-cortexa7-sun8i-h2-plus-orangepi-r1-squashfs-sdcard.img.gz;3;0;3;9.06 MB;3.02 MB
/releases/18.06.1/targets/at91/sama5d2/openwrt-18.06.1-at91-sama5d2-at91-sama5d2_xplained-ext4-root.ubi.gz;3;0;3;2.66 MB;908.45 KB
/releases/19.07.3/targets/layerscape/armv8_64b/openwrt-19.07.3-layerscape-armv8_64b-ls1043ardb-sdboot-ext4-sdcard.img.gz;3;0;3;8.67 MB;2.89 MB
/releases/19.07.3/targets/octeon/generic/openwrt-19.07.3-octeon-erlite-squashfs-sysupgrade.tar;3;0;3;26.51 MB;8.84 MB
/releases/19.07.0/targets/omap/generic/openwrt-19.07.0-omap-ti_am335x-evm-squashfs-sdcard.img.gz;3;0;3;11.73 MB;3.91 MB
/releases/19.07.0/targets/at91/sama5/openwrt-19.07.0-at91-sama5-at91-sama5d27_som1_ek-ext4-zImage.gz;3;0;3;6.77 MB;2.26 MB
/releases/19.07.3/targets/at91/sama5/openwrt-19.07.3-at91-sama5-at91-sama5d27_som1_ek-ext4-zImage.gz;3;0;3;3.67 MB;1.22 MB
/releases/19.07.3/targets/armvirt/32/openwrt-19.07.3-armvirt-32-root.squashfs.gz;3;0;3;1.93 MB;658.88 KB
/releases/19.07.0/targets/x86/geode/openwrt-19.07.0-x86-geode-combined-squashfs.img.gz;3;0;3;12.96 MB;4.32 MB
/releases/17.01.0-rc2/targets/armvirt/generic/lede-17.01.0-rc2-r3131-42f3c1f-armvirt-root.squashfs.gz;3;0;3;1.70 MB;580.04 KB
/releases/18.06.7/targets/x86/generic/openwrt-18.06.7-x86-generic-rootfs-squashfs.img.gz;3;0;3;2.12 MB;724.87 KB
/releases/19.07.0/targets/x86/legacy/openwrt-19.07.0-x86-legacy-generic-rootfs.tar.gz;3;0;3;5.88 MB;1.96 MB
/releases/18.06.7/targets/x86/legacy/openwrt-18.06.7-x86-legacy-combined-ext4.img.gz;3;0;3;1.56 MB;532.87 KB
/releases/19.07.3/targets/at91/sama5/openwrt-19.07.3-at91-sama5-at91-sama5d3_xplained-ext4-zImage.gz;3;0;3;3.69 MB;1.23 MB
/releases/19.07.0/targets/at91/sam9x/openwrt-19.07.0-at91-sam9x-at91sam9g25ek-ext4-root.ubi.gz;3;0;3;5.10 MB;1.70 MB
/releases/17.01.3/targets/ipq806x/generic/lede-17.01.3-ipq806x-AP148-legacy-ubifs-nand-sysupgrade.tar;3;0;3;8.05 MB;2.68 MB
/releases/19.07.0/targets/sunxi/cortexa8/openwrt-19.07.0-sunxi-cortexa8-sun5i-a13-olinuxino-squashfs-sdcard.img.gz;3;0;3;15.31 MB;5.10 MB
/releases/18.06.0/targets/at91/sama5d4/openwrt-18.06.0-at91-sama5d4-at91-sama5d4_xplained-ext4-root.ubi.gz;3;0;3;2.67 MB;912.13 KB
/releases/19.07.0/targets/at91/sam9x/openwrt-19.07.0-at91-sam9x-rootfs.tar.gz;3;0;3;4.39 MB;1.46 MB
/releases/18.06.1/targets/imx6/generic/openwrt-18.06.1-imx6-rootfs.tar.gz;3;0;3;2.28 MB;777.11 KB
/releases/19.07.0/targets/at91/sam9x/openwrt-19.07.0-at91-sam9x-at91sam9m10g45ek-ext4-root.ubi.gz;3;0;3;5.09 MB;1.70 MB
/releases/18.06.1/targets/at91/sama5d2/openwrt-18.06.1-at91-sama5d2-at91-sama5d27_som1_ek-ext4-zImage.gz;3;0;3;5.98 MB;1.99 MB
/releases/17.01.0/targets/oxnas/generic/lede-17.01.0-r3205-59508e3-oxnas-pogoplug-pro-ubifs-sysupgrade.tar;3;0;3;3.12 MB;1.04 MB
/releases/18.06.6/targets/x86/geode/openwrt-18.06.6-x86-geode-combined-squashfs.img.gz;3;0;3;6.46 MB;2.15 MB
/releases/19.07.0/targets/sunxi/cortexa7/openwrt-19.07.0-sunxi-cortexa7-sun8i-h3-nanopi-m1-plus-ext4-sdcard.img.gz;3;0;3;20.80 MB;6.93 MB
/releases/18.06.0/targets/at91/sama5d2/openwrt-18.06.0-at91-sama5d2-at91-sama5d2_xplained-ext4-zImage.gz;3;0;3;3.43 MB;1.14 MB
/releases/19.07.0/targets/at91/sam9x/openwrt-19.07.0-at91-sam9x-wb45n-ext4-root.ubi.gz;3;0;3;7.64 MB;2.55 MB
/releases/17.01.0-rc2/targets/ar71xx/nand/lede-17.01.0-rc2-r3131-42f3c1f-ar71xx-nand-r6100-squashfs-sysupgrade.tar;3;0;3;4.53 MB;1.51 MB
/releases/19.07.0/targets/sunxi/cortexa7/openwrt-19.07.0-sunxi-cortexa7-sun7i-a20-olinuxino-lime2-emmc-ext4-sdcard.img.gz;3;0;3;17.20 MB;5.73 MB
/releases/17.01.4/targets/sunxi/generic/lede-17.01.4-sunxi-sun7i-a20-bananapi-squashfs-sdcard.img.gz;3;0;3;2.59 MB;885.08 KB
/releases/19.07.0/targets/at91/sama5/openwrt-19.07.0-at91-sama5-at91-sama5d4_xplained-ext4-zImage.gz;3;0;3;6.90 MB;2.30 MB
/releases/17.01.2/targets/sunxi/generic/lede-17.01.2-sunxi-sun8i-h3-orangepi-plus-squashfs-sdcard.img.gz;3;0;3;399.24 KB;133.08 KB
/releases/19.07.0/targets/sunxi/cortexa7/openwrt-19.07.0-sunxi-cortexa7-sun6i-a31-m9-ext4-sdcard.img.gz;3;0;3;18.38 MB;6.13 MB
/releases/19.07.3/targets/arc770/generic/openwrt-19.07.3-arc770-generic-root.ext4.gz;3;0;3;3.36 MB;1.12 MB
/releases/17.01.5/targets/oxnas/generic/lede-17.01.5-oxnas-pogoplug-v3-ubifs-sysupgrade.tar;3;0;3;9.75 MB;3.25 MB
/releases/19.07.3/targets/at91/sam9x/openwrt-19.07.3-at91-sam9x-tny_a9263-ext4-factory.bin.gz;3;0;3;6.08 MB;2.03 MB
/releases/17.01.3/targets/sunxi/generic/lede-17.01.3-sunxi-sun7i-a20-bananapro-squashfs-sdcard.img.gz;3;0;3;4.76 MB;1.59 MB
/releases/19.07.0/targets/at91/sam9x/openwrt-19.07.0-at91-sam9x-tny_a9260-ext4-factory.bin.gz;3;0;3;11.89 MB;3.96 MB
/releases/17.01.2/targets/armvirt/generic/lede-17.01.2-armvirt-root.ext4.gz;3;0;3;2.31 MB;789.22 KB
/releases/19.07.0-rc2/targets/sunxi/cortexa7/openwrt-19.07.0-rc2-sunxi-cortexa7-sun7i-a20-pcduino3-ext4-sdcard.img.gz;3;0;3;12.28 MB;4.09 MB
/releases/19.07.0/targets/sunxi/cortexa7/openwrt-19.07.0-sunxi-cortexa7-sun7i-a20-cubieboard2-ext4-sdcard.img.gz;3;0;3;16.91 MB;5.64 MB
/releases/17.01.2/targets/x86/generic/lede-17.01.2-x86-generic-generic-rootfs.tar.gz;3;0;3;1.09 MB;373.08 KB
/releases/17.01.3/targets/kirkwood/generic/lede-17.01.3-kirkwood-dockstar-squashfs-sysupgrade.tar;3;0;3;3.31 MB;1.10 MB
/releases/18.06.1/targets/at91/sama5d3/openwrt-18.06.1-at91-sama5d3-at91-sama5d3_xplained-ext4-sdcard.img.gz;3;0;3;8.39 MB;2.80 MB
/releases/19.07.2/targets/sunxi/cortexa7/openwrt-19.07.2-sunxi-cortexa7-sun7i-a20-pcduino3-squashfs-sdcard.img.gz;3;0;3;10.43 MB;3.48 MB
/releases/17.01.0-rc1/targets/ipq806x/generic/lede-17.01.0-rc1-r3042-ec095b5-ipq806x-AP148-legacy-squashfs-nand-sysupgrade.tar;3;0;3;9.22 MB;3.07 MB
/releases/17.01.2/targets/ar71xx/generic/lede-17.01.2-ar71xx-generic-vmlinux.lzma;3;0;3;2.20 MB;751.92 KB
/releases/17.01.0-rc1/targets/ipq806x/generic/lede-17.01.0-rc1-r3042-ec095b5-ipq806x-R7500-squashfs-sysupgrade.tar;3;0;3;5.95 MB;1.98 MB
/releases/19.07.0/targets/at91/sam9x/openwrt-19.07.0-at91-sam9x-at91sam9x35ek-ext4-root.ubi.gz;3;0;3;5.21 MB;1.74 MB
/releases/19.07.3/targets/x86/legacy/openwrt-19.07.3-x86-legacy-rootfs-ext4.img.gz;3;0;3;3.55 MB;1.18 MB
/releases/19.07.2/targets/mvebu/cortexa72/openwrt-19.07.2-mvebu-cortexa72-marvell_macchiatobin-ext4-sdcard.img.gz;3;0;3;14.11 MB;4.70 MB
/releases/17.01.2/targets/sunxi/generic/lede-17.01.2-sunxi-sun7i-a20-bananapro-squashfs-sdcard.img.gz;3;0;3;479.24 KB;159.75 KB
/releases/17.01.2/targets/sunxi/generic/lede-17.01.2-sunxi-sun7i-a20-olinuxino-micro-squashfs-sdcard.img.gz;3;0;3;591.24 KB;197.08 KB
/releases/18.06.6/targets/at91/legacy/openwrt-18.06.6-at91-legacy-rootfs.tar.gz;3;0;3;2.28 MB;777.14 KB
/releases/19.07.1/targets/mxs/generic/openwrt-19.07.1-mxs-duckbill-sdcard.img.gz;3;0;3;22.87 MB;7.62 MB
/releases/18.06.6/targets/x86/64/openwrt-18.06.6-x86-64-rootfs-squashfs.img.gz;3;0;3;2.90 MB;991.05 KB
/releases/17.01.4/targets/zynq/generic/lede-17.01.4-zynq-rootfs.tar.gz;3;0;3;2.02 MB;689.63 KB
/releases/19.07.0/targets/sunxi/cortexa8/openwrt-19.07.0-sunxi-cortexa8-sun4i-a10-pcduino-squashfs-sdcard.img.gz;3;0;3;15.26 MB;5.09 MB
/releases/17.01.3/targets/mxs/generic/lede-17.01.3-mxs-duckbill-sdcard.img.gz;3;0;3;9.78 MB;3.26 MB
/releases/18.06.1/targets/apm821xx/sata/openwrt-18.06.1-apm821xx-sata-wd_mybooklive-ext4-rootfs.img.gz;3;0;3;11.18 MB;3.73 MB
/releases/17.01.5/targets/ramips/mt7621/lede-17.01.5-ramips-mt7621-ubnt-erx-squashfs-sysupgrade.tar;3;0;3;6.04 MB;2.01 MB
/releases/19.07.2/targets/x86/legacy/openwrt-19.07.2-x86-legacy-rootfs-squashfs.img.gz;3;0;3;4.99 MB;1.66 MB
/releases/18.06.2/targets/sunxi/cortexa7/openwrt-18.06.2-sunxi-cortexa7-sun7i-a20-bananapro-squashfs-sdcard.img.gz;3;0;3;10.32 MB;3.44 MB
/releases/17.01.3/targets/x86/legacy/lede-17.01.3-x86-legacy-rootfs-ext4.img.gz;3;0;3;3.07 MB;1.02 MB
/releases/19.07.0/targets/gemini/generic/openwrt-19.07.0-gemini-dlink_dir-685-ext4-sysupgrade.bin.gz;3;0;3;18.23 MB;6.08 MB
/releases/18.06.9/targets/ramips/mt7621/openwrt-18.06.9-ramips-mt7621-r6220-squashfs-sysupgrade.tar;3;0;3;12.51 MB;4.17 MB
/snapshots/faillogs/mipsel_74kc/packages/node/host-compile.txt;3;0;3;8.03 MB;2.68 MB
/releases/18.06.1/targets/at91/legacy/openwrt-18.06.1-at91-legacy-at91sam9g20ek-ext4-root.ubi.gz;3;0;3;2.64 MB;901.77 KB
/releases/17.01.2/targets/sunxi/generic/lede-17.01.2-sunxi-sun7i-a20-bananapro-ext4-sdcard.img.gz;3;0;3;5.86 MB;1.95 MB
/releases/18.06.0/targets/mvebu/cortexa9/openwrt-18.06.0-mvebu-cortexa9-armada-388-clearfog-base-squashfs-sdcard.img.gz;3;0;3;9.15 MB;3.05 MB
/releases/18.06.2/targets/x86/legacy/openwrt-18.06.2-x86-legacy-rootfs-ext4.img.gz;3;0;3;6.18 MB;2.06 MB
/releases/19.07.0/targets/omap/generic/openwrt-19.07.0-omap-ti_omap3-beagle-ext4-sdcard.img.gz;3;0;3;13.59 MB;4.53 MB
/releases/18.06.6/targets/x86/generic/openwrt-18.06.6-x86-generic-rootfs-squashfs.img.gz;3;0;3;2.63 MB;898.09 KB
/releases/19.07.1/targets/brcm2708/bcm2708/openwrt-19.07.1-brcm2708-bcm2708-rpi-squashfs-sysupgrade.img.gz;3;0;3;20.78 MB;6.93 MB
/releases/17.01.2/targets/armvirt/generic/lede-17.01.2-armvirt-rootfs.cpio.gz;3;0;3;2.00 MB;681.18 KB
/releases/19.07.3/targets/sunxi/cortexa8/openwrt-19.07.3-sunxi-cortexa8-sun5i-a13-olinuxino-squashfs-sdcard.img.gz;3;0;3;10.92 MB;3.64 MB
/releases/18.06.6/targets/at91/legacy/openwrt-18.06.6-at91-legacy-at91sam9x35ek-ext4-root.ubi.gz;3;0;3;2.64 MB;900.00 KB
/releases/18.06.5/targets/at91/legacy/openwrt-18.06.5-at91-legacy-at91sam9g20ek-ext4-zImage.gz;3;0;3;3.27 MB;1.09 MB
/releases/18.06.0/targets/sunxi/cortexa7/openwrt-18.06.0-sunxi-cortexa7-sun7i-a20-bananapro-squashfs-sdcard.img.gz;3;0;3;5.39 MB;1.80 MB
/releases/19.07.0/targets/at91/sam9x/openwrt-19.07.0-at91-sam9x-lmu5000-ext4-factory.bin.gz;3;0;3;12.04 MB;4.01 MB
/releases/18.06.1/targets/ar71xx/tiny/openwrt-18.06.1-ar71xx-tiny-vmlinux.lzma;3;0;3;414.62 KB;138.21 KB
/releases/18.06.0/targets/omap/generic/openwrt-18.06.0-omap-am335x-evm-ext4-sdcard.img.gz;3;0;3;6.12 MB;2.04 MB
/releases/17.01.0-rc1/targets/ipq806x/generic/lede-17.01.0-rc1-r3042-ec095b5-ipq806x-AP148-squashfs-nand-sysupgrade.tar;3;0;3;5.64 MB;1.88 MB
/releases/19.07.0/targets/sunxi/cortexa8/openwrt-19.07.0-sunxi-cortexa8-sun5i-a13-olinuxino-ext4-sdcard.img.gz;3;0;3;18.23 MB;6.08 MB
/releases/19.07.3/targets/at91/sama5/openwrt-19.07.3-at91-sama5-at91-sama5d27_som1_ek-ext4-root.ubi.gz;3;0;3;3.06 MB;1.02 MB
/releases/17.01.0-rc2/targets/apm821xx/nand/lede-17.01.0-rc2-r3131-42f3c1f-apm821xx-nand-mr24-squashfs-sysupgrade.tar;3;0;3;3.74 MB;1.25 MB
/releases/19.07.0/targets/sunxi/cortexa7/openwrt-19.07.0-sunxi-cortexa7-sun7i-a20-cubietruck-squashfs-sdcard.img.gz;3;0;3;16.32 MB;5.44 MB
/releases/19.07.2/targets/apm821xx/sata/openwrt-19.07.2-apm821xx-sata-wd_mybooklive-squashfs-sysupgrade.img.gz;3;0;3;16.24 MB;5.41 MB
/releases/18.06.9/targets/brcm2708/bcm2710/openwrt-18.06.9-brcm2708-bcm2710-rpi-3-squashfs-sysupgrade.img.gz;3;0;3;23.44 MB;7.81 MB
/releases/18.06.2/targets/archs38/generic/openwrt-18.06.2-archs38-generic-root.ext4.gz;3;0;3;5.83 MB;1.94 MB
/releases/17.01.0-rc2/targets/archs38/generic/lede-17.01.0-rc2-r3131-42f3c1f-archs38-generic-root.ext4.gz;3;0;3;2.89 MB;985.84 KB
/releases/18.06.1/targets/sunxi/cortexa8/openwrt-18.06.1-sunxi-cortexa8-sun4i-a10-pcduino-squashfs-sdcard.img.gz;3;0;3;7.67 MB;2.56 MB
/releases/19.07.2/targets/omap/generic/openwrt-19.07.2-omap-ti_omap3-beagle-ext4-sdcard.img.gz;3;0;3;8.54 MB;2.85 MB
/snapshots/faillogs/arm_cortex-a9/packages/frr/host-compile.txt;3;0;3;31.80 KB;10.60 KB
/releases/18.06.1/targets/sunxi/cortexa7/openwrt-18.06.1-sunxi-cortexa7-sun7i-a20-lamobo-r1-ext4-sdcard.img.gz;3;0;3;12.32 MB;4.11 MB
/releases/19.07.3/targets/sunxi/cortexa8/openwrt-19.07.3-sunxi-cortexa8-sun5i-a13-olinuxino-ext4-sdcard.img.gz;3;0;3;6.37 MB;2.12 MB
/releases/18.06.5/targets/omap/generic/openwrt-18.06.5-omap-am335x-boneblack-ubifs-sdcard.img.gz;3;0;3;6.21 MB;2.07 MB
/releases/18.06.1/targets/sunxi/cortexa7/openwrt-18.06.1-sunxi-cortexa7-sun7i-a20-olinuxino-lime2-emmc-ext4-sdcard.img.gz;3;0;3;8.11 MB;2.70 MB
/snapshots/faillogs/arm_arm926ej-s/packages/frr/host-compile.txt;3;0;3;31.80 KB;10.60 KB
/releases/18.06.1/targets/imx6/generic/openwrt-18.06.1-imx6-ventana-squashfs-bootfs.tar.gz;3;0;3;2.78 MB;949.22 KB
/releases/19.07.2/targets/zynq/generic/openwrt-19.07.2-zynq-digilent_zynq-zybo-squashfs-sdcard.img.gz;3;0;3;11.86 MB;3.95 MB
/snapshots/faillogs/arm_cortex-a7_neon-vfpv4/packages/node/host-compile.txt;3;0;3;8.11 MB;2.70 MB
/releases/19.07.0/targets/at91/sama5/openwrt-19.07.0-at91-sama5-at91-sama5d2_ptc_ek-ext4-root.ubi.gz;3;0;3;5.25 MB;1.75 MB
/releases/19.07.0-rc1/targets/x86/generic/openwrt-19.07.0-rc1-x86-generic-combined-ext4.img.gz;3;0;3;24.00 MB;8.00 MB
/releases/18.06.2/targets/omap/generic/openwrt-18.06.2-omap-am335x-boneblack-ext4-sdcard.img.gz;3;0;3;7.25 MB;2.42 MB
/releases/19.07.2/targets/sunxi/cortexa53/openwrt-19.07.2-sunxi-cortexa53-sun50i-a64-pine64-plus-squashfs-sdcard.img.gz;3;0;3;17.98 MB;5.99 MB
/releases/17.01.3/targets/sunxi/generic/lede-17.01.3-sunxi-sun7i-a20-lamobo-r1-ext4-sdcard.img.gz;3;0;3;5.69 MB;1.90 MB
/releases/17.01.2/targets/sunxi/generic/lede-17.01.2-sunxi-sun5i-a13-olinuxino-squashfs-sdcard.img.gz;3;0;3;367.24 KB;122.41 KB
/releases/19.07.2/targets/brcm63xx/smp/openwrt-19.07.2-brcm63xx-smp-livebox-vmlinux.gz;3;0;3;7.12 MB;2.38 MB
/releases/18.06.0/targets/ar71xx/nand/openwrt-18.06.0-ar71xx-nand-hiveap-121-squashfs-sysupgrade.tar;3;0;3;7.56 MB;2.52 MB
/releases/19.07.3/targets/brcm2708/bcm2708/openwrt-19.07.3-brcm2708-bcm2708-rpi-squashfs-factory.img.gz;3;0;3;2.59 MB;884.87 KB
/releases/19.07.1/targets/at91/sam9x/openwrt-19.07.1-at91-sam9x-usb_a9263-ext4-factory.bin.gz;3;0;3;11.87 MB;3.96 MB
/releases/17.01.2/targets/apm821xx/sata/lede-17.01.2-apm821xx-sata-MyBookLiveDuo-ext4-rootfs.img.gz;3;0;3;5.55 MB;1.85 MB
/releases/19.07.0/targets/sunxi/cortexa7/openwrt-19.07.0-sunxi-cortexa7-sun7i-a20-olinuxino-lime-squashfs-sdcard.img.gz;3;0;3;14.36 MB;4.79 MB
/releases/17.01.4/targets/sunxi/generic/lede-17.01.4-sunxi-sun4i-a10-olinuxino-lime-squashfs-sdcard.img.gz;3;0;3;4.42 MB;1.47 MB
/releases/18.06.3/targets/sunxi/cortexa8/openwrt-18.06.3-sunxi-cortexa8-sun5i-a13-olinuxino-ext4-sdcard.img.gz;3;0;3;11.58 MB;3.86 MB
/releases/17.01.3/targets/apm821xx/sata/lede-17.01.3-apm821xx-sata-MyBookLiveDuo-ext4-rootfs.img.gz;3;0;3;5.38 MB;1.79 MB
/releases/19.07.0/targets/at91/sam9x/openwrt-19.07.0-at91-sam9x-at91sam9g20ek_2mmc-ext4-root.ubi.gz;3;0;3;5.10 MB;1.70 MB
/releases/19.07.0/targets/sunxi/cortexa53/openwrt-19.07.0-sunxi-cortexa53-sun50i-h5-nanopi-neo-plus2-ext4-sdcard.img.gz;3;0;3;20.32 MB;6.77 MB
/releases/19.07.2/targets/x86/generic/openwrt-19.07.2-x86-generic-rootfs-squashfs.img.gz;3;0;3;3.09 MB;1.03 MB
/releases/17.01.4/targets/mediatek/generic/lede-17.01.4-mediatek-NAND-squashfs-sysupgrade.tar;3;0;3;7.42 MB;2.47 MB
/releases/18.06.6/targets/x86/legacy/openwrt-18.06.6-x86-legacy-rootfs-squashfs.img.gz;3;0;3;2.54 MB;867.42 KB
/releases/18.06.7/targets/omap/generic/openwrt-18.06.7-omap-rootfs.tar.gz;3;0;3;2.33 MB;793.86 KB
/releases/17.01.1/targets/ath25/generic/lede-17.01.1-ath25-generic-kernel.gz;3;0;3;1.72 MB;586.58 KB
/releases/19.07.3/targets/layerscape/armv8_64b/openwrt-19.07.3-layerscape-armv8_64b-ls1088ardb-sdboot-ext4-sdcard.img.gz;3;0;3;9.04 MB;3.01 MB
/releases/faillogs-19.07/arm_fa526/packages/node/host-compile.txt;3;0;3;10.67 MB;3.56 MB
/releases/18.06.1/targets/omap/generic/openwrt-18.06.1-omap-am335x-boneblack-ubifs-sdcard.img.gz;3;0;3;7.34 MB;2.45 MB
/releases/18.06.2/targets/mvebu/cortexa9/openwrt-18.06.2-mvebu-cortexa9-armada-388-clearfog-pro-squashfs-sdcard.img.gz;3;0;3;4.84 MB;1.61 MB
/releases/18.06.1/targets/at91/sama5d2/openwrt-18.06.1-at91-sama5d2-at91-sama5d2_xplained-ext4-sdcard.img.gz;3;0;3;5.89 MB;1.96 MB
/releases/18.06.1/targets/at91/legacy/openwrt-18.06.1-at91-legacy-at91sam9g20ek_2mmc-ext4-zImage.gz;3;0;3;5.55 MB;1.85 MB
/releases/17.01.0-rc2/targets/x86/64/lede-17.01.0-rc2-r3131-42f3c1f-x86-64-rootfs-ext4.img.gz;3;0;3;6.12 MB;2.04 MB
/releases/18.06.0/targets/x86/64/openwrt-18.06.0-x86-64-generic-rootfs.tar.gz;3;0;3;3.69 MB;1.23 MB
/releases/19.07.2/targets/mvebu/cortexa53/openwrt-19.07.2-mvebu-cortexa53-globalscale_espressobin-v7-emmc-ext4-sdcard.img.gz;3;0;3;14.52 MB;4.84 MB
/releases/17.01.3/targets/kirkwood/generic/lede-17.01.3-kirkwood-goflexnet-squashfs-sysupgrade.tar;3;0;3;3.48 MB;1.16 MB
/releases/18.06.1/targets/at91/sama5d2/openwrt-18.06.1-at91-sama5d2-at91-sama5d27_som1_ek-ext4-sdcard.img.gz;3;0;3;5.76 MB;1.92 MB
/releases/18.06.1/targets/mvebu/cortexa53/openwrt-18.06.1-mvebu-cortexa53-globalscale-espressobin-squashfs-sdcard.img.gz;3;0;3;10.81 MB;3.60 MB
/releases/17.01.0-rc2/targets/at91/legacy/lede-17.01.0-rc2-r3131-42f3c1f-at91-legacy-default-rootfs.tar.gz;3;0;3;2.11 MB;721.89 KB
/releases/19.07.0/targets/sunxi/cortexa7/openwrt-19.07.0-sunxi-cortexa7-sun8i-h3-nanopi-m1-plus-squashfs-sdcard.img.gz;3;0;3;17.50 MB;5.83 MB
/releases/18.06.4/targets/at91/sama5d2/openwrt-18.06.4-at91-sama5d2-at91-sama5d27_som1_ek-ext4-root.ubi.gz;3;0;3;2.70 MB;920.68 KB
/releases/18.06.0-rc1/targets/ar71xx/nand/openwrt-18.06.0-rc1-ar71xx-nand-nbg6716-squashfs-sysupgrade.tar;3;0;3;10.35 MB;3.45 MB
/releases/17.01.5/targets/imx6/generic/lede-17.01.5-imx6-rootfs.tar.gz;3;0;3;2.20 MB;749.73 KB
/releases/19.07.0/targets/sunxi/cortexa53/openwrt-19.07.0-sunxi-cortexa53-sun50i-h5-nanopi-neo-plus2-squashfs-sdcard.img.gz;3;0;3;17.96 MB;5.99 MB
/releases/19.07.0/targets/sunxi/cortexa53/openwrt-19.07.0-sunxi-cortexa53-sun50i-a64-sopine-baseboard-squashfs-sdcard.img.gz;3;0;3;17.96 MB;5.99 MB
/releases/19.07.3/targets/zynq/generic/openwrt-19.07.3-zynq-digilent_zynq-zybo-squashfs-sdcard.img.gz;3;0;3;6.09 MB;2.03 MB
/releases/18.06.1/targets/sunxi/cortexa8/openwrt-18.06.1-sunxi-cortexa8-sun4i-a10-olinuxino-lime-squashfs-sdcard.img.gz;3;0;3;7.07 MB;2.36 MB
/releases/19.07.0/targets/at91/sam9x/openwrt-19.07.0-at91-sam9x-ethernut5-ext4-root.ubi.gz;3;0;3;5.09 MB;1.70 MB
/releases/19.07.0-rc2/targets/sunxi/cortexa7/openwrt-19.07.0-rc2-sunxi-cortexa7-sun7i-a20-bananapi-ext4-sdcard.img.gz;3;0;3;5.99 MB;2.00 MB
/releases/19.07.0/targets/sunxi/cortexa8/openwrt-19.07.0-sunxi-cortexa8-sun4i-a10-cubieboard-ext4-sdcard.img.gz;3;0;3;16.70 MB;5.57 MB
/releases/17.01.0-rc1/targets/arc770/generic/lede-17.01.0-rc1-r3042-ec095b5-arc770-generic-root.ext4.gz;3;0;3;2.83 MB;964.41 KB
/releases/19.07.0/targets/sunxi/cortexa7/openwrt-19.07.0-sunxi-cortexa7-sun8i-h3-orangepi-pc-ext4-sdcard.img.gz;3;0;3;16.82 MB;5.61 MB
/releases/17.01.0/targets/brcm2708/bcm2709/lede-17.01.0-r3205-59508e3-brcm2708-bcm2709-rpi-2-ext4-sdcard.img.gz;3;2;5;14.00 MB;2.80 MB
/releases/17.01.3/targets/octeon/generic/lede-17.01.3-octeon-erlite-squashfs-sysupgrade.tar;3;0;3;7.45 MB;2.48 MB
/releases/19.07.0/targets/sunxi/cortexa53/openwrt-19.07.0-sunxi-cortexa53-sun50i-a64-pine64-plus-ext4-sdcard.img.gz;3;0;3;20.32 MB;6.77 MB
/releases/19.07.0/targets/sunxi/cortexa7/openwrt-19.07.0-sunxi-cortexa7-sun7i-a20-cubieboard2-squashfs-sdcard.img.gz;3;0;3;14.37 MB;4.79 MB
/releases/18.06.1/targets/sunxi/cortexa7/openwrt-18.06.1-sunxi-cortexa7-sun7i-a20-lamobo-r1-squashfs-sdcard.img.gz;3;0;3;10.23 MB;3.41 MB
/releases/19.07.1/targets/brcm2708/bcm2708/openwrt-19.07.1-brcm2708-bcm2708-rpi-ext4-factory.img.gz;3;0;3;34.51 MB;11.50 MB
/releases/18.06.2/targets/omap/generic/openwrt-18.06.2-omap-omap3-beagle-ext4-sdcard.img.gz;3;0;3;7.28 MB;2.43 MB
/releases/17.01.0-rc1/targets/archs38/generic/lede-17.01.0-rc1-r3042-ec095b5-archs38-generic-Default-sdcard-vfat-ext4.img.gz;3;0;3;5.57 MB;1.86 MB
/releases/18.06.3/targets/sunxi/cortexa7/openwrt-18.06.3-sunxi-cortexa7-sun8i-h3-nanopi-m1-plus-ext4-sdcard.img.gz;3;0;3;6.97 MB;2.32 MB
/releases/19.07.0/targets/arc770/generic/openwrt-19.07.0-arc770-generic-root.ext4.gz;3;0;3;8.83 MB;2.94 MB
/releases/19.07.1/targets/at91/sam9x/openwrt-19.07.1-at91-sam9x-at91sam9g20ek_2mmc-ext4-root.ubi.gz;3;0;3;2.96 MB;1011.42 KB
/releases/19.07.0/targets/at91/sam9x/openwrt-19.07.0-at91-sam9x-at91sam9263ek-ext4-root.ubi.gz;3;0;3;5.10 MB;1.70 MB
/releases/17.01.1/targets/octeon/generic/lede-17.01.1-octeon-er-squashfs-sysupgrade.tar;3;0;3;9.68 MB;3.23 MB
/releases/18.06.7/targets/x86/geode/openwrt-18.06.7-x86-geode-combined-squashfs.img.gz;3;0;3;4.48 MB;1.49 MB
/releases/18.06.1/targets/x86/legacy/openwrt-18.06.1-x86-legacy-combined-ext4.img.gz;3;0;3;13.69 MB;4.56 MB
/releases/19.07.0/targets/sunxi/cortexa7/openwrt-19.07.0-sunxi-cortexa7-sun8i-h3-orangepi-2-ext4-sdcard.img.gz;3;0;3;16.80 MB;5.60 MB
/releases/18.06.4/targets/at91/sama5d4/openwrt-18.06.4-at91-sama5d4-at91-sama5d4_xplained-ext4-zImage.gz;3;0;3;3.34 MB;1.11 MB
/releases/17.01.7/targets/sunxi/generic/lede-17.01.7-sunxi-sun4i-a10-pcduino-squashfs-sdcard.img.gz;3;0;3;8.82 MB;2.94 MB
/releases/19.07.3/targets/at91/sam9x/openwrt-19.07.3-at91-sam9x-wb45n-ext4-root.ubi.gz;3;0;3;4.14 MB;1.38 MB
/releases/17.01.0/targets/oxnas/generic/lede-17.01.0-r3205-59508e3-oxnas-pogoplug-v3-ubifs-sysupgrade.tar;3;0;3;3.36 MB;1.12 MB
/releases/18.06.5/targets/at91/legacy/openwrt-18.06.5-at91-legacy-tny_a9g20-ext4-factory.bin.gz;3;0;3;5.90 MB;1.97 MB
/releases/17.01.3/targets/sunxi/generic/lede-17.01.3-sunxi-sun7i-a20-olinuxino-lime-squashfs-sdcard.img.gz;3;0;3;4.17 MB;1.39 MB
/releases/18.06.1/targets/sunxi/cortexa7/openwrt-18.06.1-sunxi-cortexa7-sun8i-h3-nanopi-neo-ext4-sdcard.img.gz;3;0;3;5.45 MB;1.82 MB
/releases/18.06.3/targets/x86/64/openwrt-18.06.3-x86-64-combined-ext4.img.gz;3;0;3;13.04 MB;4.35 MB
/releases/18.06.2/targets/omap/generic/openwrt-18.06.2-omap-am335x-boneblack-ubifs-sdcard.img.gz;3;0;3;7.35 MB;2.45 MB
/releases/17.01.2/targets/sunxi/generic/lede-17.01.2-sunxi-sun7i-a20-pcduino3-squashfs-sdcard.img.gz;3;0;3;543.24 KB;181.08 KB
/releases/19.07.0/targets/sunxi/cortexa53/openwrt-19.07.0-sunxi-cortexa53-sun50i-h5-orangepi-zero-plus-ext4-sdcard.img.gz;3;0;3;20.32 MB;6.77 MB
/releases/19.07.0/targets/at91/sam9x/openwrt-19.07.0-at91-sam9x-at91sam9g15ek-ext4-root.ubi.gz;3;0;3;5.10 MB;1.70 MB
/releases/19.07.1/targets/at91/sam9x/openwrt-19.07.1-at91-sam9x-at91sam9g20ek-ext4-root.ubi.gz;3;0;3;2.92 MB;995.77 KB
/releases/18.06.0/targets/ar71xx/nand/openwrt-18.06.0-ar71xx-nand-rambutan-squashfs-sysupgrade.tar;3;0;3;7.54 MB;2.51 MB
/releases/18.06.4/targets/mvebu/cortexa53/openwrt-18.06.4-mvebu-cortexa53-globalscale-espressobin-ext4-sdcard.img.gz;3;0;3;6.40 MB;2.13 MB
/releases/19.07.1/targets/sunxi/cortexa7/openwrt-19.07.1-sunxi-cortexa7-sun8i-h3-orangepi-pc-plus-ext4-sdcard.img.gz;3;0;3;6.00 MB;2.00 MB
/releases/19.07.3/targets/at91/sam9x/openwrt-19.07.3-at91-sam9x-at91sam9g25ek-ext4-root.ubi.gz;3;0;3;2.70 MB;922.13 KB
/releases/19.07.2/targets/sunxi/cortexa7/openwrt-19.07.2-sunxi-cortexa7-sun8i-h2-plus-orangepi-zero-ext4-sdcard.img.gz;3;0;3;16.78 MB;5.59 MB
/snapshots/faillogs/arm_cortex-a7/packages/frr/host-compile.txt;3;0;3;31.80 KB;10.60 KB
/releases/18.06.1/targets/apm821xx/nand/openwrt-18.06.1-apm821xx-nand-netgear_wndr4700-squashfs-sysupgrade.tar;3;0;3;15.59 MB;5.20 MB
/releases/19.07.3/targets/sunxi/cortexa7/openwrt-19.07.3-sunxi-cortexa7-sun8i-h3-orangepi-plus-squashfs-sdcard.img.gz;3;0;3;5.03 MB;1.68 MB
/releases/17.01.3/targets/ar71xx/nand/lede-17.01.3-ar71xx-nand-c-60-squashfs-sysupgrade.tar;3;0;3;3.78 MB;1.26 MB
/releases/19.07.0/targets/at91/sama5/openwrt-19.07.0-at91-sama5-at91-sama5d2_xplained-ext4-root.ubi.gz;3;0;3;5.06 MB;1.69 MB
/releases/17.01.0/targets/zynq/generic/lede-17.01.0-r3205-59508e3-zynq-zc702-uramdisk.image.gz;3;0;3;575.24 KB;191.75 KB
/releases/19.07.3/targets/x86/legacy/openwrt-19.07.3-x86-legacy-generic-rootfs.tar.gz;3;0;3;3.26 MB;1.09 MB
/releases/17.01.3/targets/sunxi/generic/lede-17.01.3-sunxi-sun7i-a20-pcduino3-squashfs-sdcard.img.gz;3;0;3;4.49 MB;1.50 MB
/releases/17.01.4/targets/sunxi/generic/lede-17.01.4-sunxi-sun7i-a20-olinuxino-lime-ext4-sdcard.img.gz;3;0;3;3.09 MB;1.03 MB
/snapshots/faillogs/arm_cortex-a5_vfpv4/packages/frr/host-compile.txt;3;0;3;31.80 KB;10.60 KB
/releases/19.07.3/targets/sunxi/cortexa7/openwrt-19.07.3-sunxi-cortexa7-sun7i-a20-cubietruck-ext4-sdcard.img.gz;3;0;3;6.82 MB;2.27 MB
/releases/17.01.0-rc2/targets/ar71xx/nand/lede-17.01.0-rc2-r3131-42f3c1f-ar71xx-nand-wndr3700v4-squashfs-sysupgrade.tar;3;0;3;4.41 MB;1.47 MB
/releases/18.06.0/targets/omap/generic/openwrt-18.06.0-omap-am335x-boneblack-ext4-sdcard.img.gz;3;0;3;6.20 MB;2.07 MB
/releases/19.07.2/targets/layerscape/armv8_64b/openwrt-19.07.2-layerscape-armv8_64b-ls1046ardb-sdboot-ext4-sdcard.img.gz;3;0;3;10.62 MB;3.54 MB
/releases/18.06.0/targets/ar71xx/nand/openwrt-18.06.0-ar71xx-nand-wi2a-ac200i-squashfs-sysupgrade.tar;3;0;3;8.12 MB;2.71 MB
/releases/18.06.6/targets/ath25/generic/openwrt-18.06.6-ath25-generic-kernel.gz;3;0;3;2.41 MB;821.03 KB
/releases/17.01.3/targets/sunxi/generic/lede-17.01.3-sunxi-sun7i-a20-cubietruck-ext4-sdcard.img.gz;3;0;3;5.68 MB;1.89 MB
/releases/18.06.4/targets/at91/legacy/openwrt-18.06.4-at91-legacy-rootfs.tar.gz;3;0;3;2.32 MB;792.25 KB
/releases/18.06.4/targets/at91/sama5d2/openwrt-18.06.4-at91-sama5d2-at91-sama5d27_som1_ek-ext4-zImage.gz;3;0;3;3.32 MB;1.11 MB
/releases/19.07.0/targets/x86/generic/openwrt-19.07.0-x86-generic-rootfs-squashfs.img.gz;3;0;3;5.89 MB;1.96 MB
/releases/19.07.0/targets/mvebu/cortexa9/openwrt-19.07.0-mvebu-cortexa9-cznic_turris-omnia-sysupgrade.img.gz;3;0;3;16.45 MB;5.48 MB
/releases/17.01.3/targets/ipq806x/generic/lede-17.01.3-ipq806x-AP148-ubifs-nand-sysupgrade.tar;3;0;3;8.97 MB;2.99 MB
/releases/19.07.3/targets/sunxi/cortexa7/openwrt-19.07.3-sunxi-cortexa7-sun8i-h2-plus-orangepi-r1-squashfs-sdcard.img.gz;3;0;3;9.74 MB;3.25 MB
/releases/18.06.2/targets/brcm2708/bcm2710/openwrt-18.06.2-brcm2708-bcm2710-rpi-3-squashfs-factory.img.gz;3;0;3;15.83 MB;5.28 MB
/releases/17.01.0/targets/oxnas/generic/lede-17.01.0-r3205-59508e3-oxnas-pogoplug-v3-squashfs-sysupgrade.tar;3;0;3;3.16 MB;1.05 MB
/releases/18.06.4/targets/ar71xx/nand/openwrt-18.06.4-ar71xx-nand-hiveap-121-squashfs-sysupgrade.tar;3;0;3;3.94 MB;1.31 MB
/releases/18.06.2/targets/oxnas/ox820/openwrt-18.06.2-oxnas-ox820-shuttle-kd20-squashfs-sysupgrade.tar;3;0;3;6.70 MB;2.23 MB
/releases/19.07.0/targets/at91/sam9x/openwrt-19.07.0-at91-sam9x-at91sam9g35ek-ext4-root.ubi.gz;3;0;3;5.17 MB;1.72 MB
/releases/19.07.3/targets/at91/sam9x/openwrt-19.07.3-at91-sam9x-at91sam9g20ek_2mmc-ext4-zImage.gz;3;0;3;3.66 MB;1.22 MB
/releases/18.06.2/targets/at91/sama5d3/openwrt-18.06.2-at91-sama5d3-at91-sama5d3_xplained-ext4-sdcard.img.gz;3;0;3;5.86 MB;1.95 MB
/releases/18.06.4/targets/brcm2708/bcm2710/openwrt-18.06.4-brcm2708-bcm2710-rpi-3-squashfs-sysupgrade.img.gz;3;0;3;15.83 MB;5.28 MB
/releases/17.01.2/targets/sunxi/generic/lede-17.01.2-sunxi-sun7i-a20-olinuxino-lime-squashfs-sdcard.img.gz;3;0;3;287.24 KB;95.75 KB
/releases/17.01.4/targets/apm821xx/nand/lede-17.01.4-apm821xx-nand-mx60w-squashfs-sysupgrade.tar;3;0;3;4.39 MB;1.46 MB
/releases/19.07.2/targets/mvebu/cortexa53/openwrt-19.07.2-mvebu-cortexa53-globalscale_espressobin-v7-ext4-sdcard.img.gz;3;0;3;16.36 MB;5.45 MB
/releases/18.06.0/targets/sunxi/cortexa7/openwrt-18.06.0-sunxi-cortexa7-sun7i-a20-olinuxino-lime-ext4-sdcard.img.gz;3;0;3;5.62 MB;1.87 MB
/releases/17.01.3/targets/ipq806x/generic/lede-17.01.3-ipq806x-AP148-legacy-squashfs-nand-sysupgrade.tar;3;0;3;4.55 MB;1.52 MB
/releases/19.07.0/targets/at91/sama5/openwrt-19.07.0-at91-sama5-at91-sama5d2_xplained-ext4-sdcard.img.gz;3;0;3;12.00 MB;4.00 MB
/releases/19.07.0/targets/imx6/generic/openwrt-19.07.0-imx6-rootfs.tar.gz;3;0;3;5.25 MB;1.75 MB
/releases/18.06.3/targets/x86/geode/openwrt-18.06.3-x86-geode-combined-squashfs.img.gz;3;0;3;6.47 MB;2.16 MB
/releases/18.06.6/targets/x86/geode/openwrt-18.06.6-x86-geode-rootfs-squashfs.img.gz;3;0;3;3.90 MB;1.30 MB
/releases/17.01.3/targets/sunxi/generic/lede-17.01.3-sunxi-sun7i-a20-cubieboard2-ext4-sdcard.img.gz;3;0;3;4.93 MB;1.64 MB
/releases/19.07.0/targets/sunxi/cortexa8/openwrt-19.07.0-sunxi-cortexa8-sun4i-a10-cubieboard-squashfs-sdcard.img.gz;3;0;3;14.14 MB;4.71 MB
/releases/17.01.5/targets/oxnas/generic/lede-17.01.5-oxnas-pogoplug-pro-ubifs-sysupgrade.tar;3;0;3;9.70 MB;3.23 MB
/releases/17.01.3/targets/ipq806x/generic/lede-17.01.3-ipq806x-R7500-squashfs-sysupgrade.tar;3;0;3;7.36 MB;2.45 MB
/releases/19.07.0-rc2/targets/sunxi/cortexa7/openwrt-19.07.0-rc2-sunxi-cortexa7-sun7i-a20-olinuxino-lime2-emmc-ext4-sdcard.img.gz;3;0;3;6.09 MB;2.03 MB
/releases/18.06.1/targets/sunxi/cortexa7/openwrt-18.06.1-sunxi-cortexa7-sun7i-a20-olinuxino-lime-ext4-sdcard.img.gz;3;0;3;5.53 MB;1.84 MB
/releases/17.01.3/targets/sunxi/generic/lede-17.01.3-sunxi-sun4i-a10-pcduino-ext4-sdcard.img.gz;3;0;3;5.37 MB;1.79 MB
/releases/18.06.2/targets/omap/generic/openwrt-18.06.2-omap-omap4-panda-ext4-sdcard.img.gz;3;0;3;7.16 MB;2.39 MB
/releases/19.07.0/targets/sunxi/cortexa8/openwrt-19.07.0-sunxi-cortexa8-sun4i-a10-olinuxino-lime-squashfs-sdcard.img.gz;3;0;3;14.14 MB;4.71 MB
/releases/19.07.0/targets/sunxi/cortexa53/openwrt-19.07.0-sunxi-cortexa53-sun50i-h5-orangepi-pc2-ext4-sdcard.img.gz;3;0;3;20.39 MB;6.80 MB
/releases/17.01.5/targets/kirkwood/generic/lede-17.01.5-kirkwood-dockstar-squashfs-sysupgrade.tar;3;0;3;6.65 MB;2.22 MB
/releases/17.01.6/targets/oxnas/generic/lede-17.01.6-oxnas-pogoplug-pro-squashfs-sysupgrade.tar;3;0;3;575.24 KB;191.75 KB
/releases/19.07.0/targets/omap/generic/openwrt-19.07.0-omap-ti_omap3-beagle-squashfs-sdcard.img.gz;3;0;3;11.72 MB;3.91 MB
/releases/18.06.5/targets/mvebu/cortexa53/openwrt-18.06.5-mvebu-cortexa53-globalscale-espressobin-ext4-sdcard.img.gz;3;0;3;6.40 MB;2.13 MB
/releases/17.01.0-rc1/targets/ipq806x/generic/lede-17.01.0-rc1-r3042-ec095b5-ipq806x-R7800-squashfs-sysupgrade.tar;3;0;3;6.73 MB;2.24 MB
/releases/19.07.0/targets/at91/sama5/openwrt-19.07.0-at91-sama5-at91-sama5d2_xplained-ext4-zImage.gz;3;0;3;6.96 MB;2.32 MB
/releases/18.06.2/targets/ar71xx/nand/openwrt-18.06.2-ar71xx-nand-r6100-squashfs-sysupgrade.tar;3;0;3;5.07 MB;1.69 MB
/releases/17.01.0/targets/zynq/generic/lede-17.01.0-r3205-59508e3-zynq-zed-uramdisk.image.gz;3;0;3;735.24 KB;245.08 KB
/releases/18.06.7/targets/omap/generic/openwrt-18.06.7-omap-am335x-boneblack-ubifs-sdcard.img.gz;3;0;3;6.21 MB;2.07 MB
/releases/17.01.0-rc2/targets/ath25/generic/lede-17.01.0-rc2-r3131-42f3c1f-ath25-generic-kernel.gz;3;0;3;2.77 MB;943.92 KB
/releases/18.06.0/targets/ar71xx/nand/openwrt-18.06.0-ar71xx-nand-z1-squashfs-sysupgrade.tar;3;0;3;7.05 MB;2.35 MB
/releases/18.06.1/targets/x86/generic/openwrt-18.06.1-x86-generic-combined-squashfs.img.gz;3;0;3;13.79 MB;4.60 MB
/releases/18.06.7/targets/omap/generic/openwrt-18.06.7-omap-am335x-evm-ext4-sdcard.img.gz;3;0;3;11.87 MB;3.96 MB
/releases/19.07.3/targets/sunxi/cortexa8/openwrt-19.07.3-sunxi-cortexa8-sun5i-a13-olimex-som-ext4-sdcard.img.gz;3;0;3;6.51 MB;2.17 MB
/releases/19.07.3/targets/sunxi/cortexa7/openwrt-19.07.3-sunxi-cortexa7-sun7i-a20-bananapi-squashfs-sdcard.img.gz;3;0;3;9.86 MB;3.29 MB
/releases/18.06.0/targets/at91/sama5d2/openwrt-18.06.0-at91-sama5d2-at91-sama5d27_som1_ek-ext4-zImage.gz;3;0;3;3.46 MB;1.15 MB
/releases/17.01.0/targets/armvirt/generic/lede-17.01.0-r3205-59508e3-armvirt-root.squashfs.gz;3;0;3;1.45 MB;495.04 KB
/releases/19.07.3/targets/imx6/generic/openwrt-19.07.3-imx6-rootfs.tar.gz;3;0;3;2.78 MB;948.84 KB
/releases/17.01.0-rc2/targets/armvirt/generic/lede-17.01.0-rc2-r3131-42f3c1f-armvirt-rootfs.cpio.gz;3;0;3;2.05 MB;701.17 KB
/releases/19.07.0/targets/omap/generic/openwrt-19.07.0-omap-ti_am335x-bone-black-ext4-sdcard.img.gz;3;0;3;13.34 MB;4.45 MB
/releases/17.01.1/targets/x86/geode/lede-17.01.1-x86-geode-rootfs-ext4.img.gz;3;0;3;559.24 KB;186.41 KB
/releases/19.07.2/targets/x86/64/openwrt-19.07.2-x86-64-rootfs-squashfs.img.gz;3;0;3;5.81 MB;1.94 MB
/releases/19.07.0/targets/at91/sama5/openwrt-19.07.0-at91-sama5-at91-sama5d4_xplained-ext4-root.ubi.gz;3;0;3;4.95 MB;1.65 MB
/releases/19.07.0/targets/at91/sama5/openwrt-19.07.0-at91-sama5-at91-sama5d3_xplained-ext4-sdcard.img.gz;3;0;3;12.20 MB;4.07 MB
/releases/17.01.2/targets/at91/legacy/lede-17.01.2-at91-legacy-default-rootfs.tar.gz;3;0;3;2.14 MB;728.80 KB
/releases/19.07.3/targets/at91/sama5/openwrt-19.07.3-at91-sama5-at91-sama5d2_ptc_ek-ext4-sdcard.img.gz;3;0;3;6.35 MB;2.12 MB
/releases/18.06.4/targets/brcm2708/bcm2708/openwrt-18.06.4-brcm2708-bcm2708-rpi-squashfs-sysupgrade.img.gz;3;0;3;7.81 MB;2.60 MB
/releases/19.07.0/targets/sunxi/cortexa8/openwrt-19.07.0-sunxi-cortexa8-sun5i-a13-olimex-som-ext4-sdcard.img.gz;3;0;3;18.13 MB;6.04 MB
/releases/18.06.6/targets/x86/64/openwrt-18.06.6-x86-64-generic-rootfs.tar.gz;3;0;3;3.28 MB;1.09 MB
/releases/18.06.1/targets/at91/legacy/openwrt-18.06.1-at91-legacy-usb_a9g20-ext4-factory.bin.gz;3;0;3;8.25 MB;2.75 MB
/releases/17.01.5/targets/oxnas/generic/lede-17.01.5-oxnas-stg212-ubifs-sysupgrade.tar;3;0;3;9.86 MB;3.29 MB
/releases/19.07.3/targets/sunxi/cortexa7/openwrt-19.07.3-sunxi-cortexa7-sun7i-a20-pcduino3-ext4-sdcard.img.gz;3;0;3;12.32 MB;4.11 MB
/releases/17.01.4/targets/brcm63xx/generic/lede-17.01.4-brcm63xx-generic-livebox-vmlinux.gz;3;0;3;3.62 MB;1.21 MB
/releases/17.01.5/targets/sunxi/generic/lede-17.01.5-sunxi-sun5i-a13-olinuxino-ext4-sdcard.img.gz;3;0;3;10.60 MB;3.53 MB
/releases/19.07.0/targets/at91/sama5/openwrt-19.07.0-at91-sama5-at91-sama5d3_xplained-ext4-zImage.gz;3;0;3;6.77 MB;2.26 MB
/releases/17.01.3/targets/x86/generic/lede-17.01.3-x86-generic-rootfs-ext4.img.gz;3;0;3;3.23 MB;1.08 MB
/releases/17.01.2/targets/x86/generic/lede-17.01.2-x86-generic-combined-ext4.img.gz;3;0;3;5.03 MB;1.68 MB
/releases/17.01.5/targets/sunxi/generic/lede-17.01.5-sunxi-sun5i-a13-olinuxino-squashfs-sdcard.img.gz;3;0;3;4.58 MB;1.53 MB
/releases/18.06.0/targets/x86/64/openwrt-18.06.0-x86-64-rootfs-ext4.img.gz;3;0;3;3.55 MB;1.18 MB
/releases/18.06.2/targets/oxnas/ox820/openwrt-18.06.2-oxnas-ox820-akitio-mycloud-squashfs-sysupgrade.tar;3;0;3;1.72 MB;586.21 KB
/releases/19.07.0/targets/sunxi/cortexa53/openwrt-19.07.0-sunxi-cortexa53-sun50i-a64-pine64-plus-squashfs-sdcard.img.gz;3;0;3;17.96 MB;5.99 MB
/releases/19.07.0/targets/imx6/generic/openwrt-19.07.0-imx6-ventana-squashfs-bootfs.tar.gz;3;0;3;5.20 MB;1.73 MB
/releases/18.06.2/targets/sunxi/cortexa7/openwrt-18.06.2-sunxi-cortexa7-sun8i-h3-orangepi-pc-ext4-sdcard.img.gz;3;0;3;10.67 MB;3.56 MB
/releases/17.01.0-rc2/targets/archs38/generic/lede-17.01.0-rc2-r3131-42f3c1f-archs38-generic-Default-sdcard-vfat-ext4.img.gz;3;0;3;5.52 MB;1.84 MB
/releases/19.07.3/targets/at91/sam9x/openwrt-19.07.3-at91-sam9x-tny_a9g20-ext4-factory.bin.gz;3;0;3;6.24 MB;2.08 MB
/releases/17.01.4/targets/armvirt/generic/lede-17.01.4-armvirt-root.squashfs.gz;3;0;3;1.67 MB;570.50 KB
/releases/19.07.3/targets/at91/sama5/openwrt-19.07.3-at91-sama5-at91-sama5d4_xplained-ext4-zImage.gz;3;0;3;3.73 MB;1.24 MB
/releases/17.01.5/targets/oxnas/generic/lede-17.01.5-oxnas-kd20-squashfs-sysupgrade.tar;3;0;3;7.13 MB;2.38 MB
/releases/19.07.0/targets/mvebu/cortexa9/openwrt-19.07.0-mvebu-cortexa9-solidrun_clearfog-base-a1-squashfs-sdcard.img.gz;3;0;3;14.14 MB;4.71 MB
/releases/19.07.0/targets/sunxi/cortexa7/openwrt-19.07.0-sunxi-cortexa7-sun8i-h3-bananapi-m2-plus-ext4-sdcard.img.gz;3;0;3;20.86 MB;6.95 MB
/releases/17.01.2/targets/ar71xx/nand/lede-17.01.2-ar71xx-nand-wndr3700v4-squashfs-sysupgrade.tar;3;0;3;4.43 MB;1.48 MB
/releases/faillogs-18.06/arc_arc700/packages/node/host-compile.txt;3;0;3;11.09 MB;3.70 MB
/releases/17.01.3/targets/octeon/generic/lede-17.01.3-octeon-er-squashfs-sysupgrade.tar;3;0;3;7.56 MB;2.52 MB
/releases/19.07.3/targets/ar71xx/nand/openwrt-19.07.3-ar71xx-nand-hiveap-121-squashfs-sysupgrade.tar;3;0;3;7.86 MB;2.62 MB
/releases/18.06.1/targets/sunxi/cortexa8/openwrt-18.06.1-sunxi-cortexa8-sun5i-a13-olimex-som-squashfs-sdcard.img.gz;3;0;3;7.25 MB;2.42 MB
/releases/18.06.1/targets/at91/sama5d2/openwrt-18.06.1-at91-sama5d2-at91-sama5d2_ptc_ek-ext4-root.ubi.gz;3;0;3;2.60 MB;887.09 KB
/releases/19.07.0/targets/at91/sam9x/openwrt-19.07.0-at91-sam9x-tny_a9g20-ext4-factory.bin.gz;3;0;3;11.84 MB;3.95 MB
/releases/19.07.0/targets/at91/sam9x/openwrt-19.07.0-at91-sam9x-at91sam9g20ek_2mmc-ext4-zImage.gz;3;0;3;6.77 MB;2.26 MB
/releases/19.07.3/targets/at91/sama5/openwrt-19.07.3-at91-sama5-at91-sama5d2_ptc_ek-ext4-zImage.gz;3;0;3;3.78 MB;1.26 MB
/snapshots/faillogs/mipsel_24kc/packages/frr/host-compile.txt;3;0;3;31.80 KB;10.60 KB
/releases/19.07.0/targets/at91/sama5/openwrt-19.07.0-at91-sama5-at91-sama5d4_xplained-ext4-sdcard.img.gz;3;0;3;12.05 MB;4.02 MB
/releases/18.06.0/targets/ar71xx/tiny/openwrt-18.06.0-ar71xx-tiny-vmlinux.lzma;3;0;3;1.66 MB;565.03 KB
/releases/18.06.7/targets/x86/64/openwrt-18.06.7-x86-64-generic-rootfs.tar.gz;3;0;3;4.27 MB;1.42 MB
/releases/19.07.2/targets/at91/sama5/openwrt-19.07.2-at91-sama5-at91-sama5d2_xplained-ext4-sdcard.img.gz;3;0;3;12.21 MB;4.07 MB
/releases/18.06.2/targets/at91/sama5d2/openwrt-18.06.2-at91-sama5d2-at91-sama5d2_ptc_ek-ext4-zImage.gz;3;0;3;6.41 MB;2.14 MB
/releases/18.06.0/targets/x86/legacy/openwrt-18.06.0-x86-legacy-combined-ext4.img.gz;3;0;3;6.88 MB;2.29 MB
/releases/19.07.0/targets/at91/sama5/openwrt-19.07.0-at91-sama5-at91-sama5d27_som1_ek-ext4-root.ubi.gz;3;0;3;5.05 MB;1.68 MB
/releases/18.06.2/targets/sunxi/cortexa7/openwrt-18.06.2-sunxi-cortexa7-sun6i-a31-m9-squashfs-sdcard.img.gz;3;0;3;9.77 MB;3.26 MB
/releases/17.01.7/targets/sunxi/generic/lede-17.01.7-sunxi-sun4i-a10-cubieboard-ext4-sdcard.img.gz;3;0;3;5.05 MB;1.68 MB
/releases/17.01.2/targets/ar71xx/nand/lede-17.01.2-ar71xx-nand-r6100-squashfs-sysupgrade.tar;3;0;3;4.74 MB;1.58 MB
/releases/19.07.3/targets/at91/sam9x/openwrt-19.07.3-at91-sam9x-at91sam9x35ek-ext4-root.ubi.gz;3;0;3;2.86 MB;975.52 KB
/releases/18.06.9/targets/mvebu/cortexa9/omnia-medkit-openwrt-18.06.9-mvebu-cortexa9-turris-omnia-initramfs.tar.gz;3;0;3;11.18 MB;3.73 MB
/releases/18.06.3/targets/sunxi/cortexa7/openwrt-18.06.3-sunxi-cortexa7-sun7i-a20-olinuxino-lime-squashfs-sdcard.img.gz;3;0;3;4.80 MB;1.60 MB
/releases/19.07.0-rc2/targets/sunxi/cortexa7/openwrt-19.07.0-rc2-sunxi-cortexa7-sun7i-a20-olinuxino-lime2-squashfs-sdcard.img.gz;3;0;3;5.11 MB;1.70 MB
/releases/17.01.3/targets/ipq806x/generic/lede-17.01.3-ipq806x-NBG6817-squashfs-sysupgrade.tar;3;0;3;7.26 MB;2.42 MB
/releases/19.07.1/targets/x86/64/openwrt-19.07.1-x86-64-rootfs-squashfs.img.gz;3;0;3;3.27 MB;1.09 MB
/releases/19.07.0/targets/sunxi/cortexa7/openwrt-19.07.0-sunxi-cortexa7-sun7i-a20-olinuxino-lime2-emmc-squashfs-sdcard.img.gz;3;0;3;14.60 MB;4.87 MB
/releases/17.01.0/targets/mediatek/generic/lede-17.01.0-r3205-59508e3-mediatek-NAND-squashfs-sysupgrade.tar;3;0;3;6.73 MB;2.24 MB
/releases/19.07.0/targets/at91/sam9x/openwrt-19.07.0-at91-sam9x-at91sam9263ek-ext4-zImage.gz;3;0;3;6.83 MB;2.28 MB
/snapshots/faillogs/aarch64_cortex-a53/packages/frr/host-compile.txt;3;0;3;32.19 KB;10.73 KB
/snapshots/faillogs/arm_mpcore_vfp/packages/mariadb/host-compile.txt;3;0;3;110.04 KB;36.68 KB
/releases/18.06.1/targets/mvebu/cortexa72/openwrt-18.06.1-mvebu-cortexa72-armada-macchiatobin-ext4-sdcard.img.gz;3;0;3;1.58 MB;538.21 KB
/releases/18.06.6/targets/at91/sama5d4/openwrt-18.06.6-at91-sama5d4-at91-sama5d4_xplained-ext4-root.ubi.gz;3;0;3;2.52 MB;861.45 KB
/releases/18.06.1/targets/sunxi/cortexa7/openwrt-18.06.1-sunxi-cortexa7-sun7i-a20-pcduino3-ext4-sdcard.img.gz;3;0;3;6.05 MB;2.02 MB
/releases/17.01.0-rc2/targets/ar71xx/nand/lede-17.01.0-rc2-r3131-42f3c1f-ar71xx-nand-z1-squashfs-sysupgrade.tar;3;0;3;6.55 MB;2.18 MB
/releases/18.06.7/targets/x86/generic/openwrt-18.06.7-x86-generic-rootfs-ext4.img.gz;3;0;3;4.36 MB;1.45 MB
/releases/19.07.0/targets/sunxi/cortexa7/openwrt-19.07.0-sunxi-cortexa7-sun7i-a20-olinuxino-lime2-squashfs-sdcard.img.gz;3;0;3;14.60 MB;4.87 MB
/releases/17.01.0/targets/oxnas/generic/lede-17.01.0-r3205-59508e3-oxnas-akitio-squashfs-sysupgrade.tar;3;0;3;2.92 MB;997.08 KB
/releases/17.01.0/targets/oxnas/generic/lede-17.01.0-r3205-59508e3-oxnas-kd20-factory.tar.gz;3;0;3;367.24 KB;122.41 KB
/releases/19.07.3/targets/at91/sam9x/openwrt-19.07.3-at91-sam9x-at91sam9g15ek-ext4-root.ubi.gz;3;0;3;2.95 MB;1007.41 KB
/releases/19.07.1/targets/at91/sam9x/openwrt-19.07.1-at91-sam9x-rootfs.tar.gz;3;0;3;2.45 MB;836.84 KB
/releases/18.06.1/targets/at91/sama5d3/openwrt-18.06.1-at91-sama5d3-at91-sama5d3_xplained-ext4-root.ubi.gz;3;0;3;4.81 MB;1.60 MB
/releases/17.01.2/targets/sunxi/generic/lede-17.01.2-sunxi-sun7i-a20-cubieboard2-ext4-sdcard.img.gz;3;0;3;5.36 MB;1.79 MB
/releases/19.07.3/targets/mvebu/cortexa9/openwrt-19.07.3-mvebu-cortexa9-cznic_turris-omnia-sysupgrade.img.gz;3;0;3;11.07 MB;3.69 MB
/releases/19.07.2/targets/sunxi/cortexa7/openwrt-19.07.2-sunxi-cortexa7-sun8i-h3-orangepi-one-squashfs-sdcard.img.gz;3;0;3;9.70 MB;3.23 MB
/releases/19.07.0/targets/sunxi/cortexa7/openwrt-19.07.0-sunxi-cortexa7-sun8i-h3-bananapi-m2-plus-squashfs-sdcard.img.gz;3;0;3;17.57 MB;5.86 MB
/releases/19.07.2/targets/mvebu/cortexa72/openwrt-19.07.2-mvebu-cortexa72-marvell_armada8040-db-squashfs-sdcard.img.gz;3;0;3;11.47 MB;3.82 MB
/releases/18.06.1/targets/sunxi/cortexa53/openwrt-18.06.1-sunxi-cortexa53-sun50i-h5-nanopi-neo-plus2-ext4-sdcard.img.gz;3;0;3;9.13 MB;3.04 MB
/releases/17.01.0-rc2/targets/apm821xx/nand/lede-17.01.0-rc2-r3131-42f3c1f-apm821xx-nand-mx60-squashfs-sysupgrade.tar;3;0;3;3.84 MB;1.28 MB
/releases/19.07.0/targets/sunxi/cortexa7/openwrt-19.07.0-sunxi-cortexa7-sun7i-a20-bananapro-ext4-sdcard.img.gz;3;0;3;19.19 MB;6.40 MB
/releases/18.06.6/targets/ramips/mt7621/openwrt-18.06.6-ramips-mt7621-r6220-squashfs-sysupgrade.tar;3;0;3;8.51 MB;2.84 MB
/releases/18.06.0/targets/at91/sama5d3/openwrt-18.06.0-at91-sama5d3-at91-sama5d3_xplained-ext4-zImage.gz;3;0;3;3.55 MB;1.18 MB
/releases/17.01.3/targets/x86/generic/lede-17.01.3-x86-generic-combined-ext4.img.gz;3;0;3;6.96 MB;2.32 MB
/snapshots/faillogs/powerpc_8540/packages/frr/host-compile.txt;3;0;3;32.59 KB;10.86 KB
/releases/19.07.3/targets/sunxi/cortexa7/openwrt-19.07.3-sunxi-cortexa7-sun7i-a20-olinuxino-lime-squashfs-sdcard.img.gz;3;0;3;9.66 MB;3.22 MB
/releases/17.01.2/targets/ar71xx/nand/lede-17.01.2-ar71xx-nand-z1-squashfs-sysupgrade.tar;3;0;3;6.56 MB;2.19 MB
/releases/18.06.7/targets/ramips/mt7621/openwrt-18.06.7-ramips-mt7621-ubnt-erx-squashfs-sysupgrade.tar;3;0;3;10.14 MB;3.38 MB
/releases/17.01.3/targets/ar71xx/nand/lede-17.01.3-ar71xx-nand-mr18-squashfs-sysupgrade.tar;3;0;3;6.49 MB;2.16 MB
/releases/17.01.0-rc2/targets/armvirt/generic/lede-17.01.0-rc2-r3131-42f3c1f-armvirt-default-rootfs.tar.gz;3;0;3;2.21 MB;755.12 KB
/releases/17.01.3/targets/sunxi/generic/lede-17.01.3-sunxi-sun5i-a13-olinuxino-ext4-sdcard.img.gz;3;0;3;5.39 MB;1.80 MB
/releases/18.06.2/targets/at91/sama5d2/openwrt-18.06.2-at91-sama5d2-at91-sama5d27_som1_ek-ext4-root.ubi.gz;3;0;3;4.82 MB;1.61 MB
/releases/18.06.3/targets/x86/legacy/openwrt-18.06.3-x86-legacy-combined-ext4.img.gz;3;0;3;13.67 MB;4.56 MB
/releases/18.06.0/targets/x86/64/openwrt-18.06.0-x86-64-rootfs-squashfs.img.gz;3;0;3;2.71 MB;925.23 KB
/releases/18.06.1/targets/at91/legacy/openwrt-18.06.1-at91-legacy-at91sam9g35ek-ext4-root.ubi.gz;3;0;3;2.69 MB;917.96 KB
/releases/18.06.2/targets/mvebu/cortexa9/openwrt-18.06.2-mvebu-cortexa9-armada-388-clearfog-base-squashfs-sdcard.img.gz;3;0;3;4.74 MB;1.58 MB
/releases/17.01.0/targets/octeon/generic/lede-17.01.0-r3205-59508e3-octeon-erlite-squashfs-sysupgrade.tar;3;0;3;11.33 MB;3.78 MB
/releases/17.01.3/targets/ipq806x/generic/lede-17.01.3-ipq806x-R7800-squashfs-sysupgrade.tar;3;0;3;4.94 MB;1.65 MB
/releases/17.01.7/targets/sunxi/generic/lede-17.01.7-sunxi-sun4i-a10-olinuxino-lime-ext4-sdcard.img.gz;3;0;3;9.69 MB;3.23 MB
/releases/19.07.0-rc2/targets/sunxi/cortexa7/openwrt-19.07.0-rc2-sunxi-cortexa7-sun8i-h3-orangepi-plus-ext4-sdcard.img.gz;3;0;3;11.46 MB;3.82 MB
/releases/19.07.3/targets/x86/legacy/openwrt-19.07.3-x86-legacy-rootfs-squashfs.img.gz;3;0;3;2.88 MB;984.15 KB
/releases/17.01.3/targets/sunxi/generic/lede-17.01.3-sunxi-sun7i-a20-bananapro-ext4-sdcard.img.gz;3;0;3;5.57 MB;1.86 MB
/releases/18.06.2/targets/at91/legacy/openwrt-18.06.2-at91-legacy-at91sam9m10g45ek-ext4-root.ubi.gz;3;0;3;2.71 MB;926.06 KB
/releases/17.01.2/targets/imx6/generic/lede-17.01.2-imx6-ventana-squashfs-bootfs.tar.gz;3;0;3;799.24 KB;266.41 KB
/releases/17.01.2/targets/sunxi/generic/lede-17.01.2-sunxi-sun7i-a20-bananapi-squashfs-sdcard.img.gz;3;0;3;367.24 KB;122.41 KB
/releases/17.01.0/targets/oxnas/generic/lede-17.01.0-r3205-59508e3-oxnas-kd20-ubifs-sysupgrade.tar;3;0;3;3.50 MB;1.17 MB
/releases/17.01.3/targets/sunxi/generic/lede-17.01.3-sunxi-sun7i-a20-olinuxino-lime-ext4-sdcard.img.gz;3;0;3;4.91 MB;1.64 MB
/releases/17.01.0/targets/sunxi/generic/lede-17.01.0-r3205-59508e3-sunxi-sun7i-a20-cubieboard2-squashfs-sdcard.img.gz;3;0;3;623.24 KB;207.75 KB
/releases/18.06.4/targets/brcm2708/bcm2709/openwrt-18.06.4-brcm2708-bcm2709-rpi-2-ext4-sysupgrade.img.gz;3;0;3;9.34 MB;3.11 MB
/releases/18.06.1/targets/sunxi/cortexa8/openwrt-18.06.1-sunxi-cortexa8-sun4i-a10-olinuxino-lime-ext4-sdcard.img.gz;3;0;3;9.62 MB;3.21 MB
/releases/18.06.7/targets/omap/generic/openwrt-18.06.7-omap-omap4-panda-ubifs-sdcard.img.gz;3;0;3;11.98 MB;3.99 MB
/snapshots/faillogs/mips_4kec/packages/frr/host-compile.txt;3;0;3;31.80 KB;10.60 KB
/releases/18.06.7/targets/mvebu/cortexa53/openwrt-18.06.7-mvebu-cortexa53-globalscale-espressobin-ext4-sdcard.img.gz;3;0;3;12.47 MB;4.16 MB
/releases/17.01.0-rc2/targets/armvirt/generic/lede-17.01.0-rc2-r3131-42f3c1f-armvirt-root.ext4.gz;3;0;3;2.18 MB;745.10 KB
/releases/18.06.6/targets/at91/legacy/openwrt-18.06.6-at91-legacy-usb_a9g20-ext4-factory.bin.gz;3;0;3;5.73 MB;1.91 MB
/releases/19.07.2/targets/imx6/generic/openwrt-19.07.2-imx6-rootfs.tar.gz;3;0;3;5.28 MB;1.76 MB
/releases/18.06.4/targets/ar71xx/tiny/openwrt-18.06.4-ar71xx-tiny-vmlinux.lzma;3;0;3;510.61 KB;170.20 KB
/releases/17.01.2/targets/arc770/generic/lede-17.01.2-arc770-generic-Default-sdcard-vfat-ext4.img.gz;3;0;3;10.95 MB;3.65 MB
/releases/17.01.3/targets/sunxi/generic/lede-17.01.3-sunxi-sun4i-a10-olinuxino-lime-squashfs-sdcard.img.gz;3;0;3;4.17 MB;1.39 MB
/releases/19.07.0/targets/brcm63xx/smp/openwrt-19.07.0-brcm63xx-smp-livebox-vmlinux.gz;3;0;3;7.12 MB;2.38 MB
/releases/19.07.3/targets/gemini/generic/openwrt-19.07.3-gemini-dlink_dir-685-ext4-factory.bin.gz;3;0;3;9.35 MB;3.12 MB
/releases/19.07.1/targets/sunxi/cortexa7/openwrt-19.07.1-sunxi-cortexa7-sun7i-a20-cubieboard2-ext4-sdcard.img.gz;3;0;3;6.10 MB;2.03 MB
/releases/17.01.3/targets/sunxi/generic/lede-17.01.3-sunxi-sun5i-a13-olinuxino-squashfs-sdcard.img.gz;3;0;3;4.52 MB;1.51 MB
/releases/18.06.0/targets/x86/geode/openwrt-18.06.0-x86-geode-combined-squashfs.img.gz;3;0;3;6.85 MB;2.28 MB
/releases/18.06.1/targets/x86/legacy/openwrt-18.06.1-x86-legacy-rootfs-ext4.img.gz;3;0;3;6.00 MB;2.00 MB
/releases/17.01.2/targets/sunxi/generic/lede-17.01.2-sunxi-sun7i-a20-cubietruck-squashfs-sdcard.img.gz;3;0;3;351.24 KB;117.08 KB
/releases/17.01.5/targets/mvebu/generic/lede-17.01.5-mvebu-armada-388-clearfog-sdcard.img.gz;3;0;3;4.39 MB;1.46 MB
/releases/17.01.2/targets/apm821xx/sata/lede-17.01.2-apm821xx-sata-MyBookLiveSingle-ext4-rootfs.img.gz;3;0;3;5.17 MB;1.72 MB
/releases/19.07.3/targets/zynq/generic/openwrt-19.07.3-zynq-avnet_zynq-zed-squashfs-sdcard.img.gz;3;0;3;8.36 MB;2.79 MB
/releases/17.01.4/targets/x86/64/lede-17.01.4-x86-64-rootfs-ext4.img.gz;3;0;3;3.33 MB;1.11 MB
/releases/19.07.0/targets/sunxi/cortexa53/openwrt-19.07.0-sunxi-cortexa53-sun50i-h5-orangepi-zero-plus-squashfs-sdcard.img.gz;3;0;3;17.96 MB;5.99 MB
/releases/19.07.2/targets/omap/generic/openwrt-19.07.2-omap-ti_am335x-evm-ext4-sdcard.img.gz;3;0;3;8.08 MB;2.69 MB
/releases/18.06.2/targets/sunxi/cortexa8/openwrt-18.06.2-sunxi-cortexa8-sun4i-a10-pcduino-squashfs-sdcard.img.gz;3;0;3;5.20 MB;1.73 MB
/releases/19.07.0/targets/omap/generic/openwrt-19.07.0-omap-ti_omap4-panda-squashfs-sdcard.img.gz;3;0;3;11.48 MB;3.83 MB
/releases/19.07.0-rc1/targets/brcm2708/bcm2708/openwrt-19.07.0-rc1-brcm2708-bcm2708-rpi-squashfs-sysupgrade.img.gz;3;0;3;10.57 MB;3.52 MB
/releases/18.06.7/targets/x86/generic/openwrt-18.06.7-x86-generic-combined-ext4.img.gz;3;0;3;9.17 MB;3.06 MB
/releases/19.07.3/targets/mvebu/cortexa53/openwrt-19.07.3-mvebu-cortexa53-marvell_armada-3720-db-ext4-sdcard.img.gz;3;0;3;6.70 MB;2.23 MB
/releases/17.01.3/targets/mediatek/generic/lede-17.01.3-mediatek-eMMC-sysupgrade.tar;3;0;3;5.27 MB;1.76 MB
/releases/18.06.6/targets/mvebu/cortexa9/omnia-medkit-openwrt-18.06.6-mvebu-cortexa9-turris-omnia-initramfs.tar.gz;3;0;3;3.89 MB;1.30 MB
/releases/18.06.0-rc2/targets/x86/generic/openwrt-18.06.0-rc2-x86-generic-combined-squashfs.img.gz;3;0;3;20.47 MB;6.82 MB
/releases/19.07.3/targets/sunxi/cortexa8/openwrt-19.07.3-sunxi-cortexa8-sun4i-a10-pcduino-ext4-sdcard.img.gz;3;0;3;6.48 MB;2.16 MB
/releases/17.01.3/targets/sunxi/generic/lede-17.01.3-sunxi-sun7i-a20-cubieboard2-squashfs-sdcard.img.gz;3;0;3;4.17 MB;1.39 MB
/releases/19.07.0-rc2/targets/sunxi/cortexa7/openwrt-19.07.0-rc2-sunxi-cortexa7-sun8i-h2-plus-orangepi-zero-squashfs-sdcard.img.gz;3;0;3;5.07 MB;1.69 MB
/releases/19.07.0/targets/at91/sam9x/openwrt-19.07.0-at91-sam9x-usb_a9263-ext4-factory.bin.gz;3;0;3;11.86 MB;3.95 MB
/releases/19.07.1/targets/omap/generic/openwrt-19.07.1-omap-rootfs.tar.gz;3;0;3;2.94 MB;1001.85 KB
/releases/17.01.3/targets/x86/legacy/lede-17.01.3-x86-legacy-combined-ext4.img.gz;3;0;3;6.32 MB;2.11 MB
/releases/18.06.1/targets/x86/legacy/openwrt-18.06.1-x86-legacy-combined-squashfs.img.gz;3;0;3;12.11 MB;4.04 MB
/releases/17.01.2/targets/apm821xx/nand/lede-17.01.2-apm821xx-nand-mx60w-squashfs-sysupgrade.tar;3;0;3;4.78 MB;1.59 MB
/releases/19.07.0/targets/sunxi/cortexa53/openwrt-19.07.0-sunxi-cortexa53-sun50i-h5-nanopi-neo2-ext4-sdcard.img.gz;3;0;3;20.32 MB;6.77 MB
/snapshots/faillogs/arm_mpcore/packages/frr/host-compile.txt;3;0;3;31.80 KB;10.60 KB
/releases/17.01.0/targets/sunxi/generic/lede-17.01.0-r3205-59508e3-sunxi-sun7i-a20-cubietruck-ext4-sdcard.img.gz;3;0;3;559.24 KB;186.41 KB
/releases/19.07.3/targets/mvebu/cortexa53/openwrt-19.07.3-mvebu-cortexa53-globalscale_espressobin-emmc-squashfs-sdcard.img.gz;3;0;3;8.43 MB;2.81 MB
/releases/19.07.1/targets/at91/sam9x/openwrt-19.07.1-at91-sam9x-tny_a9263-ext4-factory.bin.gz;3;0;3;6.26 MB;2.09 MB
/releases/18.06.3/targets/sunxi/cortexa8/openwrt-18.06.3-sunxi-cortexa8-sun4i-a10-cubieboard-squashfs-sdcard.img.gz;3;0;3;8.97 MB;2.99 MB
/releases/18.06.0-rc1/targets/ramips/mt7621/openwrt-18.06.0-rc1-ramips-mt7621-r6220-squashfs-sysupgrade.tar;3;0;3;7.67 MB;2.56 MB
/releases/18.06.5/targets/sunxi/cortexa7/openwrt-18.06.5-sunxi-cortexa7-sun8i-h3-orangepi-pc-squashfs-sdcard.img.gz;3;0;3;4.79 MB;1.60 MB
/releases/19.07.3/targets/oxnas/ox820/openwrt-19.07.3-oxnas-ox820-akitio_mycloud-squashfs-sysupgrade.tar;3;0;3;8.00 MB;2.67 MB
/releases/17.01.5/targets/oxnas/generic/lede-17.01.5-oxnas-kd20-ubifs-sysupgrade.tar;3;0;3;10.83 MB;3.61 MB
/releases/18.06.0/targets/mvebu/cortexa9/openwrt-18.06.0-mvebu-cortexa9-turris-omnia-sysupgrade.img.gz;3;0;3;10.47 MB;3.49 MB
/releases/19.07.0/targets/x86/geode/openwrt-19.07.0-x86-geode-combined-ext4.img.gz;3;0;3;14.94 MB;4.98 MB
/releases/19.07.0/targets/omap/generic/openwrt-19.07.0-omap-ti_am335x-bone-black-squashfs-sdcard.img.gz;3;0;3;11.60 MB;3.87 MB
/releases/17.01.0/targets/armvirt/generic/lede-17.01.0-r3205-59508e3-armvirt-root.ext4.gz;3;0;3;2.20 MB;750.99 KB
/releases/19.07.2/targets/sunxi/cortexa53/openwrt-19.07.2-sunxi-cortexa53-sun50i-h5-orangepi-zero-plus-squashfs-sdcard.img.gz;3;0;3;17.98 MB;5.99 MB
/releases/17.01.3/targets/apm821xx/sata/lede-17.01.3-apm821xx-sata-MyBookLiveSingle-ext4-rootfs.img.gz;3;0;3;5.56 MB;1.85 MB
/releases/18.06.0-rc2/targets/ar71xx/nand/openwrt-18.06.0-rc2-ar71xx-nand-z1-squashfs-sysupgrade.tar;3;0;3;9.73 MB;3.24 MB
/releases/18.06.5/targets/x86/generic/openwrt-18.06.5-x86-generic-combined-ext4.img.gz;3;0;3;15.39 MB;5.13 MB
/releases/19.07.3/targets/mxs/generic/openwrt-19.07.3-mxs-root.ext4.gz;3;0;3;5.90 MB;1.97 MB
/releases/17.01.3/targets/sunxi/generic/lede-17.01.3-sunxi-sun6i-a31-m9-squashfs-sdcard.img.gz;3;0;3;4.50 MB;1.50 MB
/releases/17.01.3/targets/mxs/generic/lede-17.01.3-mxs-root.ext4.gz;3;0;3;4.68 MB;1.56 MB
/releases/19.07.3/targets/layerscape/armv7/openwrt-19.07.3-layerscape-armv7-ls1021atwr-sdboot-ext4-sdcard.img.gz;3;0;3;6.73 MB;2.24 MB
/releases/19.07.0-rc2/targets/brcm2708/bcm2710/openwrt-19.07.0-rc2-brcm2708-bcm2710-rpi-3-ext4-sysupgrade.img.gz;3;0;3;36.17 MB;12.06 MB
/releases/17.01.3/targets/kirkwood/generic/lede-17.01.3-kirkwood-goflexhome-squashfs-sysupgrade.tar;3;0;3;3.37 MB;1.12 MB
/releases/19.07.0/targets/x86/geode/openwrt-19.07.0-x86-geode-rootfs-squashfs.img.gz;3;0;3;7.71 MB;2.57 MB
/releases/18.06.1/targets/at91/sama5d2/openwrt-18.06.1-at91-sama5d2-at91-sama5d2_ptc_ek-ext4-zImage.gz;3;0;3;3.37 MB;1.12 MB
/releases/17.01.3/targets/ipq806x/generic/lede-17.01.3-ipq806x-D7800-squashfs-sysupgrade.tar;3;0;3;4.98 MB;1.66 MB
/releases/17.01.0-rc1/targets/ipq806x/generic/lede-17.01.0-rc1-r3042-ec095b5-ipq806x-NBG6817-squashfs-sysupgrade.tar;3;0;3;5.70 MB;1.90 MB
/releases/17.01.3/targets/x86/64/lede-17.01.3-x86-64-generic-rootfs.tar.gz;3;0;3;2.92 MB;995.35 KB
/releases/18.06.0/targets/omap/generic/openwrt-18.06.0-omap-omap3-beagle-ext4-sdcard.img.gz;3;0;3;6.21 MB;2.07 MB
/releases/17.01.2/targets/oxnas/generic/lede-17.01.2-oxnas-stg212-squashfs-sysupgrade.tar;3;0;3;735.24 KB;245.08 KB
/releases/17.01.4/targets/oxnas/generic/lede-17.01.4-oxnas-pogoplug-pro-ubifs-sysupgrade.tar;3;0;3;287.24 KB;95.75 KB
/releases/19.07.1/targets/oxnas/ox820/openwrt-19.07.1-oxnas-ox820-cloudengines_pogoplugpro-ubifs-sysupgrade.tar;3;0;3;18.46 MB;6.15 MB
/releases/19.07.2/targets/sunxi/cortexa53/openwrt-19.07.2-sunxi-cortexa53-sun50i-h5-nanopi-neo-plus2-squashfs-sdcard.img.gz;3;0;3;17.98 MB;5.99 MB
/releases/17.01.7/targets/ar71xx/nand/lede-17.01.7-ar71xx-nand-wndr4300-squashfs-sysupgrade.tar;3;0;3;9.29 MB;3.10 MB
/releases/18.06.0/targets/imx6/generic/openwrt-18.06.0-imx6-ventana-squashfs-bootfs.tar.gz;3;0;3;2.59 MB;884.65 KB
/releases/18.06.2/targets/x86/generic/openwrt-18.06.2-x86-generic-rootfs-ext4.img.gz;3;0;3;3.33 MB;1.11 MB
/releases/17.01.2/targets/apm821xx/nand/lede-17.01.2-apm821xx-nand-mr24-squashfs-sysupgrade.tar;3;0;3;3.89 MB;1.30 MB
/releases/19.07.3/targets/zynq/generic/openwrt-19.07.3-zynq-digilent_zynq-zybo-z7-squashfs-sdcard.img.gz;3;0;3;6.17 MB;2.06 MB
/releases/19.07.0/targets/at91/sam9x/openwrt-19.07.0-at91-sam9x-at91sam9g20ek-ext4-root.ubi.gz;3;0;3;5.09 MB;1.70 MB
/releases/18.06.1/targets/at91/legacy/openwrt-18.06.1-at91-legacy-tny_a9260-ext4-factory.bin.gz;3;0;3;8.02 MB;2.67 MB
/releases/19.07.3/targets/sunxi/cortexa7/openwrt-19.07.3-sunxi-cortexa7-sun8i-h3-bananapi-m2-plus-ext4-sdcard.img.gz;3;0;3;7.28 MB;2.43 MB
/releases/18.06.3/targets/sunxi/cortexa8/openwrt-18.06.3-sunxi-cortexa8-sun4i-a10-cubieboard-ext4-sdcard.img.gz;3;0;3;10.66 MB;3.55 MB
/releases/18.06.0/targets/ramips/mt7621/openwrt-18.06.0-ramips-mt7621-r6220-squashfs-sysupgrade.tar;3;0;3;4.35 MB;1.45 MB
/releases/17.01.5/targets/kirkwood/generic/lede-17.01.5-kirkwood-goflexhome-squashfs-sysupgrade.tar;3;0;3;6.67 MB;2.22 MB
/releases/17.01.3/targets/ath25/generic/lede-17.01.3-ath25-generic-kernel.gz;3;0;3;1.81 MB;618.58 KB
/releases/17.01.3/targets/ipq806x/generic/lede-17.01.3-ipq806x-R7500v2-squashfs-sysupgrade.tar;3;0;3;4.98 MB;1.66 MB
/releases/18.06.1/targets/sunxi/cortexa7/openwrt-18.06.1-sunxi-cortexa7-sun8i-h3-orangepi-2-squashfs-sdcard.img.gz;3;0;3;4.89 MB;1.63 MB
/releases/19.07.3/targets/brcm2708/bcm2709/openwrt-19.07.3-brcm2708-bcm2709-rpi-2-squashfs-sysupgrade.img.gz;3;0;3;11.13 MB;3.71 MB
/releases/19.07.2/targets/omap/generic/openwrt-19.07.2-omap-ti_am335x-bone-black-ext4-sdcard.img.gz;3;0;3;8.04 MB;2.68 MB
/releases/17.01.4/targets/armvirt/generic/lede-17.01.4-armvirt-root.ext4.gz;3;0;3;2.30 MB;784.58 KB
/releases/18.06.6/targets/at91/legacy/openwrt-18.06.6-at91-legacy-ethernut5-ext4-root.ubi.gz;3;0;3;2.70 MB;921.39 KB
/releases/19.07.0/targets/omap/generic/openwrt-19.07.0-omap-ti_omap4-panda-ext4-sdcard.img.gz;3;0;3;13.24 MB;4.41 MB
/releases/18.06.5/targets/omap/generic/openwrt-18.06.5-omap-am335x-evm-ubifs-sdcard.img.gz;3;0;3;6.34 MB;2.11 MB
/releases/19.07.0/targets/oxnas/ox820/openwrt-19.07.0-oxnas-ox820-cloudengines_pogoplug-series-3-ubifs-sysupgrade.tar;3;0;3;16.23 MB;5.41 MB
/releases/19.07.3/targets/sunxi/cortexa8/openwrt-19.07.3-sunxi-cortexa8-sun4i-a10-olinuxino-lime-squashfs-sdcard.img.gz;3;0;3;5.02 MB;1.67 MB
/releases/18.06.1/targets/omap/generic/openwrt-18.06.1-omap-am335x-evm-ext4-sdcard.img.gz;3;0;3;7.67 MB;2.56 MB
/releases/17.01.3/targets/x86/geode/lede-17.01.3-x86-geode-rootfs-ext4.img.gz;3;0;3;4.80 MB;1.60 MB
/releases/18.06.1/targets/mxs/generic/openwrt-18.06.1-mxs-duckbill-sdcard.img.gz;3;0;3;4.20 MB;1.40 MB
/releases/18.06.4/targets/at91/sama5d3/openwrt-18.06.4-at91-sama5d3-at91-sama5d3_xplained-ext4-sdcard.img.gz;3;0;3;11.43 MB;3.81 MB
/releases/17.01.4/targets/kirkwood/generic/lede-17.01.4-kirkwood-iconnect-squashfs-sysupgrade.tar;3;0;3;3.01 MB;1.00 MB
/releases/17.01.0-rc1/targets/archs38/generic/lede-17.01.0-rc1-r3042-ec095b5-archs38-generic-root.ext4.gz;3;0;3;2.85 MB;974.46 KB
/releases/19.07.3/targets/sunxi/cortexa53/openwrt-19.07.3-sunxi-cortexa53-sun50i-h5-nanopi-neo2-squashfs-sdcard.img.gz;3;0;3;6.25 MB;2.08 MB
/releases/17.01.0/targets/oxnas/generic/lede-17.01.0-r3205-59508e3-oxnas-pogoplug-pro-squashfs-sysupgrade.tar;3;0;3;3.39 MB;1.13 MB
/releases/18.06.5/targets/at91/sama5d2/openwrt-18.06.5-at91-sama5d2-rootfs.tar.gz;3;0;3;2.33 MB;793.88 KB
/releases/18.06.0-rc2/targets/ramips/mt7621/openwrt-18.06.0-rc2-ramips-mt7621-r6220-squashfs-sysupgrade.tar;3;0;3;7.41 MB;2.47 MB
/releases/17.01.3/targets/x86/geode/lede-17.01.3-x86-geode-combined-ext4.img.gz;3;0;3;6.99 MB;2.33 MB
/releases/17.01.5/targets/oxnas/generic/lede-17.01.5-oxnas-akitio-squashfs-sysupgrade.tar;3;0;3;7.18 MB;2.39 MB
/releases/18.06.1/targets/sunxi/cortexa7/openwrt-18.06.1-sunxi-cortexa7-sun8i-h3-orangepi-pc-ext4-sdcard.img.gz;3;0;3;10.66 MB;3.55 MB
/releases/18.06.5/targets/sunxi/cortexa7/openwrt-18.06.5-sunxi-cortexa7-sun7i-a20-cubietruck-squashfs-sdcard.img.gz;3;0;3;5.36 MB;1.79 MB
/releases/17.01.1/targets/armvirt/generic/lede-17.01.1-armvirt-default-rootfs.tar.gz;3;0;3;3.57 MB;1.19 MB
/releases/18.06.0/targets/ramips/mt7621/openwrt-18.06.0-ramips-mt7621-mir3g-squashfs-sysupgrade.tar;3;0;3;8.44 MB;2.81 MB
/releases/18.06.1/targets/sunxi/cortexa8/openwrt-18.06.1-sunxi-cortexa8-sun4i-a10-pcduino-ext4-sdcard.img.gz;3;0;3;5.99 MB;2.00 MB
/releases/19.07.3/targets/sunxi/cortexa8/openwrt-19.07.3-sunxi-cortexa8-sun4i-a10-marsboard-squashfs-sdcard.img.gz;3;0;3;5.05 MB;1.68 MB
/releases/19.07.2/targets/sunxi/cortexa7/openwrt-19.07.2-sunxi-cortexa7-sun7i-a20-cubieboard2-squashfs-sdcard.img.gz;3;0;3;14.38 MB;4.79 MB
/releases/19.07.0/targets/at91/sama5/openwrt-19.07.0-at91-sama5-at91-sama5d3_xplained-ext4-root.ubi.gz;3;0;3;5.16 MB;1.72 MB
/releases/18.06.4/targets/mvebu/cortexa72/openwrt-18.06.4-mvebu-cortexa72-armada-macchiatobin-ext4-sdcard.img.gz;3;0;3;12.48 MB;4.16 MB
/releases/19.07.1/targets/ath25/generic/openwrt-19.07.1-ath25-generic-kernel.gz;3;0;3;3.84 MB;1.28 MB
/releases/19.07.0/targets/sunxi/cortexa7/openwrt-19.07.0-sunxi-cortexa7-sun8i-h2-plus-orangepi-r1-ext4-sdcard.img.gz;3;0;3;16.86 MB;5.62 MB
/releases/17.01.2/targets/at91/sama5d3/lede-17.01.2-at91-sama5d3-at91sama5d3xplained-rootfs.tar.gz;3;0;3;2.22 MB;756.09 KB
/releases/19.07.3/targets/armvirt/32/openwrt-19.07.3-armvirt-32-rootfs.cpio.gz;3;0;3;60 Bytes;20 Bytes
/releases/19.07.3/targets/sunxi/cortexa7/openwrt-19.07.3-sunxi-cortexa7-sun7i-a20-olinuxino-lime2-emmc-squashfs-sdcard.img.gz;3;0;3;5.08 MB;1.69 MB
/releases/18.06.0/targets/brcm2708/bcm2708/openwrt-18.06.0-brcm2708-bcm2708-rpi-ext4-sysupgrade.img.gz;3;1;4;26.06 MB;6.51 MB
/releases/17.01.1/targets/arc770/generic/lede-17.01.1-arc770-generic-root.ext4.gz;3;0;3;2.83 MB;965.27 KB
/releases/18.06.2/targets/imx6/generic/openwrt-18.06.2-imx6-rootfs.tar.gz;3;0;3;2.23 MB;762.61 KB
/releases/18.06.9/targets/ar71xx/nand/openwrt-18.06.9-ar71xx-nand-wndr4300-squashfs-sysupgrade.tar;3;14;17;21.89 MB;1.29 MB
/releases/18.06.2/targets/sunxi/cortexa7/openwrt-18.06.2-sunxi-cortexa7-sun8i-h3-nanopi-neo-ext4-sdcard.img.gz;3;0;3;10.63 MB;3.54 MB
/releases/19.07.0/targets/omap/generic/openwrt-19.07.0-omap-rootfs.tar.gz;3;0;3;5.42 MB;1.81 MB
/releases/18.06.1/targets/sunxi/cortexa53/openwrt-18.06.1-sunxi-cortexa53-sun50i-h5-orangepi-zero-plus-ext4-sdcard.img.gz;3;0;3;8.73 MB;2.91 MB
/releases/17.01.2/targets/x86/generic/lede-17.01.2-x86-generic-rootfs-ext4.img.gz;3;0;3;2.72 MB;927.75 KB
/releases/18.06.3/targets/ath25/generic/openwrt-18.06.3-ath25-generic-kernel.gz;3;0;3;4.27 MB;1.42 MB
/releases/18.06.0-rc1/targets/ramips/mt7621/openwrt-18.06.0-rc1-ramips-mt7621-mir3g-squashfs-sysupgrade.tar;3;0;3;7.26 MB;2.42 MB
/releases/19.07.0/targets/sunxi/cortexa7/openwrt-19.07.0-sunxi-cortexa7-sun7i-a20-pcduino3-ext4-sdcard.img.gz;3;0;3;18.34 MB;6.11 MB
/releases/17.01.0-rc2/targets/ar71xx/nand/lede-17.01.0-rc2-r3131-42f3c1f-ar71xx-nand-wndr4300-squashfs-sysupgrade.tar;3;0;3;4.53 MB;1.51 MB
/releases/18.06.1/targets/at91/sama5d2/openwrt-18.06.1-at91-sama5d2-at91-sama5d2_ptc_ek-ext4-sdcard.img.gz;3;0;3;5.83 MB;1.94 MB
/releases/17.01.3/targets/sunxi/generic/lede-17.01.3-sunxi-sun7i-a20-cubietruck-squashfs-sdcard.img.gz;3;0;3;4.77 MB;1.59 MB
/releases/19.07.0/targets/sunxi/cortexa7/openwrt-19.07.0-sunxi-cortexa7-sun7i-a20-bananapro-squashfs-sdcard.img.gz;3;0;3;16.22 MB;5.41 MB
/releases/19.07.2/targets/x86/generic/openwrt-19.07.2-x86-generic-rootfs-ext4.img.gz;3;0;3;4.30 MB;1.43 MB
/releases/19.07.0/targets/x86/legacy/openwrt-19.07.0-x86-legacy-combined-ext4.img.gz;3;0;3;14.05 MB;4.68 MB
/releases/19.07.3/targets/sunxi/cortexa7/openwrt-19.07.3-sunxi-cortexa7-sun7i-a20-pcduino3-squashfs-sdcard.img.gz;3;0;3;5.52 MB;1.84 MB
/releases/19.07.0/targets/omap/generic/openwrt-19.07.0-omap-ti_am335x-evm-ext4-sdcard.img.gz;3;0;3;13.47 MB;4.49 MB
/releases/17.01.7/targets/sunxi/generic/lede-17.01.7-sunxi-sun4i-a10-pcduino-ext4-sdcard.img.gz;3;0;3;10.58 MB;3.53 MB
/releases/17.01.0-rc1/targets/ipq806x/generic/lede-17.01.0-rc1-r3042-ec095b5-ipq806x-EA8500-squashfs-sysupgrade.tar;3;0;3;6.23 MB;2.08 MB
/releases/19.07.0/targets/sunxi/cortexa8/openwrt-19.07.0-sunxi-cortexa8-sun4i-a10-marsboard-squashfs-sdcard.img.gz;3;0;3;14.13 MB;4.71 MB
/releases/18.06.6/targets/mvebu/cortexa72/openwrt-18.06.6-mvebu-cortexa72-armada-macchiatobin-squashfs-sdcard.img.gz;3;0;3;5.69 MB;1.90 MB
/releases/18.06.1/targets/sunxi/cortexa7/openwrt-18.06.1-sunxi-cortexa7-sun7i-a20-cubietruck-squashfs-sdcard.img.gz;3;0;3;7.47 MB;2.49 MB
/releases/19.07.0-rc2/targets/brcm2708/bcm2708/openwrt-19.07.0-rc2-brcm2708-bcm2708-rpi-squashfs-sysupgrade.img.gz;3;0;3;10.72 MB;3.57 MB
/releases/17.01.4/targets/sunxi/generic/lede-17.01.4-sunxi-sun4i-a10-pcduino-ext4-sdcard.img.gz;3;0;3;3.48 MB;1.16 MB
/releases/19.07.3/targets/brcm2708/bcm2708/openwrt-19.07.3-brcm2708-bcm2708-rpi-squashfs-sysupgrade.img.gz;3;0;3;1.90 MB;650.21 KB
/releases/19.07.2/targets/at91/sam9x/openwrt-19.07.2-at91-sam9x-tny_a9263-ext4-factory.bin.gz;3;0;3;6.11 MB;2.04 MB
/releases/17.01.0-rc2/targets/apm821xx/nand/lede-17.01.0-rc2-r3131-42f3c1f-apm821xx-nand-WNDR4700-squashfs-sysupgrade.tar;3;0;3;4.71 MB;1.57 MB
/releases/17.01.0-rc2/targets/arc770/generic/lede-17.01.0-rc2-r3131-42f3c1f-arc770-generic-Default-sdcard-vfat-ext4.img.gz;3;0;3;5.58 MB;1.86 MB
/releases/17.01.3/targets/kirkwood/generic/lede-17.01.3-kirkwood-linksys-audi-squashfs-sysupgrade.tar;3;0;3;4.04 MB;1.35 MB
/releases/17.01.3/targets/at91/legacy/lede-17.01.3-at91-legacy-default-rootfs.tar.gz;3;0;3;2.29 MB;782.49 KB
/releases/18.06.2/targets/sunxi/cortexa7/openwrt-18.06.2-sunxi-cortexa7-sun8i-h3-nanopi-m1-plus-squashfs-sdcard.img.gz;3;0;3;11.06 MB;3.69 MB
/releases/17.01.2/targets/sunxi/generic/lede-17.01.2-sunxi-sun6i-a31-m9-squashfs-sdcard.img.gz;3;0;3;511.24 KB;170.41 KB
/releases/18.06.1/targets/omap/generic/openwrt-18.06.1-omap-omap3-beagle-ubifs-sdcard.img.gz;3;0;3;8.31 MB;2.77 MB
/releases/18.06.6/targets/at91/legacy/openwrt-18.06.6-at91-legacy-tny_a9260-ext4-factory.bin.gz;3;0;3;5.76 MB;1.92 MB
/releases/19.07.2/targets/sunxi/cortexa7/openwrt-19.07.2-sunxi-cortexa7-sun8i-h3-orangepi-2-squashfs-sdcard.img.gz;3;0;3;9.82 MB;3.27 MB
/releases/17.01.4/targets/sunxi/generic/lede-17.01.4-sunxi-sun7i-a20-pcduino3-squashfs-sdcard.img.gz;3;0;3;3.00 MB;1023.75 KB
/releases/18.06.4/targets/at91/legacy/openwrt-18.06.4-at91-legacy-at91sam9g15ek-ext4-root.ubi.gz;3;0;3;2.75 MB;937.01 KB
/releases/18.06.3/targets/sunxi/cortexa7/openwrt-18.06.3-sunxi-cortexa7-sun7i-a20-lamobo-r1-ext4-sdcard.img.gz;3;0;3;6.52 MB;2.17 MB
/releases/18.06.2/targets/at91/sama5d3/openwrt-18.06.2-at91-sama5d3-at91-sama5d3_xplained-ext4-root.ubi.gz;3;0;3;2.76 MB;941.98 KB
/releases/19.07.3/targets/oxnas/ox820/openwrt-19.07.3-oxnas-ox820-cloudengines_pogoplug-series-3-ubifs-sysupgrade.tar;3;0;3;16.28 MB;5.43 MB
/releases/17.01.2/targets/ar71xx/nand/lede-17.01.2-ar71xx-nand-c-60-squashfs-sysupgrade.tar;3;0;3;3.73 MB;1.24 MB
/releases/18.06.1/targets/sunxi/cortexa7/openwrt-18.06.1-sunxi-cortexa7-sun7i-a20-cubietruck-ext4-sdcard.img.gz;3;0;3;6.45 MB;2.15 MB
/releases/18.06.5/targets/at91/legacy/openwrt-18.06.5-at91-legacy-at91sam9x35ek-ext4-root.ubi.gz;3;0;3;2.65 MB;905.06 KB
/releases/18.06.2/targets/x86/generic/openwrt-18.06.2-x86-generic-rootfs-squashfs.img.gz;3;0;3;2.69 MB;918.84 KB
/releases/17.01.2/targets/sunxi/generic/lede-17.01.2-sunxi-sun7i-a20-pcduino3-ext4-sdcard.img.gz;3;0;3;383.24 KB;127.75 KB
/releases/17.01.3/targets/archs38/generic/lede-17.01.3-archs38-generic-Default-sdcard-vfat-ext4.img.gz;3;0;3;5.66 MB;1.89 MB
/releases/17.01.0-rc2/targets/apm821xx/sata/lede-17.01.0-rc2-r3131-42f3c1f-apm821xx-sata-MyBookLiveSingle-ext4-rootfs.img.gz;3;0;3;4.90 MB;1.63 MB
/releases/17.01.3/targets/sunxi/generic/lede-17.01.3-sunxi-sun4i-a10-cubieboard-squashfs-sdcard.img.gz;3;0;3;4.17 MB;1.39 MB
/releases/19.07.2/targets/sunxi/cortexa7/openwrt-19.07.2-sunxi-cortexa7-sun7i-a20-olinuxino-lime2-ext4-sdcard.img.gz;3;0;3;11.67 MB;3.89 MB
/releases/18.06.2/targets/sunxi/cortexa8/openwrt-18.06.2-sunxi-cortexa8-sun4i-a10-pcduino-ext4-sdcard.img.gz;3;0;3;6.06 MB;2.02 MB
/snapshots/faillogs/powerpc_464fp/packages/frr/host-compile.txt;3;0;3;31.80 KB;10.60 KB
/releases/18.06.0/targets/x86/generic/openwrt-18.06.0-x86-generic-rootfs-ext4.img.gz;3;0;3;3.22 MB;1.07 MB
/releases/17.01.0/targets/armvirt/generic/lede-17.01.0-r3205-59508e3-armvirt-rootfs.cpio.gz;3;0;3;1.85 MB;632.33 KB
/releases/18.06.9/targets/ramips/mt7621/openwrt-18.06.9-ramips-mt7621-ubnt-erx-squashfs-sysupgrade.tar;3;4;7;9.57 MB;1.37 MB
/releases/faillogs-19.07/arm_xscale/packages/node/host-compile.txt;3;0;3;10.66 MB;3.55 MB
/releases/19.07.3/targets/at91/sam9x/openwrt-19.07.3-at91-sam9x-at91sam9g20ek-ext4-zImage.gz;3;0;3;3.57 MB;1.19 MB
/releases/17.01.6/targets/ar71xx/generic/lede-17.01.6-ar71xx-generic-vmlinux.lzma;3;0;3;607.24 KB;202.41 KB
/releases/19.07.0/targets/sunxi/cortexa7/openwrt-19.07.0-sunxi-cortexa7-sun7i-a20-olinuxino-micro-squashfs-sdcard.img.gz;3;0;3;14.37 MB;4.79 MB
/releases/18.06.2/targets/at91/legacy/openwrt-18.06.2-at91-legacy-at91sam9263ek-ext4-root.ubi.gz;3;0;3;2.60 MB;888.86 KB
/releases/19.07.1/targets/omap/generic/openwrt-19.07.1-omap-ti_omap4-panda-squashfs-sdcard.img.gz;3;0;3;5.99 MB;2.00 MB
/releases/19.07.1/targets/oxnas/ox820/openwrt-19.07.1-oxnas-ox820-cloudengines_pogoplug-series-3-ubifs-sysupgrade.tar;3;0;3;13.08 MB;4.36 MB
/releases/19.07.0/targets/mxs/generic/openwrt-19.07.0-mxs-root.ext4.gz;3;0;3;10.89 MB;3.63 MB
/releases/18.06.1/targets/sunxi/cortexa53/openwrt-18.06.1-sunxi-cortexa53-sun50i-a64-sopine-baseboard-squashfs-sdcard.img.gz;3;0;3;7.99 MB;2.66 MB
/snapshots/faillogs/arm_cortex-a8_vfpv3/packages/frr/host-compile.txt;3;0;3;31.80 KB;10.60 KB
/releases/19.07.3/targets/brcm2708/bcm2710/openwrt-19.07.3-brcm2708-bcm2710-rpi-3-squashfs-sysupgrade.img.gz;3;2;5;2.04 MB;418.28 KB
/releases/17.01.5/targets/ar71xx/nand/lede-17.01.5-ar71xx-nand-nbg6716-squashfs-sysupgrade.tar;3;0;3;7.71 MB;2.57 MB
/releases/18.06.1/targets/at91/legacy/openwrt-18.06.1-at91-legacy-at91sam9g15ek-ext4-root.ubi.gz;3;0;3;4.85 MB;1.62 MB
/releases/17.01.3/targets/sunxi/generic/lede-17.01.3-sunxi-sun5i-a13-olimex-som-squashfs-sdcard.img.gz;3;0;3;4.49 MB;1.50 MB
/releases/18.06.2/targets/sunxi/cortexa7/openwrt-18.06.2-sunxi-cortexa7-sun6i-a31-m9-ext4-sdcard.img.gz;3;0;3;11.67 MB;3.89 MB
/releases/18.06.1/targets/sunxi/cortexa7/openwrt-18.06.1-sunxi-cortexa7-sun7i-a20-bananapro-ext4-sdcard.img.gz;3;0;3;6.50 MB;2.17 MB
/releases/18.06.7/targets/x86/legacy/openwrt-18.06.7-x86-legacy-rootfs-squashfs.img.gz;3;0;3;1.58 MB;538.21 KB
/snapshots/faillogs/arm_cortex-a15_neon-vfpv4/packages/frr/host-compile.txt;3;0;3;32.59 KB;10.86 KB
/releases/18.06.1/targets/sunxi/cortexa8/openwrt-18.06.1-sunxi-cortexa8-sun4i-a10-cubieboard-ext4-sdcard.img.gz;3;0;3;7.75 MB;2.58 MB
/releases/19.07.0/targets/sunxi/cortexa7/openwrt-19.07.0-sunxi-cortexa7-sun8i-h3-orangepi-2-squashfs-sdcard.img.gz;3;0;3;14.27 MB;4.76 MB
/releases/19.07.2/targets/sunxi/cortexa53/openwrt-19.07.2-sunxi-cortexa53-sun50i-h5-nanopi-neo2-ext4-sdcard.img.gz;3;0;3;13.67 MB;4.56 MB
/snapshots/faillogs/arm_cortex-a9/packages/node/host-compile.txt;3;0;3;8.06 MB;2.69 MB
/snapshots/faillogs/aarch64_cortex-a72/packages/frr/host-compile.txt;3;0;3;31.80 KB;10.60 KB
/releases/19.07.1/targets/at91/sam9x/openwrt-19.07.1-at91-sam9x-at91sam9x35ek-ext4-root.ubi.gz;3;0;3;3.03 MB;1.01 MB
/releases/18.06.4/targets/at91/legacy/openwrt-18.06.4-at91-legacy-at91sam9g25ek-ext4-root.ubi.gz;3;0;3;2.75 MB;937.02 KB
/releases/17.01.0-rc1/targets/arc770/generic/lede-17.01.0-rc1-r3042-ec095b5-arc770-generic-Default-sdcard-vfat-ext4.img.gz;3;0;3;5.72 MB;1.91 MB
/releases/19.07.2/targets/ath25/generic/openwrt-19.07.2-ath25-generic-kernel.gz;3;0;3;3.86 MB;1.29 MB
/releases/17.01.3/targets/x86/legacy/lede-17.01.3-x86-legacy-generic-rootfs.tar.gz;3;0;3;2.88 MB;981.99 KB
/releases/19.07.0/targets/sunxi/cortexa8/openwrt-19.07.0-sunxi-cortexa8-sun5i-a13-olimex-som-squashfs-sdcard.img.gz;3;0;3;15.21 MB;5.07 MB
/releases/19.07.3/targets/ar71xx/nand/openwrt-19.07.3-ar71xx-nand-rambutan-squashfs-sysupgrade.tar;3;0;3;8.31 MB;2.77 MB
/releases/19.07.0/targets/oxnas/ox820/openwrt-19.07.0-oxnas-ox820-shuttle_kd20-factory.tar.gz;3;0;3;14.71 MB;4.90 MB
/releases/17.01.1/targets/brcm2708/bcm2709/lede-17.01.1-brcm2708-bcm2709-rpi-2-ext4-sdcard.img.gz;3;0;3;7.00 MB;2.33 MB
/releases/18.06.2/targets/sunxi/cortexa7/openwrt-18.06.2-sunxi-cortexa7-sun8i-h3-orangepi-plus-squashfs-sdcard.img.gz;3;0;3;4.66 MB;1.55 MB
/releases/18.06.1/targets/mvebu/cortexa9/openwrt-18.06.1-mvebu-cortexa9-armada-388-clearfog-base-squashfs-sdcard.img.gz;3;0;3;4.72 MB;1.57 MB
/releases/18.06.4/targets/oxnas/ox820/openwrt-18.06.4-oxnas-ox820-cloudengines-pogoplug-pro-squashfs-sysupgrade.tar;3;0;3;7.41 MB;2.47 MB
/releases/17.01.1/targets/mxs/generic/lede-17.01.1-mxs-duckbill-sdcard.img.gz;3;0;3;10.01 MB;3.34 MB
/releases/19.07.0/targets/sunxi/cortexa7/openwrt-19.07.0-sunxi-cortexa7-sun7i-a20-lamobo-r1-squashfs-sdcard.img.gz;3;0;3;16.26 MB;5.42 MB
/releases/17.01.2/targets/oxnas/generic/lede-17.01.2-oxnas-pogoplug-pro-ubifs-sysupgrade.tar;3;0;3;511.24 KB;170.41 KB
/releases/19.07.0/targets/at91/sam9x/openwrt-19.07.0-at91-sam9x-usb_a9g20-ext4-factory.bin.gz;3;0;3;11.95 MB;3.98 MB
/releases/19.07.0/targets/sunxi/cortexa53/openwrt-19.07.0-sunxi-cortexa53-sun50i-h5-nanopi-neo2-squashfs-sdcard.img.gz;3;0;3;17.96 MB;5.99 MB
/releases/18.06.0/targets/at91/sama5d3/openwrt-18.06.0-at91-sama5d3-rootfs.tar.gz;3;0;3;4.06 MB;1.35 MB
/releases/19.07.0/targets/sunxi/cortexa7/openwrt-19.07.0-sunxi-cortexa7-sun6i-a31-m9-squashfs-sdcard.img.gz;3;0;3;15.46 MB;5.15 MB
/releases/19.07.3/targets/tegra/generic/openwrt-19.07.3-tegra-compulab_trimslice-ext4-sdcard.img.gz;3;0;3;15.57 MB;5.19 MB
/releases/18.06.7/targets/at91/sama5d4/openwrt-18.06.7-at91-sama5d4-at91-sama5d4_xplained-ext4-zImage.gz;3;0;3;4.50 MB;1.50 MB
/releases/18.06.2/targets/at91/sama5d2/openwrt-18.06.2-at91-sama5d2-at91-sama5d27_som1_ek-ext4-zImage.gz;3;0;3;6.27 MB;2.09 MB
/releases/faillogs-18.06/arc_arc700/packages/perl/host-compile.txt;3;0;3;1.12 MB;383.71 KB
/releases/19.07.1/targets/at91/sam9x/openwrt-19.07.1-at91-sam9x-at91sam9x25ek-ext4-root.ubi.gz;3;0;3;5.10 MB;1.70 MB
/releases/17.01.0-rc1/targets/apm821xx/nand/lede-17.01.0-rc1-r3042-ec095b5-apm821xx-nand-WNDR4700-squashfs-sysupgrade.tar;3;0;3;7.54 MB;2.51 MB
/releases/17.01.4/targets/x86/geode/lede-17.01.4-x86-geode-rootfs-ext4.img.gz;3;0;3;4.80 MB;1.60 MB
/releases/17.01.2/targets/ar71xx/nand/lede-17.01.2-ar71xx-nand-wndr4300-squashfs-sysupgrade.tar;3;0;3;4.60 MB;1.53 MB
/releases/18.06.2/targets/omap/generic/openwrt-18.06.2-omap-am335x-evm-ext4-sdcard.img.gz;3;0;3;7.27 MB;2.42 MB
/releases/19.07.0/targets/sunxi/cortexa8/openwrt-19.07.0-sunxi-cortexa8-sun4i-a10-olinuxino-lime-ext4-sdcard.img.gz;3;0;3;16.70 MB;5.57 MB
/releases/18.06.5/targets/at91/legacy/openwrt-18.06.5-at91-legacy-at91sam9g20ek-ext4-root.ubi.gz;3;0;3;2.81 MB;958.26 KB
/releases/19.07.0/targets/sunxi/cortexa7/openwrt-19.07.0-sunxi-cortexa7-sun8i-h3-orangepi-pc-plus-squashfs-sdcard.img.gz;3;0;3;14.28 MB;4.76 MB
/releases/18.06.2/targets/sunxi/cortexa7/openwrt-18.06.2-sunxi-cortexa7-sun8i-h3-orangepi-2-squashfs-sdcard.img.gz;3;0;3;9.05 MB;3.02 MB
/releases/19.07.3/targets/at91/sam9x/openwrt-19.07.3-at91-sam9x-at91sam9263ek-ext4-zImage.gz;3;0;3;3.77 MB;1.26 MB
/releases/19.07.3/targets/layerscape/armv8_64b/openwrt-19.07.3-layerscape-armv8_64b-ls1012afrwy-ext4-sdcard.img.gz;3;0;3;8.30 MB;2.77 MB
/releases/19.07.3/targets/at91/sama5/openwrt-19.07.3-at91-sama5-at91-sama5d2_xplained-ext4-zImage.gz;3;0;3;3.66 MB;1.22 MB
/releases/19.07.0/targets/sunxi/cortexa8/openwrt-19.07.0-sunxi-cortexa8-sun4i-a10-pcduino-ext4-sdcard.img.gz;3;0;3;18.18 MB;6.06 MB
/releases/18.06.0-rc1/targets/sunxi/cortexa7/openwrt-18.06.0-rc1-sunxi-cortexa7-sun7i-a20-cubietruck-ext4-sdcard.img.gz;3;0;3;9.01 MB;3.00 MB
/releases/19.07.3/targets/sunxi/cortexa53/openwrt-19.07.3-sunxi-cortexa53-sun50i-h5-orangepi-zero-plus-ext4-sdcard.img.gz;3;0;3;7.13 MB;2.38 MB
/releases/17.01.0/targets/apm821xx/sata/lede-17.01.0-r3205-59508e3-apm821xx-sata-MyBookLiveSingle-ext4-rootfs.img.gz;3;0;3;5.04 MB;1.68 MB
/releases/17.01.2/targets/oxnas/generic/lede-17.01.2-oxnas-pogoplug-pro-squashfs-sysupgrade.tar;3;0;3;671.24 KB;223.75 KB
/releases/17.01.5/targets/ar71xx/nand/lede-17.01.5-ar71xx-nand-mr18-squashfs-sysupgrade.tar;3;0;3;9.95 MB;3.32 MB
/releases/19.07.1/targets/sunxi/cortexa7/openwrt-19.07.1-sunxi-cortexa7-sun8i-h2-plus-orangepi-zero-ext4-sdcard.img.gz;3;0;3;6.01 MB;2.00 MB
/releases/19.07.0/targets/at91/sama5/openwrt-19.07.0-at91-sama5-at91-sama5d2_ptc_ek-ext4-sdcard.img.gz;3;0;3;12.05 MB;4.02 MB
/releases/19.07.3/targets/sunxi/cortexa7/openwrt-19.07.3-sunxi-cortexa7-sun7i-a20-olinuxino-lime-ext4-sdcard.img.gz;3;0;3;5.80 MB;1.93 MB
/releases/19.07.0/targets/ath25/generic/openwrt-19.07.0-ath25-generic-kernel.gz;3;0;3;3.77 MB;1.26 MB
/releases/17.01.0-rc2/targets/ar71xx/nand/lede-17.01.0-rc2-r3131-42f3c1f-ar71xx-nand-c-60-squashfs-sysupgrade.tar;3;0;3;3.70 MB;1.23 MB
/releases/19.07.3/targets/at91/sama5/openwrt-19.07.3-at91-sama5-at91-sama5d27_som1_ek-ext4-sdcard.img.gz;3;0;3;6.24 MB;2.08 MB
/releases/19.07.0/targets/x86/geode/openwrt-19.07.0-x86-geode-rootfs-ext4.img.gz;3;0;3;9.69 MB;3.23 MB
/releases/17.01.0/targets/oxnas/generic/lede-17.01.0-r3205-59508e3-oxnas-stg212-squashfs-sysupgrade.tar;3;0;3;3.31 MB;1.10 MB
/releases/18.06.1/targets/sunxi/cortexa53/openwrt-18.06.1-sunxi-cortexa53-sun50i-h5-nanopi-neo-plus2-squashfs-sdcard.img.gz;3;0;3;8.08 MB;2.69 MB
/releases/19.07.2/targets/sunxi/cortexa7/openwrt-19.07.2-sunxi-cortexa7-sun8i-h3-orangepi-pc-plus-ext4-sdcard.img.gz;3;0;3;16.84 MB;5.61 MB
/releases/17.01.5/targets/x86/legacy/lede-17.01.5-x86-legacy-combined-ext4.img.gz;3;0;3;12.70 MB;4.23 MB
/releases/18.06.6/targets/sunxi/cortexa7/openwrt-18.06.6-sunxi-cortexa7-sun6i-a31-m9-ext4-sdcard.img.gz;3;0;3;11.69 MB;3.90 MB
/releases/18.06.2/targets/x86/64/openwrt-18.06.2-x86-64-rootfs-ext4.img.gz;3;0;3;3.40 MB;1.13 MB
/releases/19.07.0/targets/sunxi/cortexa53/openwrt-19.07.0-sunxi-cortexa53-sun50i-h5-orangepi-pc2-squashfs-sdcard.img.gz;3;0;3;18.02 MB;6.01 MB
/releases/18.06.6/targets/mvebu/cortexa9/openwrt-18.06.6-mvebu-cortexa9-armada-388-clearfog-base-squashfs-sdcard.img.gz;3;0;3;4.95 MB;1.65 MB
/releases/18.06.5/targets/arc770/generic/openwrt-18.06.5-arc770-generic-Default-sdcard-vfat-ext4.img.gz;3;0;3;9.92 MB;3.31 MB
/releases/18.06.1/targets/oxnas/ox820/openwrt-18.06.1-oxnas-ox820-mitrastar-stg212-squashfs-sysupgrade.tar;3;0;3;7.79 MB;2.60 MB
/releases/19.07.0/targets/at91/sama5/openwrt-19.07.0-at91-sama5-at91-sama5d27_som1_ek-ext4-sdcard.img.gz;3;0;3;12.01 MB;4.00 MB
/releases/18.06.1/targets/sunxi/cortexa7/openwrt-18.06.1-sunxi-cortexa7-sun8i-h2-plus-orangepi-r1-squashfs-sdcard.img.gz;3;0;3;4.72 MB;1.57 MB
/releases/17.01.0-rc1/targets/apm821xx/nand/lede-17.01.0-rc1-r3042-ec095b5-apm821xx-nand-mx60w-squashfs-sysupgrade.tar;3;0;3;7.37 MB;2.46 MB
/releases/19.07.3/targets/sunxi/cortexa7/openwrt-19.07.3-sunxi-cortexa7-sun8i-h2-plus-orangepi-zero-squashfs-sdcard.img.gz;3;0;3;5.06 MB;1.69 MB
/releases/19.07.0-rc2/targets/sunxi/cortexa7/openwrt-19.07.0-rc2-sunxi-cortexa7-sun7i-a20-pcduino3-squashfs-sdcard.img.gz;3;0;3;10.55 MB;3.52 MB
/releases/18.06.3/targets/sunxi/cortexa8/openwrt-18.06.3-sunxi-cortexa8-sun4i-a10-marsboard-squashfs-sdcard.img.gz;3;0;3;8.98 MB;2.99 MB
/releases/19.07.0/targets/brcm63xx/generic/openwrt-19.07.0-brcm63xx-generic-livebox-vmlinux.gz;2;0;2;4.50 MB;2.25 MB
/releases/17.01.5/targets/x86/legacy/lede-17.01.5-x86-legacy-rootfs-ext4.img.gz;2;0;2;3.13 MB;1.57 MB
/releases/17.01.0-rc1/targets/ramips/mt7621/lede-17.01.0-rc1-r3042-ec095b5-ramips-mt7621-ubnt-erx-squashfs-sysupgrade.tar;2;0;2;3.05 MB;1.53 MB
/releases/17.01.2/targets/sunxi/generic/lede-17.01.2-sunxi-sun7i-a20-lamobo-r1-ext4-sdcard.img.gz;2;0;2;287.50 KB;143.75 KB
/releases/19.07.2/targets/at91/sam9x/openwrt-19.07.2-at91-sam9x-ethernut5-ext4-root.ubi.gz;2;0;2;2.62 MB;1.31 MB
/releases/17.01.4/targets/mxs/generic/lede-17.01.4-mxs-duckbill-sdcard.img.gz;2;0;2;495.50 KB;247.75 KB
/releases/18.06.1/targets/gemini/generic/openwrt-18.06.1-gemini-sysupgrade-ib4220b.tar.gz;2;0;2;10.38 MB;5.19 MB
/releases/18.06.3/targets/at91/legacy/openwrt-18.06.3-at91-legacy-at91sam9g20ek_2mmc-ext4-zImage.gz;2;0;2;3.24 MB;1.62 MB
/releases/18.06.5/targets/oxnas/ox820/openwrt-18.06.5-oxnas-ox820-mitrastar-stg212-ubifs-sysupgrade.tar;2;0;2;8.41 MB;4.20 MB
/releases/19.07.2/targets/at91/sam9x/openwrt-19.07.2-at91-sam9x-usb_a9g20-ext4-factory.bin.gz;2;0;2;6.00 MB;3.00 MB
/releases/17.01.0/targets/zynq/generic/lede-17.01.0-r3205-59508e3-zynq-rootfs.tar.gz;2;0;2;255.50 KB;127.75 KB
/releases/17.01.0-rc2/targets/kirkwood/generic/lede-17.01.0-rc2-r3131-42f3c1f-kirkwood-dockstar-squashfs-sysupgrade.tar;2;0;2;927.49 KB;463.75 KB
/releases/19.07.2/targets/oxnas/ox820/openwrt-19.07.2-oxnas-ox820-akitio_mycloud-squashfs-sysupgrade.tar;2;0;2;1.45 MB;743.54 KB
/releases/18.06.0/targets/oxnas/ox820/openwrt-18.06.0-oxnas-ox820-cloudengines-pogoplug-pro-squashfs-sysupgrade.tar;2;0;2;4.82 MB;2.41 MB
/releases/18.06.0-rc2/targets/at91/sama5d2/openwrt-18.06.0-rc2-at91-sama5d2-at91-sama5d27_som1_ek-ext4-zImage.gz;2;0;2;4.32 MB;2.16 MB
/releases/18.06.0/targets/sunxi/cortexa7/openwrt-18.06.0-sunxi-cortexa7-sun7i-a20-olinuxino-lime2-ext4-sdcard.img.gz;2;0;2;5.55 MB;2.77 MB
/releases/19.07.0/targets/gemini/generic/openwrt-19.07.0-gemini-itian_sq201-ext4-factory.bin.gz;2;0;2;17.44 MB;8.72 MB
/releases/19.07.0/targets/brcm2708/bcm2709/openwrt-19.07.0-brcm2708-bcm2709-rpi-2-squashfs-factory.img.gz;2;0;2;21.53 MB;10.77 MB
/releases/18.06.6/targets/sunxi/cortexa8/openwrt-18.06.6-sunxi-cortexa8-sun4i-a10-olinuxino-lime-squashfs-sdcard.img.gz;2;0;2;4.56 MB;2.28 MB
/releases/18.06.6/targets/sunxi/cortexa53/openwrt-18.06.6-sunxi-cortexa53-sun50i-a64-sopine-baseboard-ext4-sdcard.img.gz;2;0;2;6.55 MB;3.28 MB
/releases/18.06.4/targets/at91/sama5d2/openwrt-18.06.4-at91-sama5d2-at91-sama5d2_ptc_ek-ext4-root.ubi.gz;2;0;2;2.49 MB;1.25 MB
/releases/18.06.7/targets/at91/legacy/openwrt-18.06.7-at91-legacy-at91sam9g25ek-ext4-root.ubi.gz;2;0;2;2.51 MB;1.26 MB
/releases/18.06.3/targets/at91/sama5d2/openwrt-18.06.3-at91-sama5d2-at91-sama5d2_xplained-ext4-sdcard.img.gz;2;0;2;5.72 MB;2.86 MB
/releases/17.01.0/targets/sunxi/generic/lede-17.01.0-r3205-59508e3-sunxi-sun7i-a20-pcduino3-ext4-sdcard.img.gz;2;0;2;431.50 KB;215.75 KB
/releases/17.01.0-rc2/targets/sunxi/generic/lede-17.01.0-rc2-r3131-42f3c1f-sunxi-sun7i-a20-olinuxino-micro-ext4-sdcard.img.gz;2;0;2;4.93 MB;2.47 MB
/releases/18.06.2/targets/x86/geode/openwrt-18.06.2-x86-geode-rootfs-ext4.img.gz;2;0;2;4.67 MB;2.34 MB
/releases/19.07.2/targets/at91/sam9x/openwrt-19.07.2-at91-sam9x-at91sam9263ek-ext4-root.ubi.gz;2;0;2;2.64 MB;1.32 MB
/releases/19.07.0-rc2/targets/mvebu/cortexa53/openwrt-19.07.0-rc2-mvebu-cortexa53-globalscale_espressobin-squashfs-sdcard.img.gz;2;0;2;5.72 MB;2.86 MB
/snapshots/faillogs/mipsel_24kc/packages/node/host-compile.txt;2;0;2;4.01 MB;2.01 MB
/releases/17.01.7/targets/sunxi/generic/lede-17.01.7-sunxi-sun7i-a20-lamobo-r1-ext4-sdcard.img.gz;2;0;2;5.68 MB;2.84 MB
/releases/18.06.7/targets/at91/legacy/openwrt-18.06.7-at91-legacy-at91sam9m10g45ek-ext4-root.ubi.gz;2;0;2;2.50 MB;1.25 MB
/releases/18.06.7/targets/mvebu/cortexa53/openwrt-18.06.7-mvebu-cortexa53-globalscale-espressobin-squashfs-sdcard.img.gz;2;0;2;5.51 MB;2.75 MB
/releases/17.01.2/targets/archs38/generic/lede-17.01.2-archs38-generic-Default-sdcard-vfat-ext4.img.gz;2;0;2;5.39 MB;2.70 MB
/releases/17.01.3/targets/armvirt/generic/lede-17.01.3-armvirt-default-rootfs.tar.gz;2;0;2;1.80 MB;919.79 KB
/releases/18.06.3/targets/x86/generic/openwrt-18.06.3-x86-generic-combined-squashfs.img.gz;2;0;2;7.07 MB;3.53 MB
/releases/18.06.3/targets/armvirt/32/openwrt-18.06.3-armvirt-32-root.squashfs.gz;2;0;2;2.89 MB;1.44 MB
/releases/18.06.4/targets/oxnas/ox820/openwrt-18.06.4-oxnas-ox820-shuttle-kd20-ubifs-sysupgrade.tar;2;0;2;9.06 MB;4.53 MB
/releases/18.06.1/targets/sunxi/cortexa7/openwrt-18.06.1-sunxi-cortexa7-sun8i-h3-orangepi-plus-squashfs-sdcard.img.gz;2;0;2;4.58 MB;2.29 MB
/releases/19.07.0-rc2/targets/at91/sama5/openwrt-19.07.0-rc2-at91-sama5-at91-sama5d2_ptc_ek-ext4-sdcard.img.gz;2;0;2;6.14 MB;3.07 MB
/releases/18.06.7/targets/at91/sama5d4/openwrt-18.06.7-at91-sama5d4-at91-sama5d4_xplained-ext4-root.ubi.gz;2;0;2;1.42 MB;727.54 KB
/releases/18.06.1/targets/sunxi/cortexa7/openwrt-18.06.1-sunxi-cortexa7-sun7i-a20-olinuxino-micro-ext4-sdcard.img.gz;2;0;2;5.45 MB;2.72 MB
/releases/19.07.2/targets/omap/generic/openwrt-19.07.2-omap-rootfs.tar.gz;2;0;2;1.45 MB;743.54 KB
/releases/19.07.0-rc2/targets/sunxi/cortexa7/openwrt-19.07.0-rc2-sunxi-cortexa7-sun7i-a20-olinuxino-micro-ext4-sdcard.img.gz;2;0;2;5.76 MB;2.88 MB
/releases/18.06.7/targets/sunxi/cortexa53/openwrt-18.06.7-sunxi-cortexa53-sun50i-h5-orangepi-zero-plus-squashfs-sdcard.img.gz;2;0;2;1.45 MB;743.54 KB
/releases/17.01.1/targets/x86/legacy/lede-17.01.1-x86-legacy-generic-rootfs.tar.gz;2;0;2;367.50 KB;183.75 KB
/releases/18.06.3/targets/omap/generic/openwrt-18.06.3-omap-am335x-boneblack-ubifs-sdcard.img.gz;2;0;2;6.10 MB;3.05 MB
/releases/18.06.6/targets/sunxi/cortexa7/openwrt-18.06.6-sunxi-cortexa7-sun6i-a31-m9-squashfs-sdcard.img.gz;2;0;2;4.97 MB;2.49 MB
/releases/18.06.7/targets/oxnas/ox820/openwrt-18.06.7-oxnas-ox820-mitrastar-stg212-ubifs-sysupgrade.tar;2;0;2;8.31 MB;4.16 MB
/releases/17.01.4/targets/ipq806x/generic/lede-17.01.4-ipq806x-D7800-squashfs-sysupgrade.tar;2;0;2;9.45 MB;4.73 MB
/releases/18.06.2/targets/sunxi/cortexa7/openwrt-18.06.2-sunxi-cortexa7-sun7i-a20-olinuxino-micro-squashfs-sdcard.img.gz;2;0;2;4.64 MB;2.32 MB
/releases/19.07.2/targets/at91/sama5/openwrt-19.07.2-at91-sama5-at91-sama5d3_xplained-ext4-root.ubi.gz;2;0;2;2.62 MB;1.31 MB
/releases/19.07.3/targets/sunxi/cortexa8/openwrt-19.07.3-sunxi-cortexa8-sun4i-a10-pcduino-squashfs-sdcard.img.gz;2;0;2;5.36 MB;2.68 MB
/releases/17.01.0-rc1/targets/oxnas/generic/lede-17.01.0-rc1-r3042-ec095b5-oxnas-pogoplug-pro-squashfs-sysupgrade.tar;2;0;2;3.33 MB;1.66 MB
/releases/19.07.1/targets/sunxi/cortexa8/openwrt-19.07.1-sunxi-cortexa8-sun4i-a10-cubieboard-squashfs-sdcard.img.gz;2;0;2;4.99 MB;2.49 MB
/releases/18.06.6/targets/armvirt/32/openwrt-18.06.6-armvirt-32-default-rootfs.tar.gz;2;0;2;2.12 MB;1.06 MB
/releases/18.06.5/targets/sunxi/cortexa8/openwrt-18.06.5-sunxi-cortexa8-sun4i-a10-pcduino-ext4-sdcard.img.gz;2;0;2;5.84 MB;2.92 MB
/releases/19.07.3/targets/ath25/generic/openwrt-19.07.3-ath25-generic-kernel.gz;2;0;2;1.94 MB;991.77 KB
/releases/18.06.7/targets/at91/sama5d3/openwrt-18.06.7-at91-sama5d3-rootfs.tar.gz;2;0;2;1.42 MB;727.54 KB
/releases/17.01.4/targets/kirkwood/generic/lede-17.01.4-kirkwood-ib62x0-squashfs-sysupgrade.tar;2;0;2;2.91 MB;1.45 MB
/releases/18.06.0/targets/mvebu/cortexa53/openwrt-18.06.0-mvebu-cortexa53-globalscale-espressobin-squashfs-sdcard.img.gz;2;0;2;5.46 MB;2.73 MB
/releases/18.06.6/targets/sunxi/cortexa7/openwrt-18.06.6-sunxi-cortexa7-sun7i-a20-bananapro-squashfs-sdcard.img.gz;2;0;2;5.24 MB;2.62 MB
/releases/19.07.1/targets/sunxi/cortexa7/openwrt-19.07.1-sunxi-cortexa7-sun6i-a31-m9-squashfs-sdcard.img.gz;2;0;2;5.36 MB;2.68 MB
/releases/17.01.0-rc1/targets/kirkwood/generic/lede-17.01.0-rc1-r3042-ec095b5-kirkwood-linksys-viper-squashfs-sysupgrade.tar;2;0;2;3.42 MB;1.71 MB
/releases/19.07.3/targets/sunxi/cortexa53/openwrt-19.07.3-sunxi-cortexa53-sun50i-h5-orangepi-pc2-squashfs-sdcard.img.gz;2;0;2;6.29 MB;3.14 MB
/releases/19.07.2/targets/gemini/generic/openwrt-19.07.2-gemini-dlink_dir-685-ext4-sysupgrade.bin.gz;2;0;2;9.10 MB;4.55 MB
/releases/18.06.2/targets/sunxi/cortexa7/openwrt-18.06.2-sunxi-cortexa7-sun8i-h2-plus-orangepi-r1-squashfs-sdcard.img.gz;2;0;2;4.61 MB;2.30 MB
/releases/18.06.2/targets/armvirt/32/openwrt-18.06.2-armvirt-32-root.ext4.gz;2;0;2;2.39 MB;1.19 MB
/releases/18.06.1/targets/sunxi/cortexa7/openwrt-18.06.1-sunxi-cortexa7-sun8i-h3-orangepi-pc-squashfs-sdcard.img.gz;2;0;2;4.57 MB;2.28 MB
/releases/17.01.6/targets/oxnas/generic/lede-17.01.6-oxnas-kd20-factory.tar.gz;2;0;2;527.50 KB;263.75 KB
/releases/18.06.6/targets/archs38/generic/openwrt-18.06.6-archs38-generic-root.ext4.gz;2;0;2;5.63 MB;2.81 MB
/releases/17.01.4/targets/oxnas/generic/lede-17.01.4-oxnas-kd20-ubifs-sysupgrade.tar;2;0;2;415.50 KB;207.75 KB
/releases/17.01.1/targets/sunxi/generic/lede-17.01.1-sunxi-sun7i-a20-bananapro-squashfs-sdcard.img.gz;2;0;2;431.50 KB;215.75 KB
/releases/18.06.3/targets/sunxi/cortexa7/openwrt-18.06.3-sunxi-cortexa7-sun7i-a20-lamobo-r1-squashfs-sdcard.img.gz;2;0;2;5.22 MB;2.61 MB
/releases/17.01.1/targets/sunxi/generic/lede-17.01.1-sunxi-sun7i-a20-bananapi-ext4-sdcard.img.gz;2;0;2;399.50 KB;199.75 KB
/releases/17.01.4/targets/gemini/raidsonic/lede-17.01.4-gemini-raidsonic-nas4220-hddapp.tgz;2;0;2;2.50 MB;1.25 MB
/releases/17.01.4/targets/sunxi/generic/lede-17.01.4-sunxi-sun7i-a20-bananapro-squashfs-sdcard.img.gz;2;0;2;415.50 KB;207.75 KB
/releases/19.07.1/targets/at91/sama5/openwrt-19.07.1-at91-sama5-at91-sama5d4_xplained-ext4-root.ubi.gz;2;0;2;2.57 MB;1.28 MB
/releases/18.06.6/targets/at91/legacy/openwrt-18.06.6-at91-legacy-at91sam9g20ek_2mmc-ext4-root.ubi.gz;2;0;2;2.67 MB;1.33 MB
/releases/18.06.7/targets/mvebu/cortexa72/openwrt-18.06.7-mvebu-cortexa72-armada-macchiatobin-ext4-sdcard.img.gz;2;0;2;6.25 MB;3.13 MB
/releases/18.06.0-rc2/targets/octeon/generic/openwrt-18.06.0-rc2-octeon-erlite-squashfs-sysupgrade.tar;2;0;2;11.98 MB;5.99 MB
/releases/17.01.0/targets/zynq/generic/lede-17.01.0-r3205-59508e3-zynq-zybo-uramdisk.image.gz;2;0;2;367.50 KB;183.75 KB
/releases/18.06.2/targets/at91/sama5d4/openwrt-18.06.2-at91-sama5d4-at91-sama5d4_xplained-ext4-sdcard.img.gz;2;0;2;5.71 MB;2.86 MB
/releases/19.07.0-rc1/targets/mvebu/cortexa53/openwrt-19.07.0-rc1-mvebu-cortexa53-globalscale_espressobin-ext4-sdcard.img.gz;2;0;2;6.48 MB;3.24 MB
/releases/17.01.4/targets/apm821xx/sata/lede-17.01.4-apm821xx-sata-MyBookLiveSingle-ext4-rootfs.img.gz;2;0;2;4.87 MB;2.44 MB
/releases/18.06.3/targets/sunxi/cortexa7/openwrt-18.06.3-sunxi-cortexa7-sun7i-a20-cubietruck-squashfs-sdcard.img.gz;2;0;2;5.27 MB;2.63 MB
/releases/19.07.2/targets/at91/sama5/openwrt-19.07.2-at91-sama5-at91-sama5d27_som1_ek-ext4-root.ubi.gz;2;0;2;2.60 MB;1.30 MB
/releases/19.07.0-rc2/targets/ar71xx/generic/openwrt-19.07.0-rc2-ar71xx-generic-vmlinux.lzma;2;0;2;671.08 KB;335.54 KB
/snapshots/faillogs/arm_cortex-a9_neon/packages/node/host-compile.txt;2;0;2;4.05 MB;2.03 MB
/releases/18.06.2/targets/omap/generic/openwrt-18.06.2-omap-omap3-beagle-ubifs-sdcard.img.gz;2;0;2;1.47 MB;751.54 KB
/releases/18.06.3/targets/oxnas/ox820/openwrt-18.06.3-oxnas-ox820-mitrastar-stg212-ubifs-sysupgrade.tar;2;0;2;8.38 MB;4.19 MB
/releases/18.06.0/targets/oxnas/ox820/openwrt-18.06.0-oxnas-ox820-cloudengines-pogoplug-series-3-ubifs-sysupgrade.tar;2;0;2;7.94 MB;3.97 MB
/releases/18.06.4/targets/at91/sama5d2/openwrt-18.06.4-at91-sama5d2-at91-sama5d2_ptc_ek-ext4-zImage.gz;2;0;2;3.21 MB;1.61 MB
/releases/19.07.1/targets/sunxi/cortexa8/openwrt-19.07.1-sunxi-cortexa8-sun5i-a13-olimex-som-squashfs-sdcard.img.gz;2;0;2;5.22 MB;2.61 MB
/releases/17.01.1/targets/sunxi/generic/lede-17.01.1-sunxi-sun5i-a13-olinuxino-ext4-sdcard.img.gz;2;0;2;207.50 KB;103.75 KB
/releases/19.07.3/targets/mvebu/cortexa53/openwrt-19.07.3-mvebu-cortexa53-globalscale_espressobin-emmc-ext4-sdcard.img.gz;2;0;2;6.50 MB;3.25 MB
/releases/17.01.0-rc2/targets/sunxi/generic/lede-17.01.0-rc2-r3131-42f3c1f-sunxi-sun8i-h3-orangepi-plus-squashfs-sdcard.img.gz;2;0;2;3.59 MB;1.80 MB
/releases/18.06.6/targets/sunxi/cortexa8/openwrt-18.06.6-sunxi-cortexa8-sun4i-a10-pcduino-ext4-sdcard.img.gz;2;0;2;5.95 MB;2.97 MB
/snapshots/faillogs/arm_mpcore_vfp/packages/node/host-compile.txt;2;0;2;4.04 MB;2.02 MB
/releases/17.01.6/targets/sunxi/generic/lede-17.01.6-sunxi-sun7i-a20-lamobo-r1-squashfs-sdcard.img.gz;2;0;2;4.73 MB;2.36 MB
/releases/18.06.3/targets/sunxi/cortexa7/openwrt-18.06.3-sunxi-cortexa7-sun7i-a20-pcduino3-squashfs-sdcard.img.gz;2;0;2;4.98 MB;2.49 MB
/releases/18.06.2/targets/at91/legacy/openwrt-18.06.2-at91-legacy-tny_a9g20-ext4-factory.bin.gz;2;0;2;5.62 MB;2.81 MB
/releases/18.06.1/targets/mvebu/cortexa72/openwrt-18.06.1-mvebu-cortexa72-armada-macchiatobin-squashfs-sdcard.img.gz;2;0;2;1.42 MB;727.54 KB
/releases/18.06.0-rc1/targets/sunxi/cortexa7/openwrt-18.06.0-rc1-sunxi-cortexa7-sun7i-a20-olinuxino-lime2-ext4-sdcard.img.gz;2;0;2;5.49 MB;2.74 MB
/releases/19.07.1/targets/at91/sama5/openwrt-19.07.1-at91-sama5-at91-sama5d4_xplained-ext4-sdcard.img.gz;2;0;2;6.27 MB;3.14 MB
/releases/18.06.3/targets/oxnas/ox820/openwrt-18.06.3-oxnas-ox820-cloudengines-pogoplug-series-3-ubifs-sysupgrade.tar;2;0;2;7.96 MB;3.98 MB
/releases/19.07.0/targets/mvebu/cortexa53/openwrt-19.07.0-mvebu-cortexa53-marvell_armada-3720-db-squashfs-sdcard.img.gz;2;0;2;11.11 MB;5.56 MB
/releases/18.06.5/targets/sunxi/cortexa7/openwrt-18.06.5-sunxi-cortexa7-sun7i-a20-cubietruck-ext4-sdcard.img.gz;2;0;2;6.17 MB;3.08 MB
/releases/18.06.2/targets/mvebu/cortexa72/openwrt-18.06.2-mvebu-cortexa72-armada-macchiatobin-squashfs-sdcard.img.gz;2;0;2;5.52 MB;2.76 MB
/releases/19.07.0-rc2/targets/sunxi/cortexa7/openwrt-19.07.0-rc2-sunxi-cortexa7-sun8i-h2-plus-orangepi-r1-ext4-sdcard.img.gz;2;0;2;5.88 MB;2.94 MB
/releases/18.06.3/targets/armvirt/64/openwrt-18.06.3-armvirt-64-root.ext4.gz;2;0;2;4.47 MB;2.23 MB
/releases/19.07.2/targets/at91/sama5/openwrt-19.07.2-at91-sama5-rootfs.tar.gz;2;0;2;2.24 MB;1.12 MB
/releases/18.06.6/targets/at91/legacy/openwrt-18.06.6-at91-legacy-at91sam9g20ek-ext4-root.ubi.gz;2;0;2;2.51 MB;1.26 MB
/releases/18.06.3/targets/sunxi/cortexa7/openwrt-18.06.3-sunxi-cortexa7-sun8i-h2-plus-orangepi-r1-squashfs-sdcard.img.gz;2;0;2;4.61 MB;2.31 MB
/releases/18.06.1/targets/at91/legacy/openwrt-18.06.1-at91-legacy-usb_a9263-ext4-factory.bin.gz;2;0;2;5.58 MB;2.79 MB
/releases/19.07.3/targets/sunxi/cortexa53/openwrt-19.07.3-sunxi-cortexa53-sun50i-h5-nanopi-neo-plus2-squashfs-sdcard.img.gz;2;0;2;6.06 MB;3.03 MB
/releases/18.06.3/targets/x86/generic/openwrt-18.06.3-x86-generic-rootfs-ext4.img.gz;2;0;2;3.24 MB;1.62 MB
/releases/18.06.2/targets/oxnas/ox820/openwrt-18.06.2-oxnas-ox820-mitrastar-stg212-ubifs-sysupgrade.tar;2;0;2;1.36 MB;695.54 KB
/releases/18.06.6/targets/at91/sama5d2/openwrt-18.06.6-at91-sama5d2-at91-sama5d2_ptc_ek-ext4-zImage.gz;2;0;2;3.22 MB;1.61 MB
/releases/19.07.2/targets/apm821xx/sata/openwrt-19.07.2-apm821xx-sata-wd_mybooklive-ext4-sysupgrade.img.gz;2;0;2;13.09 MB;6.55 MB
/releases/17.01.4/targets/oxnas/generic/lede-17.01.4-oxnas-pogoplug-v3-squashfs-sysupgrade.tar;2;0;2;287.50 KB;143.75 KB
/releases/18.06.7/targets/omap/generic/openwrt-18.06.7-omap-omap3-beagle-ubifs-sdcard.img.gz;2;0;2;6.21 MB;3.11 MB
/releases/18.06.2/targets/oxnas/ox820/openwrt-18.06.2-oxnas-ox820-shuttle-kd20-ubifs-sysupgrade.tar;2;0;2;1.44 MB;735.54 KB
/releases/18.06.6/targets/sunxi/cortexa7/openwrt-18.06.6-sunxi-cortexa7-sun7i-a20-olinuxino-lime-ext4-sdcard.img.gz;2;0;2;5.48 MB;2.74 MB
/releases/18.06.0-rc2/targets/oxnas/ox820/openwrt-18.06.0-rc2-oxnas-ox820-mitrastar-stg212-ubifs-sysupgrade.tar;2;0;2;11.59 MB;5.80 MB
/releases/18.06.0/targets/x86/geode/openwrt-18.06.0-x86-geode-rootfs-squashfs.img.gz;2;0;2;3.67 MB;1.84 MB
/releases/18.06.6/targets/at91/legacy/openwrt-18.06.6-at91-legacy-wb45n-ext4-root.ubi.gz;2;0;2;3.72 MB;1.86 MB
/releases/19.07-SNAPSHOT/targets/x86/64/openwrt-19.07-snapshot-r11237-a448ad7490-x86-64-combined-ext4.img.gz;2;12;14;17.20 MB;1.23 MB
/releases/18.06.4/targets/ar71xx/nand/openwrt-18.06.4-ar71xx-nand-wi2a-ac200i-squashfs-sysupgrade.tar;2;0;2;4.21 MB;2.10 MB
/releases/18.06.4/targets/at91/legacy/openwrt-18.06.4-at91-legacy-tny_a9g20-ext4-factory.bin.gz;2;0;2;5.61 MB;2.81 MB
/snapshots/faillogs/arm_mpcore_vfp/packages/frr/host-compile.txt;2;0;2;15.90 KB;7.95 KB
/releases/18.06.0-rc1/targets/mxs/generic/openwrt-18.06.0-rc1-mxs-duckbill-sdcard.img.gz;2;0;2;13.51 MB;6.75 MB
/releases/18.06.5/targets/imx6/generic/openwrt-18.06.5-imx6-ventana-squashfs-bootfs.tar.gz;2;0;2;2.69 MB;1.35 MB
/releases/17.01.2/targets/sunxi/generic/lede-17.01.2-sunxi-sun5i-a13-olimex-som-ext4-sdcard.img.gz;2;0;2;351.50 KB;175.75 KB
/releases/19.07.3/targets/mvebu/cortexa53/openwrt-19.07.3-mvebu-cortexa53-globalscale_espressobin-squashfs-sdcard.img.gz;2;0;2;8.38 MB;4.19 MB
/releases/17.01.1/targets/sunxi/generic/lede-17.01.1-sunxi-sun5i-a13-olimex-som-squashfs-sdcard.img.gz;2;0;2;303.50 KB;151.75 KB
/releases/19.07.2/targets/zynq/generic/openwrt-19.07.2-zynq-avnet_zynq-zed-squashfs-sdcard.img.gz;2;0;2;5.99 MB;3.00 MB
/releases/18.06.6/targets/omap/generic/openwrt-18.06.6-omap-am335x-boneblack-ubifs-sdcard.img.gz;2;0;2;6.12 MB;3.06 MB
/releases/18.06.0/targets/oxnas/ox820/openwrt-18.06.0-oxnas-ox820-shuttle-kd20-ubifs-sysupgrade.tar;2;0;2;9.04 MB;4.52 MB
/releases/17.01.0-rc1/targets/oxnas/generic/lede-17.01.0-rc1-r3042-ec095b5-oxnas-kd20-ubifs-sysupgrade.tar;2;0;2;2.91 MB;1.45 MB
/releases/18.06.5/targets/brcm2708/bcm2709/openwrt-18.06.5-brcm2708-bcm2709-rpi-2-ext4-factory.img.gz;2;0;2;8.99 MB;4.50 MB
/releases/19.07.0/targets/mvebu/cortexa53/openwrt-19.07.0-mvebu-cortexa53-globalscale_espressobin-emmc-ext4-sdcard.img.gz;2;0;2;12.76 MB;6.38 MB
/releases/19.07.3/targets/sunxi/cortexa7/openwrt-19.07.3-sunxi-cortexa7-sun7i-a20-lamobo-r1-ext4-sdcard.img.gz;2;2;4;6.68 MB;1.67 MB
/releases/17.01.1/targets/oxnas/generic/lede-17.01.1-oxnas-kd20-factory.tar.gz;2;0;2;575.50 KB;287.75 KB
/releases/18.06.4/targets/at91/sama5d2/openwrt-18.06.4-at91-sama5d2-at91-sama5d2_xplained-ext4-sdcard.img.gz;2;0;2;5.78 MB;2.89 MB
/releases/18.06.6/targets/sunxi/cortexa7/openwrt-18.06.6-sunxi-cortexa7-sun7i-a20-cubietruck-squashfs-sdcard.img.gz;2;0;2;5.29 MB;2.64 MB
/releases/19.07.0-rc2/targets/sunxi/cortexa7/openwrt-19.07.0-rc2-sunxi-cortexa7-sun8i-h3-nanopi-m1-plus-squashfs-sdcard.img.gz;2;0;2;6.06 MB;3.03 MB
/releases/18.06.0-rc2/targets/ramips/mt7621/openwrt-18.06.0-rc2-ramips-mt7621-ubnt-erx-sfp-squashfs-sysupgrade.tar;2;0;2;6.42 MB;3.21 MB
/releases/18.06.0-rc1/targets/sunxi/cortexa7/openwrt-18.06.0-rc1-sunxi-cortexa7-sun8i-h3-orangepi-pc-squashfs-sdcard.img.gz;2;0;2;6.91 MB;3.45 MB
/releases/17.01.1/targets/sunxi/generic/lede-17.01.1-sunxi-sun7i-a20-cubietruck-ext4-sdcard.img.gz;2;0;2;431.50 KB;215.75 KB
/releases/18.06.6/targets/sunxi/cortexa7/openwrt-18.06.6-sunxi-cortexa7-sun7i-a20-olinuxino-lime2-emmc-squashfs-sdcard.img.gz;2;0;2;4.72 MB;2.36 MB
/releases/18.06.0-rc2/targets/oxnas/ox820/openwrt-18.06.0-rc2-oxnas-ox820-akitio-mycloud-ubifs-sysupgrade.tar;2;0;2;11.29 MB;5.65 MB
/releases/18.06.5/targets/at91/legacy/openwrt-18.06.5-at91-legacy-tny_a9260-ext4-factory.bin.gz;2;0;2;5.64 MB;2.82 MB
/releases/18.06.1/targets/sunxi/cortexa7/openwrt-18.06.1-sunxi-cortexa7-sun7i-a20-cubieboard2-squashfs-sdcard.img.gz;2;0;2;4.61 MB;2.31 MB
/releases/19.07.3/targets/mvebu/cortexa53/openwrt-19.07.3-mvebu-cortexa53-globalscale_espressobin-v7-squashfs-sdcard.img.gz;2;0;2;8.66 MB;4.33 MB
/releases/18.06.2/targets/mvebu/cortexa53/openwrt-18.06.2-mvebu-cortexa53-globalscale-espressobin-squashfs-sdcard.img.gz;2;0;2;5.51 MB;2.75 MB
/releases/17.01.7/targets/sunxi/generic/lede-17.01.7-sunxi-sun6i-a31-m9-ext4-sdcard.img.gz;2;0;2;447.50 KB;223.75 KB
/releases/17.01.0-rc2/targets/sunxi/generic/lede-17.01.0-rc2-r3131-42f3c1f-sunxi-sun7i-a20-pcduino3-squashfs-sdcard.img.gz;2;0;2;3.11 MB;1.55 MB
/releases/18.06.1/targets/sunxi/cortexa53/openwrt-18.06.1-sunxi-cortexa53-sun50i-h5-orangepi-zero-plus-squashfs-sdcard.img.gz;2;0;2;5.75 MB;2.88 MB
/releases/19.07.1/targets/at91/sam9x/openwrt-19.07.1-at91-sam9x-tny_a9260-ext4-factory.bin.gz;2;0;2;6.03 MB;3.02 MB
/releases/18.06.5/targets/armvirt/32/openwrt-18.06.5-armvirt-32-root.squashfs.gz;2;0;2;1.71 MB;875.67 KB
/releases/19.07.0-rc2/targets/sunxi/cortexa7/openwrt-19.07.0-rc2-sunxi-cortexa7-sun7i-a20-cubieboard2-squashfs-sdcard.img.gz;2;0;2;5.00 MB;2.50 MB
/releases/19.07.2/targets/oxnas/ox820/openwrt-19.07.2-oxnas-ox820-shuttle_kd20-factory.tar.gz;2;0;2;1.80 MB;919.54 KB
/releases/18.06.5/targets/ramips/mt7621/openwrt-18.06.5-ramips-mt7621-ubnt-erx-squashfs-sysupgrade.tar;2;0;2;3.53 MB;1.77 MB
/releases/17.01.5/targets/x86/legacy/lede-17.01.5-x86-legacy-generic-rootfs.tar.gz;2;0;2;2.88 MB;1.44 MB
/releases/18.06.2/targets/x86/legacy/openwrt-18.06.2-x86-legacy-combined-ext4.img.gz;2;0;2;6.90 MB;3.45 MB
/releases/18.06.6/targets/sunxi/cortexa8/openwrt-18.06.6-sunxi-cortexa8-sun4i-a10-pcduino-squashfs-sdcard.img.gz;2;0;2;4.91 MB;2.45 MB
/releases/17.01.0/targets/kirkwood/generic/lede-17.01.0-r3205-59508e3-kirkwood-ib62x0-squashfs-sysupgrade.tar;2;0;2;3.31 MB;1.66 MB
/releases/19.07.0-rc2/targets/sunxi/cortexa7/openwrt-19.07.0-rc2-sunxi-cortexa7-sun7i-a20-olinuxino-lime-ext4-sdcard.img.gz;2;0;2;5.82 MB;2.91 MB
/releases/18.06.2/targets/ramips/mt7621/openwrt-18.06.2-ramips-mt7621-ubnt-erx-sfp-squashfs-sysupgrade.tar;2;0;2;3.44 MB;1.72 MB
/releases/18.06.6/targets/mvebu/cortexa53/openwrt-18.06.6-mvebu-cortexa53-globalscale-espressobin-ext4-sdcard.img.gz;2;0;2;6.31 MB;3.16 MB
/releases/18.06.0/targets/apm821xx/sata/openwrt-18.06.0-apm821xx-sata-wd_mybooklive-duo-ext4-rootfs.img.gz;2;0;2;12.17 MB;6.09 MB
/releases/18.06.3/targets/at91/sama5d4/openwrt-18.06.3-at91-sama5d4-rootfs.tar.gz;2;0;2;2.11 MB;1.05 MB
/releases/18.06.0-rc1/targets/sunxi/cortexa7/openwrt-18.06.0-rc1-sunxi-cortexa7-sun8i-h3-orangepi-2-squashfs-sdcard.img.gz;2;0;2;4.62 MB;2.31 MB
/releases/18.06.0/targets/sunxi/cortexa7/openwrt-18.06.0-sunxi-cortexa7-sun7i-a20-olinuxino-micro-ext4-sdcard.img.gz;2;0;2;5.46 MB;2.73 MB
/releases/18.06.7/targets/at91/legacy/openwrt-18.06.7-at91-legacy-ethernut5-ext4-root.ubi.gz;2;0;2;2.43 MB;1.22 MB
/releases/19.07.2/targets/at91/sama5/openwrt-19.07.2-at91-sama5-at91-sama5d27_som1_ek-ext4-sdcard.img.gz;2;0;2;6.09 MB;3.05 MB
/releases/18.06.0/targets/sunxi/cortexa8/openwrt-18.06.0-sunxi-cortexa8-sun4i-a10-pcduino-ext4-sdcard.img.gz;2;0;2;5.82 MB;2.91 MB
/releases/18.06.0/targets/x86/legacy/openwrt-18.06.0-x86-legacy-generic-rootfs.tar.gz;2;0;2;2.92 MB;1.46 MB
/releases/19.07.1/targets/omap/generic/openwrt-19.07.1-omap-ti_omap4-panda-ext4-sdcard.img.gz;2;0;2;6.69 MB;3.34 MB
/releases/19.07.1/targets/x86/legacy/openwrt-19.07.1-x86-legacy-generic-rootfs.tar.gz;2;0;2;3.02 MB;1.51 MB
/releases/18.06.3/targets/sunxi/cortexa7/openwrt-18.06.3-sunxi-cortexa7-sun8i-h3-orangepi-pc-ext4-sdcard.img.gz;2;0;2;5.57 MB;2.78 MB
/releases/18.06.7/targets/at91/legacy/openwrt-18.06.7-at91-legacy-tny_a9260-ext4-factory.bin.gz;2;0;2;5.64 MB;2.82 MB
/releases/18.06.6/targets/sunxi/cortexa7/openwrt-18.06.6-sunxi-cortexa7-sun7i-a20-pcduino3-ext4-sdcard.img.gz;2;0;2;5.93 MB;2.96 MB
/releases/18.06.2/targets/oxnas/ox820/openwrt-18.06.2-oxnas-ox820-cloudengines-pogoplug-pro-squashfs-sysupgrade.tar;2;0;2;1.47 MB;751.54 KB
/releases/18.06.7/targets/mvebu/cortexa9/omnia-medkit-openwrt-18.06.7-mvebu-cortexa9-turris-omnia-initramfs.tar.gz;2;0;2;3.88 MB;1.94 MB
/releases/17.01.2/targets/zynq/generic/lede-17.01.2-zynq-rootfs.tar.gz;2;0;2;223.50 KB;111.75 KB
/releases/19.07.1/targets/imx6/generic/openwrt-19.07.1-imx6-ventana-squashfs-bootfs.tar.gz;2;0;2;2.68 MB;1.34 MB
/releases/18.06.0-rc1/targets/armvirt/32/openwrt-18.06.0-rc1-armvirt-32-root.ext4.gz;2;0;2;4.24 MB;2.12 MB
/releases/18.06.1/targets/sunxi/cortexa8/openwrt-18.06.1-sunxi-cortexa8-sun5i-a13-olinuxino-squashfs-sdcard.img.gz;2;0;2;4.91 MB;2.45 MB
/releases/18.06.3/targets/x86/generic/openwrt-18.06.3-x86-generic-rootfs-squashfs.img.gz;2;0;2;2.36 MB;1.18 MB
/releases/18.06.6/targets/at91/sama5d3/openwrt-18.06.6-at91-sama5d3-at91-sama5d3_xplained-ext4-sdcard.img.gz;2;0;2;5.81 MB;2.91 MB
/releases/18.06.5/targets/mvebu/cortexa72/openwrt-18.06.5-mvebu-cortexa72-armada-macchiatobin-ext4-sdcard.img.gz;2;0;2;6.25 MB;3.13 MB
/releases/17.01.6/targets/x86/64/lede-17.01.6-x86-64-rootfs-ext4.img.gz;2;0;2;3.37 MB;1.68 MB
/releases/19.07.0-rc2/targets/sunxi/cortexa7/openwrt-19.07.0-rc2-sunxi-cortexa7-sun7i-a20-olinuxino-lime-squashfs-sdcard.img.gz;2;0;2;5.05 MB;2.52 MB
/releases/17.01.0-rc2/targets/sunxi/generic/lede-17.01.0-rc2-r3131-42f3c1f-sunxi-sun4i-a10-cubieboard-squashfs-sdcard.img.gz;2;0;2;4.19 MB;2.10 MB
/releases/18.06.0-rc1/targets/apm821xx/nand/openwrt-18.06.0-rc1-apm821xx-nand-meraki_mx60-squashfs-sysupgrade.tar;2;0;2;8.30 MB;4.15 MB
/releases/18.06.2/targets/sunxi/cortexa8/openwrt-18.06.2-sunxi-cortexa8-sun5i-a13-olimex-som-ext4-sdcard.img.gz;2;0;2;5.83 MB;2.92 MB
/releases/18.06.5/targets/sunxi/cortexa7/openwrt-18.06.5-sunxi-cortexa7-sun7i-a20-olinuxino-lime2-squashfs-sdcard.img.gz;2;0;2;4.72 MB;2.36 MB
/releases/18.06.3/targets/at91/legacy/openwrt-18.06.3-at91-legacy-at91sam9263ek-ext4-root.ubi.gz;2;0;2;2.50 MB;1.25 MB
/releases/18.06.2/targets/mxs/generic/openwrt-18.06.2-mxs-duckbill-sdcard.img.gz;2;0;2;1.44 MB;735.54 KB
/releases/18.06.5/targets/sunxi/cortexa7/openwrt-18.06.5-sunxi-cortexa7-sun7i-a20-olinuxino-micro-ext4-sdcard.img.gz;2;0;2;5.59 MB;2.79 MB
/releases/17.01.5/targets/zynq/generic/lede-17.01.5-zynq-zybo-uramdisk.image.gz;2;0;2;1.98 MB;1012.99 KB
/releases/17.01.4/targets/oxnas/generic/lede-17.01.4-oxnas-kd20-squashfs-sysupgrade.tar;2;0;2;223.50 KB;111.75 KB
/releases/19.07.0-rc2/targets/mvebu/cortexa72/openwrt-19.07.0-rc2-mvebu-cortexa72-marvell_armada8040-db-squashfs-sdcard.img.gz;2;0;2;5.65 MB;2.82 MB
/releases/17.01.0-rc2/targets/sunxi/generic/lede-17.01.0-rc2-r3131-42f3c1f-sunxi-sun7i-a20-lamobo-r1-ext4-sdcard.img.gz;2;0;2;3.12 MB;1.56 MB
/releases/18.06.5/targets/mvebu/cortexa9/openwrt-18.06.5-mvebu-cortexa9-armada-388-clearfog-pro-squashfs-sdcard.img.gz;2;0;2;4.69 MB;2.34 MB
/releases/19.07.3/targets/apm821xx/sata/openwrt-19.07.3-apm821xx-sata-wd_mybooklive-squashfs-sysupgrade.img.gz;2;0;2;5.48 MB;2.74 MB
/releases/18.06.5/targets/omap/generic/openwrt-18.06.5-omap-rootfs.tar.gz;2;0;2;2.07 MB;1.04 MB
/releases/18.06.7/targets/sunxi/cortexa53/openwrt-18.06.7-sunxi-cortexa53-sun50i-h5-nanopi-neo-plus2-squashfs-sdcard.img.gz;2;0;2;1.55 MB;791.54 KB
/releases/18.06.0/targets/sunxi/cortexa7/openwrt-18.06.0-sunxi-cortexa7-sun8i-h3-orangepi-plus-squashfs-sdcard.img.gz;2;0;2;4.58 MB;2.29 MB
/releases/19.07.0-rc2/targets/gemini/generic/openwrt-19.07.0-rc2-gemini-dlink_dir-685-ext4-sysupgrade.bin.gz;2;0;2;9.21 MB;4.61 MB
/releases/18.06.6/targets/mvebu/cortexa53/openwrt-18.06.6-mvebu-cortexa53-globalscale-espressobin-squashfs-sdcard.img.gz;2;0;2;5.52 MB;2.76 MB
/releases/18.06.6/targets/at91/legacy/openwrt-18.06.6-at91-legacy-at91sam9m10g45ek-ext4-root.ubi.gz;2;0;2;2.51 MB;1.26 MB
/releases/19.07.3/targets/sunxi/cortexa53/openwrt-19.07.3-sunxi-cortexa53-sun50i-a64-sopine-baseboard-squashfs-sdcard.img.gz;2;0;2;6.17 MB;3.09 MB
/releases/18.06.3/targets/x86/generic/openwrt-18.06.3-x86-generic-combined-ext4.img.gz;2;0;2;7.70 MB;3.85 MB
/releases/18.06.6/targets/ar71xx/nand/openwrt-18.06.6-ar71xx-nand-hiveap-121-squashfs-sysupgrade.tar;2;0;2;3.88 MB;1.94 MB
/releases/19.07.3/targets/ar71xx/nand/openwrt-19.07.3-ar71xx-nand-z1-squashfs-sysupgrade.tar;2;0;2;7.56 MB;3.78 MB
/releases/18.06.6/targets/brcm2708/bcm2709/openwrt-18.06.6-brcm2708-bcm2709-rpi-2-ext4-factory.img.gz;2;0;2;1.48 MB;759.54 KB
/releases/18.06.1/targets/at91/legacy/openwrt-18.06.1-at91-legacy-at91sam9g20ek-ext4-zImage.gz;2;0;2;3.21 MB;1.60 MB
/releases/18.06.6/targets/sunxi/cortexa7/openwrt-18.06.6-sunxi-cortexa7-sun8i-h3-nanopi-neo-ext4-sdcard.img.gz;2;0;2;5.39 MB;2.70 MB
/releases/19.07.2/targets/sunxi/cortexa7/openwrt-19.07.2-sunxi-cortexa7-sun7i-a20-pcduino3-ext4-sdcard.img.gz;2;0;2;6.20 MB;3.10 MB
/releases/19.07.1/targets/sunxi/cortexa7/openwrt-19.07.1-sunxi-cortexa7-sun8i-h3-orangepi-2-squashfs-sdcard.img.gz;2;0;2;5.00 MB;2.50 MB
/releases/17.01.2/targets/sunxi/generic/lede-17.01.2-sunxi-sun4i-a10-cubieboard-ext4-sdcard.img.gz;2;0;2;223.50 KB;111.75 KB
/releases/19.07.2/targets/sunxi/cortexa7/openwrt-19.07.2-sunxi-cortexa7-sun8i-h3-orangepi-pc-plus-squashfs-sdcard.img.gz;2;0;2;9.53 MB;4.77 MB
/releases/18.06.4/targets/ath25/generic/openwrt-18.06.4-ath25-generic-kernel.gz;2;0;2;2.16 MB;1.08 MB
/releases/18.06.6/targets/oxnas/ox820/openwrt-18.06.6-oxnas-ox820-shuttle-kd20-squashfs-sysupgrade.tar;2;0;2;5.46 MB;2.73 MB
/releases/18.06.5/targets/arc770/generic/openwrt-18.06.5-arc770-generic-root.ext4.gz;2;0;2;2.87 MB;1.43 MB
/releases/17.01.5/targets/x86/64/lede-17.01.5-x86-64-combined-ext4.img.gz;2;0;2;6.10 MB;3.05 MB
/releases/18.06.2/targets/brcm2708/bcm2710/openwrt-18.06.2-brcm2708-bcm2710-rpi-3-squashfs-sysupgrade.img.gz;2;0;2;7.96 MB;3.98 MB
/releases/19.07.1/targets/at91/sama5/openwrt-19.07.1-at91-sama5-at91-sama5d3_xplained-ext4-zImage.gz;2;0;2;3.47 MB;1.73 MB
/releases/18.06.4/targets/omap/generic/openwrt-18.06.4-omap-am335x-boneblack-ubifs-sdcard.img.gz;2;0;2;6.11 MB;3.06 MB
/releases/17.01.6/targets/mvebu/generic/lede-17.01.6-mvebu-armada-388-clearfog-sdcard.img.gz;2;0;2;415.50 KB;207.75 KB
/releases/18.06.6/targets/at91/sama5d2/openwrt-18.06.6-at91-sama5d2-at91-sama5d2_xplained-ext4-zImage.gz;2;0;2;1.42 MB;727.54 KB
/releases/17.01.0-rc2/targets/ipq806x/generic/lede-17.01.0-rc2-r3131-42f3c1f-ipq806x-R7500-squashfs-sysupgrade.tar;2;0;2;2.67 MB;1.34 MB
/releases/18.06.5/targets/x86/generic/openwrt-18.06.5-x86-generic-combined-squashfs.img.gz;2;0;2;7.07 MB;3.53 MB
/releases/18.06.0/targets/mvebu/cortexa9/omnia-medkit-openwrt-18.06.0-mvebu-cortexa9-turris-omnia-initramfs.tar.gz;2;0;2;3.85 MB;1.92 MB
/releases/19.07.1/targets/mxs/generic/openwrt-19.07.1-mxs-root.ext4.gz;2;0;2;5.46 MB;2.73 MB
/releases/17.01.0/targets/brcm63xx/generic/lede-17.01.0-r3205-59508e3-brcm63xx-generic-livebox-vmlinux.gz;2;0;2;3.50 MB;1.75 MB
/releases/19.07.1/targets/x86/geode/openwrt-19.07.1-x86-geode-rootfs-ext4.img.gz;2;0;2;4.93 MB;2.47 MB
/releases/18.06.6/targets/ramips/mt7621/openwrt-18.06.6-ramips-mt7621-ubnt-erx-sfp-squashfs-sysupgrade.tar;2;0;2;3.58 MB;1.79 MB
/releases/18.06.1/targets/oxnas/ox820/openwrt-18.06.1-oxnas-ox820-shuttle-kd20-squashfs-sysupgrade.tar;2;0;2;5.43 MB;2.71 MB
/releases/19.07.1/targets/sunxi/cortexa7/openwrt-19.07.1-sunxi-cortexa7-sun7i-a20-cubietruck-ext4-sdcard.img.gz;2;0;2;6.82 MB;3.41 MB
/releases/18.06.0-rc1/targets/mvebu/cortexa53/openwrt-18.06.0-rc1-mvebu-cortexa53-globalscale-espressobin-squashfs-sdcard.img.gz;2;0;2;10.63 MB;5.31 MB
/releases/18.06.3/targets/sunxi/cortexa7/openwrt-18.06.3-sunxi-cortexa7-sun8i-h3-orangepi-plus-ext4-sdcard.img.gz;2;0;2;5.42 MB;2.71 MB
/releases/18.06.7/targets/mvebu/cortexa9/openwrt-18.06.7-mvebu-cortexa9-armada-388-clearfog-base-squashfs-sdcard.img.gz;2;0;2;4.69 MB;2.34 MB
/releases/18.06.6/targets/sunxi/cortexa7/openwrt-18.06.6-sunxi-cortexa7-sun8i-h3-orangepi-plus-ext4-sdcard.img.gz;2;0;2;5.43 MB;2.71 MB
/releases/19.07.2/targets/oxnas/ox820/openwrt-19.07.2-oxnas-ox820-shuttle_kd20-squashfs-sysupgrade.tar;2;0;2;1.44 MB;735.54 KB
/releases/18.06.3/targets/oxnas/ox820/openwrt-18.06.3-oxnas-ox820-akitio-mycloud-ubifs-sysupgrade.tar;2;0;2;8.48 MB;4.24 MB
/releases/17.01.1/targets/sunxi/generic/lede-17.01.1-sunxi-sun7i-a20-olinuxino-micro-ext4-sdcard.img.gz;2;0;2;559.50 KB;279.75 KB
/releases/18.06.0-rc2/targets/oxnas/ox820/openwrt-18.06.0-rc2-oxnas-ox820-mitrastar-stg212-squashfs-sysupgrade.tar;2;0;2;7.71 MB;3.86 MB
/releases/18.06.0-rc2/targets/ar71xx/nand/openwrt-18.06.0-rc2-ar71xx-nand-nbg6716-squashfs-sysupgrade.tar;2;0;2;8.02 MB;4.01 MB
/releases/19.07.1/targets/at91/sama5/openwrt-19.07.1-at91-sama5-at91-sama5d4_xplained-ext4-zImage.gz;2;0;2;3.47 MB;1.73 MB
/releases/18.06.0-rc1/targets/octeon/generic/openwrt-18.06.0-rc1-octeon-er-squashfs-sysupgrade.tar;2;0;2;12.09 MB;6.05 MB
/releases/19.07.0/targets/mvebu/cortexa72/openwrt-19.07.0-mvebu-cortexa72-marvell_macchiatobin-squashfs-sdcard.img.gz;2;0;2;11.16 MB;5.58 MB
/snapshots/faillogs/arm_cortex-a5_vfpv4/packages/perl-inline/host-compile.txt;2;0;2;391 Bytes;195 Bytes
/releases/19.07.3/targets/sunxi/cortexa7/openwrt-19.07.3-sunxi-cortexa7-sun8i-h3-orangepi-pc-ext4-sdcard.img.gz;2;0;2;5.68 MB;2.84 MB
/releases/18.06.7/targets/sunxi/cortexa8/openwrt-18.06.7-sunxi-cortexa8-sun4i-a10-olinuxino-lime-squashfs-sdcard.img.gz;2;0;2;5.68 MB;2.84 MB
/releases/17.01.6/targets/zynq/generic/lede-17.01.6-zynq-zc702-uramdisk.image.gz;2;0;2;1.96 MB;1005.60 KB
/releases/18.06.5/targets/at91/sama5d3/openwrt-18.06.5-at91-sama5d3-at91-sama5d3_xplained-ext4-root.ubi.gz;2;0;2;2.50 MB;1.25 MB
/snapshots/faillogs/arm_cortex-a7/packages/perl-parse-recdescent/host-compile.txt;2;0;2;429 Bytes;214 Bytes
/snapshots/faillogs/arm_cortex-a8_neon/packages/node/host-compile.txt;2;0;2;4.05 MB;2.03 MB
/releases/18.06.9/targets/brcm2708/bcm2710/openwrt-18.06.9-brcm2708-bcm2710-rpi-3-ext4-sysupgrade.img.gz;2;0;2;17.70 MB;8.85 MB
/releases/18.06.5/targets/ramips/mt7621/openwrt-18.06.5-ramips-mt7621-mir3g-squashfs-sysupgrade.tar;2;0;2;4.25 MB;2.12 MB
/releases/18.06.1/targets/oxnas/ox820/openwrt-18.06.1-oxnas-ox820-akitio-mycloud-ubifs-sysupgrade.tar;2;0;2;2.76 MB;1.38 MB
/releases/18.06.5/targets/at91/legacy/openwrt-18.06.5-at91-legacy-at91sam9263ek-ext4-root.ubi.gz;2;0;2;2.62 MB;1.31 MB
/releases/17.01.2/targets/omap/generic/lede-17.01.2-omap-default-rootfs.tar.gz;2;0;2;303.50 KB;151.75 KB
/releases/18.06.4/targets/at91/sama5d2/openwrt-18.06.4-at91-sama5d2-at91-sama5d27_som1_ek-ext4-sdcard.img.gz;2;0;2;5.72 MB;2.86 MB
/releases/18.06.7/targets/oxnas/ox820/openwrt-18.06.7-oxnas-ox820-cloudengines-pogoplug-pro-squashfs-sysupgrade.tar;2;0;2;4.78 MB;2.39 MB
/releases/18.06.7/targets/x86/geode/openwrt-18.06.7-x86-geode-rootfs-ext4.img.gz;2;0;2;2.75 MB;1.37 MB
/releases/18.06.6/targets/at91/sama5d4/openwrt-18.06.6-at91-sama5d4-at91-sama5d4_xplained-ext4-zImage.gz;2;0;2;1.41 MB;719.54 KB
/releases/18.06.0-rc2/targets/ramips/mt7621/openwrt-18.06.0-rc2-ramips-mt7621-ubnt-erx-squashfs-sysupgrade.tar;2;0;2;6.45 MB;3.23 MB
/releases/19.07.1/targets/ar71xx/nand/openwrt-19.07.1-ar71xx-nand-wndr3700v4-squashfs-sysupgrade.tar;2;0;2;4.68 MB;2.34 MB
/releases/17.01.0-rc2/targets/sunxi/generic/lede-17.01.0-rc2-r3131-42f3c1f-sunxi-sun4i-a10-pcduino-ext4-sdcard.img.gz;2;0;2;2.94 MB;1.47 MB
/releases/19.07.0-rc2/targets/sunxi/cortexa7/openwrt-19.07.0-rc2-sunxi-cortexa7-sun8i-h3-orangepi-pc-plus-ext4-sdcard.img.gz;2;0;2;5.68 MB;2.84 MB
/releases/17.01.5/targets/brcm2708/bcm2710/lede-17.01.5-brcm2708-bcm2710-rpi-3-ext4-sdcard.img.gz;2;0;2;16.26 MB;8.13 MB
/releases/18.06.0-rc1/targets/sunxi/cortexa8/openwrt-18.06.0-rc1-sunxi-cortexa8-sun5i-a13-olimex-som-squashfs-sdcard.img.gz;2;0;2;7.14 MB;3.57 MB
/releases/17.01.2/targets/zynq/generic/lede-17.01.2-zynq-zed-uramdisk.image.gz;2;0;2;143.50 KB;71.75 KB
/snapshots/faillogs/arm_cortex-a9_neon/packages/frr/host-compile.txt;2;0;2;15.90 KB;7.95 KB
/releases/18.06.0/targets/sunxi/cortexa53/openwrt-18.06.0-sunxi-cortexa53-sun50i-h5-orangepi-zero-plus-squashfs-sdcard.img.gz;2;0;2;5.75 MB;2.87 MB
/releases/17.01.1/targets/sunxi/generic/lede-17.01.1-sunxi-sun7i-a20-cubieboard2-squashfs-sdcard.img.gz;2;0;2;335.50 KB;167.75 KB
/releases/18.06.6/targets/at91/legacy/openwrt-18.06.6-at91-legacy-at91sam9g25ek-ext4-root.ubi.gz;2;0;2;2.50 MB;1.25 MB
/releases/19.07.1/targets/zynq/generic/openwrt-19.07.1-zynq-xlnx_zynq-zc702-squashfs-sdcard.img.gz;2;0;2;6.02 MB;3.01 MB
/releases/19.07.1/targets/sunxi/cortexa7/openwrt-19.07.1-sunxi-cortexa7-sun8i-h3-orangepi-plus-squashfs-sdcard.img.gz;2;0;2;4.91 MB;2.45 MB
/releases/17.01.3/targets/apm821xx/nand/lede-17.01.3-apm821xx-nand-mx60w-squashfs-sysupgrade.tar;2;0;2;4.32 MB;2.16 MB
/releases/18.06.5/targets/mvebu/cortexa72/openwrt-18.06.5-mvebu-cortexa72-armada-macchiatobin-squashfs-sdcard.img.gz;2;0;2;5.54 MB;2.77 MB
/releases/18.06.5/targets/gemini/generic/openwrt-18.06.5-gemini-sysupgrade-ib4220b.tar.gz;2;0;2;10.53 MB;5.27 MB
/releases/17.01.0-rc1/targets/mediatek/generic/lede-17.01.0-rc1-r3042-ec095b5-mediatek-NAND-squashfs-sysupgrade.tar;2;0;2;3.20 MB;1.60 MB
/releases/17.01.0-rc1/targets/kirkwood/generic/lede-17.01.0-rc1-r3042-ec095b5-kirkwood-linksys-audi-squashfs-sysupgrade.tar;2;0;2;3.12 MB;1.56 MB
/releases/19.07.2/targets/at91/sama5/openwrt-19.07.2-at91-sama5-at91-sama5d4_xplained-ext4-sdcard.img.gz;2;0;2;6.12 MB;3.06 MB
/releases/17.01.0-rc1/targets/oxnas/generic/lede-17.01.0-rc1-r3042-ec095b5-oxnas-kd20-squashfs-sysupgrade.tar;2;0;2;3.42 MB;1.71 MB
/releases/19.07.2/targets/omap/generic/openwrt-19.07.2-omap-ti_am335x-evm-squashfs-sdcard.img.gz;2;0;2;1.55 MB;791.54 KB
/releases/18.06.3/targets/at91/sama5d2/openwrt-18.06.3-at91-sama5d2-at91-sama5d2_ptc_ek-ext4-zImage.gz;2;0;2;3.21 MB;1.61 MB
/releases/19.07.0/targets/oxnas/ox820/openwrt-19.07.0-oxnas-ox820-akitio_mycloud-ubifs-sysupgrade.tar;2;0;2;8.49 MB;4.24 MB
/releases/18.06.7/targets/at91/legacy/openwrt-18.06.7-at91-legacy-usb_a9263-ext4-factory.bin.gz;2;0;2;5.62 MB;2.81 MB
/releases/18.06.7/targets/at91/sama5d2/openwrt-18.06.7-at91-sama5d2-at91-sama5d2_ptc_ek-ext4-zImage.gz;2;0;2;1.42 MB;727.54 KB
/releases/18.06.2/targets/sunxi/cortexa8/openwrt-18.06.2-sunxi-cortexa8-sun5i-a13-olimex-som-squashfs-sdcard.img.gz;2;0;2;4.89 MB;2.44 MB
/releases/18.06.1/targets/mvebu/cortexa9/openwrt-18.06.1-mvebu-cortexa9-turris-omnia-sysupgrade.img.gz;2;0;2;1.55 MB;791.54 KB
/releases/18.06.2/targets/oxnas/ox820/openwrt-18.06.2-oxnas-ox820-cloudengines-pogoplug-series-3-ubifs-sysupgrade.tar;2;0;2;1.42 MB;727.54 KB
/releases/18.06.3/targets/sunxi/cortexa7/openwrt-18.06.3-sunxi-cortexa7-sun8i-h3-nanopi-m1-plus-squashfs-sdcard.img.gz;2;0;2;5.60 MB;2.80 MB
/releases/19.07.1/targets/sunxi/cortexa7/openwrt-19.07.1-sunxi-cortexa7-sun7i-a20-bananapi-ext4-sdcard.img.gz;2;0;2;5.91 MB;2.95 MB
/releases/18.06.2/targets/x86/legacy/openwrt-18.06.2-x86-legacy-combined-squashfs.img.gz;2;0;2;6.20 MB;3.10 MB
/releases/18.06.4/targets/at91/sama5d2/openwrt-18.06.4-at91-sama5d2-at91-sama5d2_xplained-ext4-zImage.gz;2;0;2;3.21 MB;1.61 MB
/releases/18.06.1/targets/apm821xx/sata/openwrt-18.06.1-apm821xx-sata-wd_mybooklive-duo-ext4-rootfs.img.gz;2;0;2;6.09 MB;3.04 MB
/releases/19.07.0-rc2/targets/sunxi/cortexa7/openwrt-19.07.0-rc2-sunxi-cortexa7-sun8i-h3-orangepi-pc-ext4-sdcard.img.gz;2;0;2;5.86 MB;2.93 MB
/releases/18.06.0-rc1/targets/sunxi/cortexa7/openwrt-18.06.0-rc1-sunxi-cortexa7-sun8i-h2-plus-orangepi-r1-squashfs-sdcard.img.gz;2;0;2;7.35 MB;3.68 MB
/releases/18.06.3/targets/at91/sama5d4/openwrt-18.06.3-at91-sama5d4-at91-sama5d4_xplained-ext4-sdcard.img.gz;2;0;2;5.72 MB;2.86 MB
/releases/19.07.0-rc2/targets/sunxi/cortexa7/openwrt-19.07.0-rc2-sunxi-cortexa7-sun7i-a20-bananapi-squashfs-sdcard.img.gz;2;0;2;5.05 MB;2.52 MB
/releases/18.06.5/targets/sunxi/cortexa8/openwrt-18.06.5-sunxi-cortexa8-sun4i-a10-olinuxino-lime-squashfs-sdcard.img.gz;2;0;2;4.57 MB;2.29 MB
/releases/17.01.4/targets/kirkwood/generic/lede-17.01.4-kirkwood-goflexnet-squashfs-sysupgrade.tar;2;0;2;2.72 MB;1.36 MB
/releases/18.06.1/targets/x86/legacy/openwrt-18.06.1-x86-legacy-generic-rootfs.tar.gz;2;0;2;2.82 MB;1.41 MB
/releases/18.06.5/targets/sunxi/cortexa7/openwrt-18.06.5-sunxi-cortexa7-sun8i-h3-orangepi-plus-ext4-sdcard.img.gz;2;0;2;5.42 MB;2.71 MB
/releases/17.01.0/targets/imx6/generic/lede-17.01.0-r3205-59508e3-imx6-rootfs.tar.gz;2;0;2;607.50 KB;303.75 KB
/releases/19.07.0/targets/oxnas/ox820/openwrt-19.07.0-oxnas-ox820-mitrastar_stg-212-squashfs-sysupgrade.tar;2;0;2;5.58 MB;2.79 MB
/releases/18.06.6/targets/at91/legacy/openwrt-18.06.6-at91-legacy-lmu5000-ext4-factory.bin.gz;2;0;2;5.66 MB;2.83 MB
/releases/18.06.5/targets/sunxi/cortexa7/openwrt-18.06.5-sunxi-cortexa7-sun7i-a20-cubieboard2-squashfs-sdcard.img.gz;2;0;2;4.63 MB;2.32 MB
/releases/18.06.2/targets/brcm2708/bcm2709/openwrt-18.06.2-brcm2708-bcm2709-rpi-2-ext4-sysupgrade.img.gz;2;0;2;9.02 MB;4.51 MB
/releases/18.06.7/targets/armvirt/32/openwrt-18.06.7-armvirt-32-default-rootfs.tar.gz;2;0;2;1.84 MB;943.54 KB
/releases/18.06.7/targets/sunxi/cortexa53/openwrt-18.06.7-sunxi-cortexa53-sun50i-a64-sopine-baseboard-ext4-sdcard.img.gz;2;0;2;1.33 MB;679.54 KB
/releases/18.06.3/targets/imx6/generic/openwrt-18.06.3-imx6-rootfs.tar.gz;2;0;2;1.44 MB;735.54 KB
/releases/18.06.5/targets/omap/generic/openwrt-18.06.5-omap-omap4-panda-ubifs-sdcard.img.gz;2;0;2;6.07 MB;3.04 MB
/releases/17.01.1/targets/oxnas/generic/lede-17.01.1-oxnas-kd20-ubifs-sysupgrade.tar;2;0;2;735.50 KB;367.75 KB
/releases/17.01.6/targets/x86/legacy/lede-17.01.6-x86-legacy-combined-ext4.img.gz;2;0;2;6.44 MB;3.22 MB
/releases/18.06.6/targets/oxnas/ox820/openwrt-18.06.6-oxnas-ox820-mitrastar-stg212-ubifs-sysupgrade.tar;2;0;2;8.31 MB;4.16 MB
/releases/18.06.6/targets/x86/legacy/openwrt-18.06.6-x86-legacy-combined-ext4.img.gz;2;0;2;6.92 MB;3.46 MB
/releases/19.07.2/targets/x86/geode/openwrt-19.07.2-x86-geode-combined-ext4.img.gz;2;0;2;7.56 MB;3.78 MB
/releases/19.07.3/targets/oxnas/ox820/openwrt-19.07.3-oxnas-ox820-shuttle_kd20-squashfs-sysupgrade.tar;2;0;2;5.65 MB;2.83 MB
/releases/18.06.3/targets/oxnas/ox820/openwrt-18.06.3-oxnas-ox820-cloudengines-pogoplug-pro-squashfs-sysupgrade.tar;2;0;2;4.84 MB;2.42 MB
/releases/18.06.2/targets/archs38/generic/openwrt-18.06.2-archs38-generic-Default-sdcard-vfat-ext4.img.gz;2;0;2;11.84 MB;5.92 MB
/releases/17.01.1/targets/sunxi/generic/lede-17.01.1-sunxi-sun4i-a10-cubieboard-squashfs-sdcard.img.gz;2;0;2;223.50 KB;111.75 KB
/releases/18.06.2/targets/sunxi/cortexa7/openwrt-18.06.2-sunxi-cortexa7-sun7i-a20-olinuxino-lime2-ext4-sdcard.img.gz;2;0;2;5.56 MB;2.78 MB
/releases/18.06.4/targets/brcm2708/bcm2709/openwrt-18.06.4-brcm2708-bcm2709-rpi-2-ext4-factory.img.gz;2;0;2;17.71 MB;8.86 MB
/releases/19.07.1/targets/x86/geode/openwrt-19.07.1-x86-geode-rootfs-squashfs.img.gz;2;0;2;3.95 MB;1.98 MB
/releases/18.06.3/targets/sunxi/cortexa53/openwrt-18.06.3-sunxi-cortexa53-sun50i-h5-nanopi-neo-plus2-squashfs-sdcard.img.gz;2;0;2;5.77 MB;2.89 MB
/releases/18.06.5/targets/x86/geode/openwrt-18.06.5-x86-geode-rootfs-ext4.img.gz;2;0;2;4.78 MB;2.39 MB
/releases/19.07.1/targets/oxnas/ox820/openwrt-19.07.1-oxnas-ox820-shuttle_kd20-factory.tar.gz;2;0;2;7.44 MB;3.72 MB
/releases/17.01.0/targets/sunxi/generic/lede-17.01.0-r3205-59508e3-sunxi-sun5i-a13-olimex-som-ext4-sdcard.img.gz;2;0;2;335.50 KB;167.75 KB
/releases/17.01.3/targets/apm821xx/nand/lede-17.01.3-apm821xx-nand-mr24-squashfs-sysupgrade.tar;2;0;2;3.70 MB;1.85 MB
/releases/18.06.6/targets/oxnas/ox820/openwrt-18.06.6-oxnas-ox820-cloudengines-pogoplug-pro-squashfs-sysupgrade.tar;2;0;2;4.85 MB;2.43 MB
/releases/18.06.6/targets/sunxi/cortexa7/openwrt-18.06.6-sunxi-cortexa7-sun8i-h2-plus-orangepi-r1-squashfs-sdcard.img.gz;2;0;2;4.61 MB;2.31 MB
/releases/17.01.0/targets/sunxi/generic/lede-17.01.0-r3205-59508e3-sunxi-sun7i-a20-olinuxino-micro-ext4-sdcard.img.gz;2;0;2;319.50 KB;159.75 KB
/releases/18.06.4/targets/at91/legacy/openwrt-18.06.4-at91-legacy-lmu5000-ext4-factory.bin.gz;2;0;2;5.65 MB;2.82 MB
/releases/18.06.6/targets/at91/legacy/openwrt-18.06.6-at91-legacy-usb_a9263-ext4-factory.bin.gz;2;0;2;5.64 MB;2.82 MB
/releases/18.06.4/targets/omap/generic/openwrt-18.06.4-omap-am335x-evm-ext4-sdcard.img.gz;2;0;2;5.99 MB;3.00 MB
/releases/17.01.4/targets/oxnas/generic/lede-17.01.4-oxnas-pogoplug-v3-ubifs-sysupgrade.tar;2;0;2;207.50 KB;103.75 KB
/releases/18.06.2/targets/brcm2708/bcm2709/openwrt-18.06.2-brcm2708-bcm2709-rpi-2-ext4-factory.img.gz;2;0;2;9.08 MB;4.54 MB
/releases/19.07.3/targets/sunxi/cortexa7/openwrt-19.07.3-sunxi-cortexa7-sun8i-h3-orangepi-pc-squashfs-sdcard.img.gz;2;0;2;4.83 MB;2.42 MB
/releases/18.06.1/targets/brcm63xx/smp/openwrt-18.06.1-brcm63xx-smp-livebox-vmlinux.gz;2;0;2;2.16 MB;1.08 MB
/releases/18.06.4/targets/at91/legacy/openwrt-18.06.4-at91-legacy-usb_a9260-ext4-factory.bin.gz;2;0;2;5.78 MB;2.89 MB
/releases/18.06.7/targets/x86/legacy/openwrt-18.06.7-x86-legacy-combined-squashfs.img.gz;2;0;2;1.83 MB;935.54 KB
/releases/18.06.6/targets/sunxi/cortexa8/openwrt-18.06.6-sunxi-cortexa8-sun4i-a10-marsboard-ext4-sdcard.img.gz;2;0;2;5.39 MB;2.69 MB
/releases/18.06.5/targets/at91/sama5d2/openwrt-18.06.5-at91-sama5d2-at91-sama5d27_som1_ek-ext4-zImage.gz;2;0;2;3.22 MB;1.61 MB
/releases/17.01.1/targets/sunxi/generic/lede-17.01.1-sunxi-sun7i-a20-pcduino3-ext4-sdcard.img.gz;2;0;2;319.50 KB;159.75 KB
/releases/17.01.5/targets/gemini/raidsonic/lede-17.01.5-gemini-raidsonic-nas4220-rd.gz;2;0;2;4.23 MB;2.12 MB
/releases/18.06.2/targets/at91/legacy/openwrt-18.06.2-at91-legacy-tny_a9260-ext4-factory.bin.gz;2;0;2;5.54 MB;2.77 MB
/releases/19.07.0-rc1/targets/mvebu/cortexa9/openwrt-19.07.0-rc1-mvebu-cortexa9-solidrun_clearfog-pro-a1-squashfs-sdcard.img.gz;2;0;2;4.93 MB;2.47 MB
/releases/18.06.5/targets/oxnas/ox820/openwrt-18.06.5-oxnas-ox820-mitrastar-stg212-squashfs-sysupgrade.tar;2;0;2;4.98 MB;2.49 MB
/snapshots/faillogs/i386_pentium4/packages/node/host-compile.txt;2;0;2;4.01 MB;2.01 MB
/releases/18.06.1/targets/apm821xx/nand/openwrt-18.06.1-apm821xx-nand-meraki_mr24-squashfs-sysupgrade.tar;2;0;2;8.34 MB;4.17 MB
/releases/19.07.2/targets/at91/sam9x/openwrt-19.07.2-at91-sam9x-at91sam9g20ek-ext4-root.ubi.gz;2;0;2;2.64 MB;1.32 MB
/releases/19.07.0/targets/pistachio/generic/openwrt-19.07.0-pistachio-rootfs.tar.gz;2;0;2;3.99 MB;1.99 MB
/releases/18.06.6/targets/sunxi/cortexa7/openwrt-18.06.6-sunxi-cortexa7-sun8i-h3-orangepi-plus-squashfs-sdcard.img.gz;2;0;2;4.76 MB;2.38 MB
/releases/18.06.0/targets/apm821xx/nand/openwrt-18.06.0-apm821xx-nand-meraki_mr24-squashfs-sysupgrade.tar;2;0;2;8.34 MB;4.17 MB
/releases/18.06.3/targets/mvebu/cortexa9/openwrt-18.06.3-mvebu-cortexa9-turris-omnia-sysupgrade.img.gz;2;0;2;5.34 MB;2.67 MB
/releases/19.07.3/targets/x86/geode/openwrt-19.07.3-x86-geode-rootfs-squashfs.img.gz;2;0;2;3.86 MB;1.93 MB
/releases/17.01.0-rc2/targets/kirkwood/generic/lede-17.01.0-rc2-r3131-42f3c1f-kirkwood-goflexhome-squashfs-sysupgrade.tar;2;0;2;351.49 KB;175.75 KB
/releases/17.01.7/targets/ipq806x/generic/lede-17.01.7-ipq806x-R7800-squashfs-sysupgrade.tar;2;0;2;1.06 MB;543.75 KB
/releases/19.07.3/targets/sunxi/cortexa7/openwrt-19.07.3-sunxi-cortexa7-sun8i-h3-orangepi-one-squashfs-sdcard.img.gz;2;0;2;4.82 MB;2.41 MB
/releases/18.06.5/targets/sunxi/cortexa7/openwrt-18.06.5-sunxi-cortexa7-sun7i-a20-bananapro-ext4-sdcard.img.gz;2;0;2;6.20 MB;3.10 MB
/releases/18.06.3/targets/at91/legacy/openwrt-18.06.3-at91-legacy-at91sam9g25ek-ext4-root.ubi.gz;2;0;2;2.51 MB;1.26 MB
/releases/17.01.6/targets/ar71xx/nand/lede-17.01.6-ar71xx-nand-wndr4300-squashfs-sysupgrade.tar;2;0;2;4.65 MB;2.33 MB
/releases/19.07.1/targets/at91/sama5/openwrt-19.07.1-at91-sama5-at91-sama5d27_som1_ek-ext4-sdcard.img.gz;2;0;2;6.20 MB;3.10 MB
/releases/18.06.7/targets/rb532/generic/openwrt-18.06.7-rb532-default-rootfs.tar.gz;2;0;2;2.89 MB;1.44 MB
/releases/18.06.6/targets/at91/sama5d3/openwrt-18.06.6-at91-sama5d3-at91-sama5d3_xplained-ext4-root.ubi.gz;2;0;2;2.50 MB;1.25 MB
/releases/19.07.3/targets/oxnas/ox820/openwrt-19.07.3-oxnas-ox820-shuttle_kd20-ubifs-sysupgrade.tar;2;0;2;9.31 MB;4.65 MB
/releases/18.06.6/targets/sunxi/cortexa7/openwrt-18.06.6-sunxi-cortexa7-sun8i-h3-nanopi-m1-plus-ext4-sdcard.img.gz;2;0;2;6.68 MB;3.34 MB
/releases/17.01.2/targets/archs38/generic/lede-17.01.2-archs38-generic-root.ext4.gz;2;0;2;2.71 MB;1.35 MB
/releases/18.06.0/targets/at91/sama5d2/openwrt-18.06.0-at91-sama5d2-rootfs.tar.gz;2;0;2;2.12 MB;1.06 MB
/releases/17.01.1/targets/oxnas/generic/lede-17.01.1-oxnas-stg212-ubifs-sysupgrade.tar;2;0;2;607.50 KB;303.75 KB
/releases/19.07.2/targets/sunxi/cortexa8/openwrt-19.07.2-sunxi-cortexa8-sun5i-a13-olinuxino-squashfs-sdcard.img.gz;2;0;2;10.22 MB;5.11 MB
/releases/17.01.5/targets/brcm63xx/generic/lede-17.01.5-brcm63xx-generic-livebox-vmlinux.gz;2;0;2;1.89 MB;967.87 KB
/releases/17.01.5/targets/sunxi/generic/lede-17.01.5-sunxi-sun7i-a20-cubieboard2-squashfs-sdcard.img.gz;2;0;2;4.15 MB;2.08 MB
/releases/18.06.0/targets/at91/sama5d3/openwrt-18.06.0-at91-sama5d3-at91-sama5d3_xplained-ext4-root.ubi.gz;2;0;2;2.49 MB;1.24 MB
/releases/17.01.4/targets/sunxi/generic/lede-17.01.4-sunxi-sun7i-a20-bananapi-ext4-sdcard.img.gz;2;0;2;207.50 KB;103.75 KB
/releases/19.07.0/targets/oxnas/ox820/openwrt-19.07.0-oxnas-ox820-cloudengines_pogoplug-series-3-squashfs-sysupgrade.tar;2;0;2;5.03 MB;2.51 MB
/releases/18.06.2/targets/oxnas/ox820/openwrt-18.06.2-oxnas-ox820-cloudengines-pogoplug-series-3-squashfs-sysupgrade.tar;2;0;2;1.44 MB;735.54 KB
/releases/18.06.2/targets/sunxi/cortexa8/openwrt-18.06.2-sunxi-cortexa8-sun4i-a10-olinuxino-lime-ext4-sdcard.img.gz;2;0;2;5.40 MB;2.70 MB
/releases/17.01.1/targets/imx6/generic/lede-17.01.1-imx6-rootfs.tar.gz;2;0;2;431.50 KB;215.75 KB
/releases/17.01.5/targets/rb532/generic/lede-17.01.5-rb532-default-rootfs.tar.gz;2;0;2;3.40 MB;1.70 MB
/releases/18.06.2/targets/sunxi/cortexa53/openwrt-18.06.2-sunxi-cortexa53-sun50i-a64-sopine-baseboard-squashfs-sdcard.img.gz;2;0;2;5.90 MB;2.95 MB
/releases/17.01.2/targets/kirkwood/generic/lede-17.01.2-kirkwood-linksys-audi-squashfs-sysupgrade.tar;2;0;2;4.01 MB;2.01 MB
/releases/17.01.5/targets/kirkwood/generic/lede-17.01.5-kirkwood-linksys-viper-squashfs-sysupgrade.tar;2;0;2;6.89 MB;3.45 MB
/releases/19.07.1/targets/rb532/generic/openwrt-19.07.1-rb532-default-rootfs.tar.gz;2;0;2;3.74 MB;1.87 MB
/releases/19.07.2/targets/sunxi/cortexa8/openwrt-19.07.2-sunxi-cortexa8-sun4i-a10-olinuxino-lime-ext4-sdcard.img.gz;2;0;2;11.15 MB;5.58 MB
/releases/18.06.3/targets/sunxi/cortexa53/openwrt-18.06.3-sunxi-cortexa53-sun50i-a64-pine64-plus-squashfs-sdcard.img.gz;2;0;2;5.77 MB;2.89 MB
/releases/17.01.0-rc2/targets/x86/64/lede-17.01.0-rc2-r3131-42f3c1f-x86-64-combined-ext4.img.gz;2;4;6;6.55 MB;1.09 MB
/releases/17.01.5/targets/oxnas/generic/lede-17.01.5-oxnas-kd20-factory.tar.gz;2;0;2;4.64 MB;2.32 MB
/releases/19.07.0-rc1/targets/oxnas/ox820/openwrt-19.07.0-rc1-oxnas-ox820-mitrastar_stg-212-squashfs-sysupgrade.tar;2;0;2;5.60 MB;2.80 MB
/releases/19.07.2/targets/at91/sama5/openwrt-19.07.2-at91-sama5-at91-sama5d3_xplained-ext4-zImage.gz;2;0;2;3.65 MB;1.83 MB
/releases/18.06.5/targets/at91/legacy/openwrt-18.06.5-at91-legacy-at91sam9g20ek_2mmc-ext4-zImage.gz;2;0;2;3.25 MB;1.63 MB
/releases/18.06.2/targets/sunxi/cortexa8/openwrt-18.06.2-sunxi-cortexa8-sun4i-a10-marsboard-squashfs-sdcard.img.gz;2;0;2;4.66 MB;2.33 MB
/releases/18.06.6/targets/oxnas/ox820/openwrt-18.06.6-oxnas-ox820-cloudengines-pogoplug-pro-ubifs-sysupgrade.tar;2;0;2;7.96 MB;3.98 MB
/releases/17.01.5/targets/x86/64/lede-17.01.5-x86-64-generic-rootfs.tar.gz;2;0;2;2.93 MB;1.46 MB
/releases/18.06.6/targets/at91/sama5d2/openwrt-18.06.6-at91-sama5d2-at91-sama5d27_som1_ek-ext4-root.ubi.gz;2;0;2;2.65 MB;1.33 MB
/releases/19.07.3/targets/sunxi/cortexa7/openwrt-19.07.3-sunxi-cortexa7-sun7i-a20-olinuxino-lime2-squashfs-sdcard.img.gz;2;0;2;5.33 MB;2.66 MB
/releases/17.01.0/targets/kirkwood/generic/lede-17.01.0-r3205-59508e3-kirkwood-pogo_e02-squashfs-sysupgrade.tar;2;0;2;3.25 MB;1.62 MB
/releases/18.06.3/targets/at91/legacy/openwrt-18.06.3-at91-legacy-at91sam9x35ek-ext4-root.ubi.gz;2;0;2;2.51 MB;1.26 MB
/releases/18.06.6/targets/at91/legacy/openwrt-18.06.6-at91-legacy-tny_a9g20-ext4-factory.bin.gz;2;0;2;5.64 MB;2.82 MB
/releases/19.07.2/targets/sunxi/cortexa7/openwrt-19.07.2-sunxi-cortexa7-sun7i-a20-cubietruck-squashfs-sdcard.img.gz;2;0;2;10.90 MB;5.45 MB
/releases/18.06.0-rc2/targets/pistachio/generic/openwrt-18.06.0-rc2-pistachio-marduk-squashfs-sysupgrade.tar;2;0;2;7.03 MB;3.52 MB
/releases/18.06.3/targets/sunxi/cortexa53/openwrt-18.06.3-sunxi-cortexa53-sun50i-a64-pine64-plus-ext4-sdcard.img.gz;2;0;2;6.55 MB;3.27 MB
/releases/18.06.0-rc1/targets/apm821xx/nand/openwrt-18.06.0-rc1-apm821xx-nand-meraki_mr24-squashfs-sysupgrade.tar;2;0;2;7.51 MB;3.76 MB
/releases/18.06.0/targets/sunxi/cortexa7/openwrt-18.06.0-sunxi-cortexa7-sun7i-a20-bananapi-squashfs-sdcard.img.gz;2;0;2;4.63 MB;2.31 MB
/releases/18.06.5/targets/sunxi/cortexa7/openwrt-18.06.5-sunxi-cortexa7-sun7i-a20-pcduino3-ext4-sdcard.img.gz;2;0;2;5.93 MB;2.96 MB
/releases/18.06.0/targets/sunxi/cortexa7/openwrt-18.06.0-sunxi-cortexa7-sun7i-a20-bananapi-ext4-sdcard.img.gz;2;0;2;5.44 MB;2.72 MB
/releases/17.01.5/targets/sunxi/generic/lede-17.01.5-sunxi-sun8i-h3-orangepi-plus-ext4-sdcard.img.gz;2;0;2;4.84 MB;2.42 MB
/releases/18.06.1/targets/at91/legacy/openwrt-18.06.1-at91-legacy-at91sam9x25ek-ext4-root.ubi.gz;2;0;2;2.49 MB;1.24 MB
/releases/18.06.4/targets/at91/legacy/openwrt-18.06.4-at91-legacy-at91sam9x35ek-ext4-root.ubi.gz;2;0;2;2.51 MB;1.26 MB
/releases/18.06.3/targets/at91/legacy/openwrt-18.06.3-at91-legacy-usb_a9g20-ext4-factory.bin.gz;2;0;2;5.64 MB;2.82 MB
/releases/18.06.0/targets/oxnas/ox820/openwrt-18.06.0-oxnas-ox820-mitrastar-stg212-ubifs-sysupgrade.tar;2;0;2;8.29 MB;4.15 MB
/releases/18.06.0/targets/gemini/generic/openwrt-18.06.0-gemini-sysupgrade-ib4220b.tar.gz;2;0;2;10.47 MB;5.24 MB
/releases/18.06.6/targets/mxs/generic/openwrt-18.06.6-mxs-duckbill-sdcard.img.gz;2;0;2;11.22 MB;5.61 MB
/releases/18.06.5/targets/sunxi/cortexa7/openwrt-18.06.5-sunxi-cortexa7-sun8i-h3-orangepi-2-squashfs-sdcard.img.gz;2;0;2;4.60 MB;2.30 MB
/releases/17.01.5/targets/sunxi/generic/lede-17.01.5-sunxi-sun7i-a20-olinuxino-lime-squashfs-sdcard.img.gz;2;0;2;4.14 MB;2.07 MB
/releases/19.07.0/targets/mvebu/cortexa53/openwrt-19.07.0-mvebu-cortexa53-globalscale_espressobin-v7-squashfs-sdcard.img.gz;2;0;2;11.11 MB;5.56 MB
/releases/17.01.5/targets/sunxi/generic/lede-17.01.5-sunxi-sun7i-a20-bananapro-ext4-sdcard.img.gz;2;0;2;5.64 MB;2.82 MB
/releases/19.07.0-rc2/targets/brcm2708/bcm2708/openwrt-19.07.0-rc2-brcm2708-bcm2708-rpi-squashfs-factory.img.gz;2;0;2;10.50 MB;5.25 MB
/releases/19.07.1/targets/at91/sama5/openwrt-19.07.1-at91-sama5-at91-sama5d2_xplained-ext4-sdcard.img.gz;2;0;2;6.08 MB;3.04 MB
/releases/18.06.5/targets/at91/sama5d2/openwrt-18.06.5-at91-sama5d2-at91-sama5d2_xplained-ext4-root.ubi.gz;2;0;2;2.50 MB;1.25 MB
/releases/18.06.3/targets/x86/64/openwrt-18.06.3-x86-64-rootfs-squashfs.img.gz;2;0;2;2.53 MB;1.26 MB
/releases/18.06.6/targets/sunxi/cortexa7/openwrt-18.06.6-sunxi-cortexa7-sun7i-a20-bananapi-squashfs-sdcard.img.gz;2;0;2;4.63 MB;2.32 MB
/releases/17.01.5/targets/apm821xx/nand/lede-17.01.5-apm821xx-nand-mx60w-squashfs-sysupgrade.tar;2;0;2;7.56 MB;3.78 MB
/releases/19.07.0-rc1/targets/oxnas/ox820/openwrt-19.07.0-rc1-oxnas-ox820-cloudengines_pogoplugpro-ubifs-sysupgrade.tar;2;0;2;9.43 MB;4.71 MB
/releases/18.06.2/targets/at91/sama5d2/openwrt-18.06.2-at91-sama5d2-at91-sama5d2_ptc_ek-ext4-root.ubi.gz;2;0;2;2.59 MB;1.29 MB
/releases/17.01.2/targets/oxnas/generic/lede-17.01.2-oxnas-pogoplug-v3-squashfs-sysupgrade.tar;2;0;2;351.50 KB;175.75 KB
/releases/18.06.3/targets/brcm2708/bcm2708/openwrt-18.06.3-brcm2708-bcm2708-rpi-squashfs-sysupgrade.img.gz;2;0;2;7.94 MB;3.97 MB
/releases/17.01.5/targets/kirkwood/generic/lede-17.01.5-kirkwood-ib62x0-squashfs-sysupgrade.tar;2;0;2;6.50 MB;3.25 MB
/releases/18.06.0/targets/oxnas/ox820/openwrt-18.06.0-oxnas-ox820-cloudengines-pogoplug-pro-ubifs-sysupgrade.tar;2;0;2;7.94 MB;3.97 MB
/releases/19.07.3/targets/sunxi/cortexa7/openwrt-19.07.3-sunxi-cortexa7-sun7i-a20-bananapro-ext4-sdcard.img.gz;2;0;2;6.47 MB;3.23 MB
/releases/19.07.2/targets/at91/sama5/openwrt-19.07.2-at91-sama5-at91-sama5d4_xplained-ext4-root.ubi.gz;2;0;2;2.57 MB;1.28 MB
/releases/17.01.0/targets/kirkwood/generic/lede-17.01.0-r3205-59508e3-kirkwood-goflexhome-squashfs-sysupgrade.tar;2;0;2;2.89 MB;1.45 MB
/releases/19.07.3/targets/oxnas/ox820/openwrt-19.07.3-oxnas-ox820-cloudengines_pogoplugpro-squashfs-sysupgrade.tar;2;0;2;5.65 MB;2.83 MB
/releases/18.06.5/targets/sunxi/cortexa53/openwrt-18.06.5-sunxi-cortexa53-sun50i-a64-pine64-plus-ext4-sdcard.img.gz;2;0;2;6.55 MB;3.27 MB
/releases/18.06.3/targets/at91/legacy/openwrt-18.06.3-at91-legacy-at91sam9g20ek-ext4-zImage.gz;2;0;2;3.24 MB;1.62 MB
/releases/17.01.1/targets/oxnas/generic/lede-17.01.1-oxnas-akitio-ubifs-sysupgrade.tar;2;0;2;319.50 KB;159.75 KB
/releases/18.06.0-rc2/targets/octeon/generic/openwrt-18.06.0-rc2-octeon-er-squashfs-sysupgrade.tar;2;0;2;12.23 MB;6.11 MB
/releases/18.06.5/targets/at91/legacy/openwrt-18.06.5-at91-legacy-tny_a9263-ext4-factory.bin.gz;2;0;2;5.62 MB;2.81 MB
/releases/18.06.2/targets/armvirt/32/openwrt-18.06.2-armvirt-32-default-rootfs.tar.gz;2;0;2;3.70 MB;1.85 MB
/releases/19.07.1/targets/omap/generic/openwrt-19.07.1-omap-ti_omap3-beagle-ext4-sdcard.img.gz;2;0;2;6.83 MB;3.42 MB
/releases/18.06.1/targets/at91/legacy/openwrt-18.06.1-at91-legacy-at91sam9263ek-ext4-root.ubi.gz;2;0;2;2.50 MB;1.25 MB
/releases/18.06.3/targets/sunxi/cortexa7/openwrt-18.06.3-sunxi-cortexa7-sun7i-a20-cubieboard2-squashfs-sdcard.img.gz;2;0;2;4.68 MB;2.34 MB
/releases/17.01.4/targets/sunxi/generic/lede-17.01.4-sunxi-sun7i-a20-lamobo-r1-ext4-sdcard.img.gz;2;0;2;607.50 KB;303.75 KB
/releases/18.06.2/targets/armvirt/64/openwrt-18.06.2-armvirt-64-rootfs.cpio.gz;2;0;2;40 Bytes;20 Bytes
/releases/19.07.2/targets/at91/sam9x/openwrt-19.07.2-at91-sam9x-at91sam9x35ek-ext4-root.ubi.gz;2;0;2;2.64 MB;1.32 MB
/releases/18.06.2/targets/at91/legacy/openwrt-18.06.2-at91-legacy-at91sam9263ek-ext4-zImage.gz;2;0;2;3.24 MB;1.62 MB
/releases/19.07.0-rc1/targets/mvebu/cortexa53/openwrt-19.07.0-rc1-mvebu-cortexa53-marvell_armada-3720-db-ext4-sdcard.img.gz;2;0;2;6.45 MB;3.23 MB
/releases/18.06.7/targets/sunxi/cortexa8/openwrt-18.06.7-sunxi-cortexa8-sun5i-a13-olinuxino-squashfs-sdcard.img.gz;2;0;2;6.54 MB;3.27 MB
/releases/18.06.0/targets/sunxi/cortexa7/openwrt-18.06.0-sunxi-cortexa7-sun7i-a20-olinuxino-lime2-emmc-ext4-sdcard.img.gz;2;0;2;5.55 MB;2.77 MB
/releases/18.06.6/targets/sunxi/cortexa7/openwrt-18.06.6-sunxi-cortexa7-sun8i-h3-orangepi-pc-squashfs-sdcard.img.gz;2;0;2;4.59 MB;2.30 MB
/releases/19.07.3/targets/sunxi/cortexa7/openwrt-19.07.3-sunxi-cortexa7-sun7i-a20-bananapi-ext4-sdcard.img.gz;2;0;2;5.72 MB;2.86 MB
/releases/18.06.3/targets/sunxi/cortexa8/openwrt-18.06.3-sunxi-cortexa8-sun4i-a10-pcduino-squashfs-sdcard.img.gz;2;0;2;4.89 MB;2.45 MB
/releases/17.01.0-rc1/targets/mvebu/generic/lede-17.01.0-rc1-r3042-ec095b5-mvebu-armada-388-clearfog-sdcard.img.gz;2;0;2;383.49 KB;191.75 KB
/releases/17.01.0-rc2/targets/sunxi/generic/lede-17.01.0-rc2-r3131-42f3c1f-sunxi-sun7i-a20-olinuxino-micro-squashfs-sdcard.img.gz;2;0;2;2.62 MB;1.31 MB
/releases/19.07.0/targets/archs38/generic/openwrt-19.07.0-archs38-generic-Default-sdcard-vfat-ext4.img.gz;2;0;2;11.55 MB;5.77 MB
/releases/17.01.1/targets/mvebu/generic/lede-17.01.1-mvebu-armada-388-clearfog-sdcard.img.gz;2;0;2;4.24 MB;2.12 MB
/releases/19.07.3/targets/sunxi/cortexa53/openwrt-19.07.3-sunxi-cortexa53-sun50i-a64-pine64-plus-ext4-sdcard.img.gz;2;0;2;7.02 MB;3.51 MB
/releases/18.06.5/targets/sunxi/cortexa7/openwrt-18.06.5-sunxi-cortexa7-sun7i-a20-pcduino3-squashfs-sdcard.img.gz;2;0;2;5.13 MB;2.57 MB
/releases/19.07.1/targets/oxnas/ox820/openwrt-19.07.1-oxnas-ox820-mitrastar_stg-212-ubifs-sysupgrade.tar;2;0;2;9.18 MB;4.59 MB
/releases/18.06.2/targets/sunxi/cortexa7/openwrt-18.06.2-sunxi-cortexa7-sun7i-a20-olinuxino-lime2-emmc-ext4-sdcard.img.gz;2;0;2;5.55 MB;2.77 MB
/snapshots/faillogs/arm_xscale/packages/node/host-compile.txt;2;0;2;4.02 MB;2.01 MB
/releases/17.01.5/targets/x86/generic/lede-17.01.5-x86-generic-combined-ext4.img.gz;2;0;2;7.05 MB;3.53 MB
/releases/19.07.2/targets/sunxi/cortexa7/openwrt-19.07.2-sunxi-cortexa7-sun8i-h3-orangepi-pc-squashfs-sdcard.img.gz;2;0;2;9.53 MB;4.77 MB
/releases/18.06.3/targets/omap/generic/openwrt-18.06.3-omap-rootfs.tar.gz;2;0;2;2.09 MB;1.05 MB
/snapshots/faillogs/arm_mpcore_vfp/packages/perl-parse-recdescent/host-compile.txt;2;0;2;944 Bytes;472 Bytes
/releases/18.06.3/targets/sunxi/cortexa53/openwrt-18.06.3-sunxi-cortexa53-sun50i-a64-sopine-baseboard-ext4-sdcard.img.gz;2;0;2;6.55 MB;3.27 MB
/releases/18.06.3/targets/sunxi/cortexa8/openwrt-18.06.3-sunxi-cortexa8-sun4i-a10-olinuxino-lime-ext4-sdcard.img.gz;2;0;2;5.41 MB;2.70 MB
/releases/18.06.6/targets/sunxi/cortexa8/openwrt-18.06.6-sunxi-cortexa8-sun5i-a13-olinuxino-squashfs-sdcard.img.gz;2;0;2;4.93 MB;2.46 MB
/releases/19.07.3/targets/pistachio/generic/openwrt-19.07.3-pistachio-marduk-squashfs-sysupgrade.tar;2;0;2;9.67 MB;4.83 MB
/releases/19.07.1/targets/x86/legacy/openwrt-19.07.1-x86-legacy-combined-ext4.img.gz;2;0;2;7.03 MB;3.52 MB
/releases/18.06.1/targets/at91/legacy/openwrt-18.06.1-at91-legacy-ethernut5-ext4-root.ubi.gz;2;0;2;2.49 MB;1.24 MB
/releases/17.01.1/targets/apm821xx/nand/lede-17.01.1-apm821xx-nand-mx60w-squashfs-sysupgrade.tar;2;0;2;4.32 MB;2.16 MB
/releases/17.01.5/targets/sunxi/generic/lede-17.01.5-sunxi-sun4i-a10-cubieboard-ext4-sdcard.img.gz;2;0;2;4.83 MB;2.42 MB
/releases/18.06.0-rc1/targets/apm821xx/nand/openwrt-18.06.0-rc1-apm821xx-nand-netgear_wndr4700-squashfs-sysupgrade.tar;2;0;2;8.49 MB;4.25 MB
/releases/18.06.5/targets/mvebu/cortexa9/openwrt-18.06.5-mvebu-cortexa9-armada-388-clearfog-base-squashfs-sdcard.img.gz;2;0;2;4.67 MB;2.33 MB
/releases/18.06.4/targets/at91/legacy/openwrt-18.06.4-at91-legacy-at91sam9g35ek-ext4-root.ubi.gz;2;0;2;2.51 MB;1.26 MB
/releases/18.06.2/targets/at91/legacy/openwrt-18.06.2-at91-legacy-tny_a9263-ext4-factory.bin.gz;2;0;2;5.62 MB;2.81 MB
/releases/17.01.1/targets/x86/64/lede-17.01.1-x86-64-generic-rootfs.tar.gz;2;0;2;2.42 MB;1.21 MB
/releases/19.07.0-rc2/targets/at91/sama5/openwrt-19.07.0-rc2-at91-sama5-at91-sama5d2_ptc_ek-ext4-root.ubi.gz;2;0;2;2.74 MB;1.37 MB
/releases/18.06.0/targets/at91/sama5d2/openwrt-18.06.0-at91-sama5d2-at91-sama5d27_som1_ek-ext4-root.ubi.gz;2;0;2;2.49 MB;1.24 MB
/releases/18.06.6/targets/omap/generic/openwrt-18.06.6-omap-rootfs.tar.gz;2;0;2;2.09 MB;1.05 MB
/releases/18.06.6/targets/omap/generic/openwrt-18.06.6-omap-am335x-evm-ext4-sdcard.img.gz;2;0;2;6.00 MB;3.00 MB
/releases/18.06.0-rc2/targets/brcm2708/bcm2710/openwrt-18.06.0-rc2-brcm2708-bcm2710-rpi-3-squashfs-sdcard.img.gz;2;0;2;1.39 MB;711.54 KB
/releases/18.06.1/targets/at91/sama5d3/openwrt-18.06.1-at91-sama5d3-at91-sama5d3_xplained-ext4-zImage.gz;2;0;2;3.17 MB;1.59 MB
/releases/18.06.0/targets/at91/sama5d4/openwrt-18.06.0-at91-sama5d4-at91-sama5d4_xplained-ext4-sdcard.img.gz;2;0;2;5.69 MB;2.85 MB
/releases/18.06.2/targets/at91/legacy/openwrt-18.06.2-at91-legacy-lmu5000-ext4-factory.bin.gz;2;0;2;5.64 MB;2.82 MB
/releases/19.07.2/targets/gemini/generic/openwrt-19.07.2-gemini-itian_sq201-ext4-factory.bin.gz;2;0;2;8.82 MB;4.41 MB
/releases/19.07.1/targets/sunxi/cortexa7/openwrt-19.07.1-sunxi-cortexa7-sun8i-h2-plus-orangepi-r1-squashfs-sdcard.img.gz;2;0;2;4.91 MB;2.46 MB
/releases/18.06.6/targets/sunxi/cortexa8/openwrt-18.06.6-sunxi-cortexa8-sun4i-a10-cubieboard-ext4-sdcard.img.gz;2;0;2;5.55 MB;2.78 MB
/releases/18.06.3/targets/sunxi/cortexa8/openwrt-18.06.3-sunxi-cortexa8-sun4i-a10-pcduino-ext4-sdcard.img.gz;2;0;2;5.85 MB;2.93 MB
/releases/18.06.2/targets/at91/legacy/openwrt-18.06.2-at91-legacy-at91sam9g25ek-ext4-root.ubi.gz;2;0;2;2.51 MB;1.26 MB
/releases/18.06.5/targets/oxnas/ox820/openwrt-18.06.5-oxnas-ox820-akitio-mycloud-squashfs-sysupgrade.tar;2;0;2;5.00 MB;2.50 MB
/releases/18.06.6/targets/ar71xx/nand/openwrt-18.06.6-ar71xx-nand-rambutan-squashfs-sysupgrade.tar;2;0;2;3.96 MB;1.98 MB
/releases/19.07.1/targets/x86/legacy/openwrt-19.07.1-x86-legacy-rootfs-squashfs.img.gz;2;0;2;2.57 MB;1.29 MB
/releases/19.07.3/targets/arc770/generic/openwrt-19.07.3-arc770-generic-Default-sdcard-vfat-ext4.img.gz;2;0;2;6.12 MB;3.06 MB
/snapshots/faillogs/mipsel_24kc_24kf/packages/glib2/host-compile.txt;2;0;2;221.72 KB;110.86 KB
/releases/19.07.0-rc1/targets/sunxi/cortexa7/openwrt-19.07.0-rc1-sunxi-cortexa7-sun7i-a20-olinuxino-lime-ext4-sdcard.img.gz;2;0;2;11.25 MB;5.62 MB
/releases/18.06.0/targets/sunxi/cortexa7/openwrt-18.06.0-sunxi-cortexa7-sun8i-h2-plus-orangepi-r1-ext4-sdcard.img.gz;2;0;2;5.56 MB;2.78 MB
/releases/17.01.4/targets/sunxi/generic/lede-17.01.4-sunxi-sun5i-a13-olimex-som-squashfs-sdcard.img.gz;2;0;2;383.50 KB;191.75 KB
/releases/19.07.2/targets/oxnas/ox820/openwrt-19.07.2-oxnas-ox820-akitio_mycloud-ubifs-sysupgrade.tar;2;0;2;1.44 MB;735.54 KB
/releases/19.07.1/targets/sunxi/cortexa8/openwrt-19.07.1-sunxi-cortexa8-sun5i-a13-olinuxino-squashfs-sdcard.img.gz;2;0;2;5.24 MB;2.62 MB
/releases/18.06.3/targets/at91/sama5d2/openwrt-18.06.3-at91-sama5d2-at91-sama5d27_som1_ek-ext4-sdcard.img.gz;2;0;2;5.70 MB;2.85 MB
/releases/19.07.1/targets/brcm63xx/generic/openwrt-19.07.1-brcm63xx-generic-livebox-vmlinux.gz;2;0;2;2.44 MB;1.22 MB
/releases/18.06.1/targets/brcm2708/bcm2708/openwrt-18.06.1-brcm2708-bcm2708-rpi-squashfs-sysupgrade.img.gz;2;0;2;11.33 MB;5.67 MB
/releases/17.01.0/targets/archs38/generic/lede-17.01.0-r3205-59508e3-archs38-generic-Default-sdcard-vfat-ext4.img.gz;2;0;2;5.37 MB;2.68 MB
/releases/18.06.3/targets/omap/generic/openwrt-18.06.3-omap-am335x-boneblack-ext4-sdcard.img.gz;2;0;2;5.94 MB;2.97 MB
/releases/18.06.0-rc1/targets/ar71xx/nand/openwrt-18.06.0-rc1-ar71xx-nand-wi2a-ac200i-squashfs-sysupgrade.tar;2;0;2;7.02 MB;3.51 MB
/releases/17.01.0-rc2/targets/sunxi/generic/lede-17.01.0-rc2-r3131-42f3c1f-sunxi-sun7i-a20-bananapro-squashfs-sdcard.img.gz;2;0;2;2.62 MB;1.31 MB
/releases/18.06.5/targets/sunxi/cortexa53/openwrt-18.06.5-sunxi-cortexa53-sun50i-a64-pine64-plus-squashfs-sdcard.img.gz;2;0;2;5.77 MB;2.89 MB
/releases/19.07.2/targets/gemini/generic/openwrt-19.07.2-gemini-dlink_dns-313-ext4-factory.bin.gz;2;0;2;17.01 MB;8.51 MB
/releases/18.06.0-rc1/targets/sunxi/cortexa7/openwrt-18.06.0-rc1-sunxi-cortexa7-sun8i-h3-nanopi-neo-squashfs-sdcard.img.gz;2;0;2;4.76 MB;2.38 MB
/releases/18.06.5/targets/sunxi/cortexa53/openwrt-18.06.5-sunxi-cortexa53-sun50i-h5-orangepi-zero-plus-squashfs-sdcard.img.gz;2;0;2;5.78 MB;2.89 MB
/releases/17.01.0/targets/sunxi/generic/lede-17.01.0-r3205-59508e3-sunxi-sun5i-a13-olinuxino-squashfs-sdcard.img.gz;2;0;2;431.50 KB;215.75 KB
/releases/19.07.3/targets/mvebu/cortexa72/openwrt-19.07.3-mvebu-cortexa72-marvell_armada8040-db-squashfs-sdcard.img.gz;2;0;2;5.84 MB;2.92 MB
/releases/18.06.3/targets/ar71xx/generic/openwrt-18.06.3-ar71xx-generic-vmlinux.lzma;2;0;2;751.09 KB;375.54 KB
/releases/18.06.3/targets/sunxi/cortexa7/openwrt-18.06.3-sunxi-cortexa7-sun7i-a20-olinuxino-lime2-ext4-sdcard.img.gz;2;0;2;5.57 MB;2.78 MB
/releases/18.06.6/targets/ar71xx/nand/openwrt-18.06.6-ar71xx-nand-wi2a-ac200i-squashfs-sysupgrade.tar;2;0;2;4.28 MB;2.14 MB
/releases/18.06.0/targets/sunxi/cortexa7/openwrt-18.06.0-sunxi-cortexa7-sun8i-h3-orangepi-pc-squashfs-sdcard.img.gz;2;0;2;4.58 MB;2.29 MB
/releases/19.07.0-rc2/targets/at91/sama5/openwrt-19.07.0-rc2-at91-sama5-rootfs.tar.gz;2;0;2;2.21 MB;1.10 MB
/releases/18.06.7/targets/at91/legacy/openwrt-18.06.7-at91-legacy-at91sam9g20ek-ext4-zImage.gz;2;0;2;2.36 MB;1.18 MB
/releases/17.01.0-rc2/targets/kirkwood/generic/lede-17.01.0-rc2-r3131-42f3c1f-kirkwood-goflexnet-squashfs-sysupgrade.tar;2;0;2;847.49 KB;423.75 KB
/releases/18.06.0-rc1/targets/sunxi/cortexa53/openwrt-18.06.0-rc1-sunxi-cortexa53-sun50i-a64-sopine-baseboard-squashfs-sdcard.img.gz;2;0;2;8.82 MB;4.41 MB
/releases/18.06.6/targets/sunxi/cortexa7/openwrt-18.06.6-sunxi-cortexa7-sun7i-a20-olinuxino-lime2-emmc-ext4-sdcard.img.gz;2;0;2;5.57 MB;2.79 MB
/releases/18.06.7/targets/sunxi/cortexa53/openwrt-18.06.7-sunxi-cortexa53-sun50i-a64-pine64-plus-squashfs-sdcard.img.gz;2;0;2;1.34 MB;687.54 KB
/releases/18.06.0/targets/sunxi/cortexa8/openwrt-18.06.0-sunxi-cortexa8-sun5i-a13-olinuxino-squashfs-sdcard.img.gz;2;0;2;4.89 MB;2.45 MB
/releases/19.07.0/targets/armvirt/64/openwrt-19.07.0-armvirt-64-rootfs.cpio.gz;2;0;2;40 Bytes;20 Bytes
/releases/17.01.6/targets/sunxi/generic/lede-17.01.6-sunxi-sun5i-a13-olinuxino-squashfs-sdcard.img.gz;2;0;2;287.50 KB;143.75 KB
/releases/18.06.0/targets/sunxi/cortexa7/openwrt-18.06.0-sunxi-cortexa7-sun7i-a20-cubietruck-ext4-sdcard.img.gz;2;0;2;6.23 MB;3.11 MB
/releases/17.01.1/targets/sunxi/generic/lede-17.01.1-sunxi-sun7i-a20-pcduino3-squashfs-sdcard.img.gz;2;0;2;383.50 KB;191.75 KB
/releases/18.06.3/targets/sunxi/cortexa7/openwrt-18.06.3-sunxi-cortexa7-sun7i-a20-pcduino3-ext4-sdcard.img.gz;2;0;2;5.91 MB;2.95 MB
/releases/18.06.5/targets/sunxi/cortexa7/openwrt-18.06.5-sunxi-cortexa7-sun8i-h3-nanopi-m1-plus-ext4-sdcard.img.gz;2;0;2;6.66 MB;3.33 MB
/releases/17.01.0-rc2/targets/sunxi/generic/lede-17.01.0-rc2-r3131-42f3c1f-sunxi-sun7i-a20-lamobo-r1-squashfs-sdcard.img.gz;2;0;2;2.45 MB;1.23 MB
/releases/19.07.0-rc2/targets/pistachio/generic/openwrt-19.07.0-rc2-pistachio-rootfs.tar.gz;2;0;2;2.16 MB;1.08 MB
/releases/19.07.1/targets/zynq/generic/openwrt-19.07.1-zynq-digilent_zynq-zybo-z7-squashfs-sdcard.img.gz;2;0;2;5.99 MB;2.99 MB
/releases/18.06.7/targets/at91/sama5d3/openwrt-18.06.7-at91-sama5d3-at91-sama5d3_xplained-ext4-sdcard.img.gz;2;0;2;1.42 MB;727.54 KB
/releases/18.06.5/targets/sunxi/cortexa7/openwrt-18.06.5-sunxi-cortexa7-sun7i-a20-olinuxino-lime-ext4-sdcard.img.gz;2;0;2;5.46 MB;2.73 MB
/releases/18.06.7/targets/at91/sama5d2/openwrt-18.06.7-at91-sama5d2-at91-sama5d2_xplained-ext4-root.ubi.gz;2;0;2;2.48 MB;1.24 MB
/releases/18.06.3/targets/sunxi/cortexa8/openwrt-18.06.3-sunxi-cortexa8-sun5i-a13-olimex-som-squashfs-sdcard.img.gz;2;0;2;4.89 MB;2.45 MB
/releases/19.07.1/targets/sunxi/cortexa7/openwrt-19.07.1-sunxi-cortexa7-sun7i-a20-bananapro-ext4-sdcard.img.gz;2;0;2;6.65 MB;3.32 MB
/releases/18.06.4/targets/ar71xx/nand/openwrt-18.06.4-ar71xx-nand-wndr3700v4-squashfs-sysupgrade.tar;2;0;2;4.59 MB;2.29 MB
/releases/17.01.4/targets/sunxi/generic/lede-17.01.4-sunxi-sun8i-h3-orangepi-plus-squashfs-sdcard.img.gz;2;0;2;223.50 KB;111.75 KB
/releases/18.06.6/targets/at91/sama5d2/openwrt-18.06.6-at91-sama5d2-at91-sama5d2_ptc_ek-ext4-root.ubi.gz;2;0;2;2.50 MB;1.25 MB
/releases/18.06.2/targets/armvirt/32/openwrt-18.06.2-armvirt-32-rootfs.cpio.gz;2;0;2;40 Bytes;20 Bytes
/releases/17.01.0/targets/sunxi/generic/lede-17.01.0-r3205-59508e3-sunxi-sun8i-h3-orangepi-plus-ext4-sdcard.img.gz;2;0;2;223.50 KB;111.75 KB
/releases/18.06.5/targets/x86/legacy/openwrt-18.06.5-x86-legacy-rootfs-ext4.img.gz;2;0;2;3.17 MB;1.59 MB
/releases/17.01.0/targets/sunxi/generic/lede-17.01.0-r3205-59508e3-sunxi-sun7i-a20-pcduino3-squashfs-sdcard.img.gz;2;0;2;319.50 KB;159.75 KB
/releases/19.07.1/targets/at91/sama5/openwrt-19.07.1-at91-sama5-at91-sama5d3_xplained-ext4-sdcard.img.gz;2;0;2;6.18 MB;3.09 MB
/releases/18.06.2/targets/sunxi/cortexa53/openwrt-18.06.2-sunxi-cortexa53-sun50i-h5-orangepi-zero-plus-squashfs-sdcard.img.gz;2;0;2;5.76 MB;2.88 MB
/releases/17.01.5/targets/sunxi/generic/lede-17.01.5-sunxi-sun4i-a10-pcduino-squashfs-sdcard.img.gz;2;0;2;4.49 MB;2.24 MB
/releases/17.01.0-rc2/targets/sunxi/generic/lede-17.01.0-rc2-r3131-42f3c1f-sunxi-sun7i-a20-cubieboard2-ext4-sdcard.img.gz;2;0;2;2.58 MB;1.29 MB
/releases/18.06.0/targets/x86/legacy/openwrt-18.06.0-x86-legacy-rootfs-ext4.img.gz;2;0;2;3.15 MB;1.58 MB
/releases/18.06.2/targets/octeon/generic/openwrt-18.06.2-octeon-erlite-squashfs-sysupgrade.tar;2;0;2;1.36 MB;695.54 KB
/releases/18.06.1/targets/gemini/generic/openwrt-18.06.1-gemini-nas4220b-rd.gz;2;0;2;6.08 MB;3.04 MB
/releases/17.01.0-rc2/targets/kirkwood/generic/lede-17.01.0-rc2-r3131-42f3c1f-kirkwood-pogo_e02-squashfs-sysupgrade.tar;2;0;2;463.49 KB;231.75 KB
/releases/17.01.5/targets/sunxi/generic/lede-17.01.5-sunxi-sun6i-a31-m9-ext4-sdcard.img.gz;2;0;2;5.35 MB;2.68 MB
/releases/17.01.4/targets/gemini/raidsonic/lede-17.01.4-gemini-raidsonic-sysupgrade-ib4220.tar.gz;2;0;2;2.39 MB;1.20 MB
/releases/18.06.0-rc2/targets/ar71xx/nand/openwrt-18.06.0-rc2-ar71xx-nand-hiveap-121-squashfs-sysupgrade.tar;2;0;2;6.77 MB;3.39 MB
/releases/17.01.4/targets/sunxi/generic/lede-17.01.4-sunxi-sun4i-a10-cubieboard-squashfs-sdcard.img.gz;2;0;2;447.50 KB;223.75 KB
/releases/19.07.0/targets/armvirt/32/openwrt-19.07.0-armvirt-32-root.ext4.gz;2;0;2;4.45 MB;2.23 MB
/releases/18.06.4/targets/ar71xx/generic/openwrt-18.06.4-ar71xx-generic-vmlinux.lzma;2;0;2;1.64 MB;839.77 KB
/releases/17.01.5/targets/arc770/generic/lede-17.01.5-arc770-generic-Default-sdcard-vfat-ext4.img.gz;2;0;2;11.00 MB;5.50 MB
/releases/19.07.2/targets/armvirt/64/openwrt-19.07.2-armvirt-64-root.ext4.gz;2;0;2;2.44 MB;1.22 MB
/releases/17.01.0-rc2/targets/sunxi/generic/lede-17.01.0-rc2-r3131-42f3c1f-sunxi-sun5i-a13-olimex-som-squashfs-sdcard.img.gz;2;0;2;2.52 MB;1.26 MB
/releases/19.07.2/targets/sunxi/cortexa8/openwrt-19.07.2-sunxi-cortexa8-sun4i-a10-pcduino-squashfs-sdcard.img.gz;2;0;2;10.19 MB;5.10 MB
/releases/18.06.0-rc2/targets/oxnas/ox820/openwrt-18.06.0-rc2-oxnas-ox820-cloudengines-pogoplug-series-3-squashfs-sysupgrade.tar;2;0;2;7.80 MB;3.90 MB
/releases/17.01.4/targets/sunxi/generic/lede-17.01.4-sunxi-sun7i-a20-olinuxino-lime-squashfs-sdcard.img.gz;2;0;2;447.50 KB;223.75 KB
/releases/19.07.3/targets/sunxi/cortexa7/openwrt-19.07.3-sunxi-cortexa7-sun7i-a20-olinuxino-micro-squashfs-sdcard.img.gz;2;0;2;4.94 MB;2.47 MB
/releases/17.01.0/targets/sunxi/generic/lede-17.01.0-r3205-59508e3-sunxi-sun5i-a13-olinuxino-ext4-sdcard.img.gz;2;0;2;431.50 KB;215.75 KB
/releases/18.06.2/targets/sunxi/cortexa53/openwrt-18.06.2-sunxi-cortexa53-sun50i-h5-orangepi-zero-plus-ext4-sdcard.img.gz;2;0;2;6.65 MB;3.32 MB
/releases/18.06.5/targets/sunxi/cortexa8/openwrt-18.06.5-sunxi-cortexa8-sun4i-a10-olinuxino-lime-ext4-sdcard.img.gz;2;0;2;5.41 MB;2.70 MB
/releases/17.01.2/targets/kirkwood/generic/lede-17.01.2-kirkwood-iconnect-squashfs-sysupgrade.tar;2;0;2;703.49 KB;351.75 KB
/releases/18.06.2/targets/ath25/generic/openwrt-18.06.2-ath25-generic-kernel.gz;2;0;2;2.14 MB;1.07 MB
/releases/19.07.0/targets/ar71xx/generic/openwrt-19.07.0-ar71xx-generic-vmlinux.lzma;2;0;2;1.75 MB;895.77 KB
/releases/18.06.0/targets/sunxi/cortexa8/openwrt-18.06.0-sunxi-cortexa8-sun4i-a10-olinuxino-lime-ext4-sdcard.img.gz;2;0;2;5.39 MB;2.69 MB
/releases/19.07.3/targets/oxnas/ox820/openwrt-19.07.3-oxnas-ox820-cloudengines_pogoplugpro-ubifs-sysupgrade.tar;2;0;2;9.29 MB;4.65 MB
/releases/18.06.2/targets/sunxi/cortexa7/openwrt-18.06.2-sunxi-cortexa7-sun8i-h3-nanopi-m1-plus-ext4-sdcard.img.gz;2;0;2;6.67 MB;3.34 MB
/releases/19.07.2/targets/omap/generic/openwrt-19.07.2-omap-ti_omap4-panda-squashfs-sdcard.img.gz;2;0;2;1.48 MB;759.54 KB
/releases/17.01.4/targets/sunxi/generic/lede-17.01.4-sunxi-sun5i-a13-olinuxino-squashfs-sdcard.img.gz;2;0;2;431.50 KB;215.75 KB
/releases/19.07.0-rc2/targets/layerscape/armv8_64b/openwrt-19.07.0-rc2-layerscape-armv8_64b-ls1043ardb-sdboot-ext4-sdcard.img.gz;2;0;2;8.48 MB;4.24 MB
/releases/18.06.5/targets/at91/sama5d4/openwrt-18.06.5-at91-sama5d4-at91-sama5d4_xplained-ext4-root.ubi.gz;2;0;2;2.54 MB;1.27 MB
/releases/18.06.5/targets/armvirt/64/openwrt-18.06.5-armvirt-64-root.squashfs.gz;2;0;2;1.73 MB;884.70 KB
/releases/18.06.2/targets/x86/legacy/openwrt-18.06.2-x86-legacy-generic-rootfs.tar.gz;2;0;2;2.90 MB;1.45 MB
/releases/18.06.5/targets/sunxi/cortexa7/openwrt-18.06.5-sunxi-cortexa7-sun7i-a20-lamobo-r1-ext4-sdcard.img.gz;2;0;2;6.25 MB;3.13 MB
/releases/19.07.1/targets/sunxi/cortexa7/openwrt-19.07.1-sunxi-cortexa7-sun8i-h3-nanopi-m1-plus-ext4-sdcard.img.gz;2;0;2;7.02 MB;3.51 MB
/releases/17.01.2/targets/oxnas/generic/lede-17.01.2-oxnas-kd20-squashfs-sysupgrade.tar;2;0;2;319.50 KB;159.75 KB
/releases/18.06.7/targets/at91/sama5d2/openwrt-18.06.7-at91-sama5d2-rootfs.tar.gz;2;0;2;1.44 MB;735.54 KB
/releases/18.06.6/targets/sunxi/cortexa7/openwrt-18.06.6-sunxi-cortexa7-sun7i-a20-olinuxino-lime-squashfs-sdcard.img.gz;2;0;2;4.63 MB;2.32 MB
/releases/18.06.3/targets/at91/sama5d2/openwrt-18.06.3-at91-sama5d2-at91-sama5d2_xplained-ext4-zImage.gz;2;0;2;3.20 MB;1.60 MB
/releases/19.07.3/targets/oxnas/ox820/openwrt-19.07.3-oxnas-ox820-akitio_mycloud-ubifs-sysupgrade.tar;2;0;2;8.49 MB;4.24 MB
/releases/18.06.5/targets/at91/legacy/openwrt-18.06.5-at91-legacy-usb_a9g20-ext4-factory.bin.gz;2;0;2;5.64 MB;2.82 MB
/releases/18.06.4/targets/omap/generic/openwrt-18.06.4-omap-omap3-beagle-ext4-sdcard.img.gz;2;0;2;6.00 MB;3.00 MB
/releases/17.01.0/targets/sunxi/generic/lede-17.01.0-r3205-59508e3-sunxi-sun4i-a10-olinuxino-lime-ext4-sdcard.img.gz;2;0;2;495.50 KB;247.75 KB
/releases/17.01.5/targets/sunxi/generic/lede-17.01.5-sunxi-sun8i-h3-orangepi-plus-squashfs-sdcard.img.gz;2;0;2;4.08 MB;2.04 MB
/releases/18.06.3/targets/at91/sama5d2/openwrt-18.06.3-at91-sama5d2-at91-sama5d27_som1_ek-ext4-zImage.gz;2;0;2;3.21 MB;1.61 MB
/releases/18.06.2/targets/at91/sama5d4/openwrt-18.06.2-at91-sama5d4-rootfs.tar.gz;2;0;2;2.12 MB;1.06 MB
/releases/18.06.3/targets/mvebu/cortexa53/openwrt-18.06.3-mvebu-cortexa53-globalscale-espressobin-squashfs-sdcard.img.gz;2;0;2;5.44 MB;2.72 MB
/releases/19.07.2/targets/sunxi/cortexa7/openwrt-19.07.2-sunxi-cortexa7-sun8i-h3-nanopi-neo-ext4-sdcard.img.gz;2;0;2;9.28 MB;4.64 MB
/releases/17.01.3/targets/arc770/generic/lede-17.01.3-arc770-generic-Default-sdcard-vfat-ext4.img.gz;2;0;2;5.48 MB;2.74 MB
/releases/18.06.2/targets/at91/sama5d4/openwrt-18.06.2-at91-sama5d4-at91-sama5d4_xplained-ext4-zImage.gz;2;0;2;3.20 MB;1.60 MB
/releases/18.06.5/targets/ramips/mt7621/openwrt-18.06.5-ramips-mt7621-ubnt-erx-sfp-squashfs-sysupgrade.tar;2;0;2;3.61 MB;1.80 MB
/releases/19.07.2/targets/at91/sama5/openwrt-19.07.2-at91-sama5-at91-sama5d2_ptc_ek-ext4-root.ubi.gz;2;0;2;2.62 MB;1.31 MB
/releases/19.07.3/targets/mxs/generic/openwrt-19.07.3-mxs-duckbill-sdcard.img.gz;2;0;2;11.45 MB;5.72 MB
/releases/19.07.0/targets/armvirt/64/openwrt-19.07.0-armvirt-64-root.squashfs.gz;2;0;2;3.28 MB;1.64 MB
/releases/18.06.0-rc2/targets/oxnas/ox820/openwrt-18.06.0-rc2-oxnas-ox820-shuttle-kd20-squashfs-sysupgrade.tar;2;0;2;8.46 MB;4.23 MB
/releases/18.06.5/targets/mxs/generic/openwrt-18.06.5-mxs-root.ext4.gz;2;0;2;5.33 MB;2.67 MB
/releases/18.06.6/targets/imx6/generic/openwrt-18.06.6-imx6-rootfs.tar.gz;2;0;2;2.10 MB;1.05 MB
/releases/18.06.5/targets/x86/legacy/openwrt-18.06.5-x86-legacy-combined-ext4.img.gz;2;0;2;6.92 MB;3.46 MB
/releases/17.01.5/targets/ipq806x/generic/lede-17.01.5-ipq806x-AP148-squashfs-nand-sysupgrade.tar;2;0;2;5.43 MB;2.72 MB
/releases/17.01.1/targets/sunxi/generic/lede-17.01.1-sunxi-sun6i-a31-m9-squashfs-sdcard.img.gz;2;0;2;223.50 KB;111.75 KB
/releases/18.06.6/targets/mxs/generic/openwrt-18.06.6-mxs-root.ext4.gz;2;0;2;5.41 MB;2.71 MB
/releases/19.07.0/targets/gemini/generic/openwrt-19.07.0-gemini-dlink_dir-685-ext4-factory.bin.gz;2;0;2;18.03 MB;9.01 MB
/releases/17.01.0-rc2/targets/sunxi/generic/lede-17.01.0-rc2-r3131-42f3c1f-sunxi-sun7i-a20-bananapro-ext4-sdcard.img.gz;2;0;2;2.66 MB;1.33 MB
/releases/18.06.7/targets/mvebu/cortexa9/openwrt-18.06.7-mvebu-cortexa9-armada-388-clearfog-pro-squashfs-sdcard.img.gz;2;0;2;4.72 MB;2.36 MB
/releases/19.07.2/targets/oxnas/ox820/openwrt-19.07.2-oxnas-ox820-shuttle_kd20-ubifs-sysupgrade.tar;2;0;2;1.45 MB;743.54 KB
/releases/19.07.3/targets/mvebu/cortexa72/openwrt-19.07.3-mvebu-cortexa72-marvell_armada7040-db-ext4-sdcard.img.gz;2;0;2;6.72 MB;3.36 MB
/releases/19.07.1/targets/at91/sama5/openwrt-19.07.1-at91-sama5-at91-sama5d2_xplained-ext4-zImage.gz;2;0;2;3.47 MB;1.73 MB
/releases/18.06.7/targets/sunxi/cortexa53/openwrt-18.06.7-sunxi-cortexa53-sun50i-h5-orangepi-zero-plus-ext4-sdcard.img.gz;2;0;2;1.98 MB;1015.54 KB
/releases/19.07.1/targets/oxnas/ox820/openwrt-19.07.1-oxnas-ox820-akitio_mycloud-ubifs-sysupgrade.tar;2;0;2;8.49 MB;4.24 MB
/releases/19.07.1/targets/mvebu/cortexa72/openwrt-19.07.1-mvebu-cortexa72-marvell_armada8040-db-ext4-sdcard.img.gz;2;0;2;6.58 MB;3.29 MB
/releases/18.06.2/targets/sunxi/cortexa8/openwrt-18.06.2-sunxi-cortexa8-sun4i-a10-cubieboard-squashfs-sdcard.img.gz;2;0;2;4.55 MB;2.27 MB
/releases/18.06.0/targets/sunxi/cortexa7/openwrt-18.06.0-sunxi-cortexa7-sun7i-a20-olinuxino-lime2-emmc-squashfs-sdcard.img.gz;2;0;2;4.68 MB;2.34 MB
/releases/18.06.4/targets/sunxi/cortexa7/openwrt-18.06.4-sunxi-cortexa7-sun7i-a20-olinuxino-micro-squashfs-sdcard.img.gz;2;0;2;4.65 MB;2.32 MB
/releases/19.07.3/targets/sunxi/cortexa7/openwrt-19.07.3-sunxi-cortexa7-sun8i-h3-nanopi-m1-plus-squashfs-sdcard.img.gz;2;0;2;5.92 MB;2.96 MB
/releases/17.01.0/targets/sunxi/generic/lede-17.01.0-r3205-59508e3-sunxi-sun5i-a13-olimex-som-squashfs-sdcard.img.gz;2;0;2;303.50 KB;151.75 KB
/releases/17.01.5/targets/mediatek/generic/lede-17.01.5-mediatek-NAND-squashfs-sysupgrade.tar;2;0;2;8.09 MB;4.04 MB
/releases/18.06.0-rc2/targets/at91/sama5d2/openwrt-18.06.0-rc2-at91-sama5d2-at91-sama5d2_ptc_ek-ext4-sdcard.img.gz;2;0;2;6.83 MB;3.41 MB
/releases/18.06.2/targets/sunxi/cortexa53/openwrt-18.06.2-sunxi-cortexa53-sun50i-a64-pine64-plus-ext4-sdcard.img.gz;2;0;2;6.54 MB;3.27 MB
/releases/18.06.1/targets/x86/geode/openwrt-18.06.1-x86-geode-combined-ext4.img.gz;2;0;2;7.31 MB;3.65 MB
/releases/18.06.0-rc2/targets/oxnas/ox820/openwrt-18.06.0-rc2-oxnas-ox820-cloudengines-pogoplug-series-3-ubifs-sysupgrade.tar;2;0;2;10.89 MB;5.45 MB
/releases/18.06.3/targets/armvirt/64/openwrt-18.06.3-armvirt-64-default-rootfs.tar.gz;2;0;2;3.93 MB;1.97 MB
/releases/19.07.1/targets/brcm2708/bcm2709/openwrt-19.07.1-brcm2708-bcm2709-rpi-2-ext4-factory.img.gz;2;13;15;25.84 MB;1.72 MB
/releases/18.06.0/targets/sunxi/cortexa53/openwrt-18.06.0-sunxi-cortexa53-sun50i-h5-orangepi-zero-plus-ext4-sdcard.img.gz;2;0;2;6.51 MB;3.26 MB
/releases/19.07.3/targets/sunxi/cortexa7/openwrt-19.07.3-sunxi-cortexa7-sun6i-a31-m9-squashfs-sdcard.img.gz;2;0;2;5.23 MB;2.61 MB
/releases/17.01.5/targets/zynq/generic/lede-17.01.5-zynq-zc702-uramdisk.image.gz;2;0;2;1.98 MB;1012.99 KB
/releases/19.07.0/targets/tegra/generic/openwrt-19.07.0-tegra-compulab_trimslice-squashfs-sdcard.img.gz;2;0;2;10.74 MB;5.37 MB
/releases/17.01.0-rc1/targets/kirkwood/generic/lede-17.01.0-rc1-r3042-ec095b5-kirkwood-goflexhome-squashfs-sysupgrade.tar;2;0;2;3.14 MB;1.57 MB
/releases/18.06.2/targets/x86/geode/openwrt-18.06.2-x86-geode-rootfs-squashfs.img.gz;2;0;2;3.75 MB;1.88 MB
/snapshots/faillogs/arm_fa526/packages/node/host-compile.txt;2;0;2;4.03 MB;2.01 MB
/releases/19.07.1/targets/oxnas/ox820/openwrt-19.07.1-oxnas-ox820-akitio_mycloud-squashfs-sysupgrade.tar;2;0;2;5.17 MB;2.58 MB
/releases/19.07.3/targets/mvebu/cortexa53/openwrt-19.07.3-mvebu-cortexa53-globalscale_espressobin-v7-emmc-ext4-sdcard.img.gz;2;0;2;6.66 MB;3.33 MB
/releases/18.06.7/targets/oxnas/ox820/openwrt-18.06.7-oxnas-ox820-shuttle-kd20-factory.tar.gz;2;0;2;7.16 MB;3.58 MB
/releases/18.06.0/targets/x86/legacy/openwrt-18.06.0-x86-legacy-combined-squashfs.img.gz;2;0;2;6.05 MB;3.03 MB
/releases/18.06.5/targets/x86/64/openwrt-18.06.5-x86-64-generic-rootfs.tar.gz;2;0;2;2.97 MB;1.49 MB
/releases/19.07.1/targets/sunxi/cortexa7/openwrt-19.07.1-sunxi-cortexa7-sun8i-h2-plus-orangepi-r1-ext4-sdcard.img.gz;2;0;2;5.80 MB;2.90 MB
/releases/18.06.3/targets/at91/legacy/openwrt-18.06.3-at91-legacy-lmu5000-ext4-factory.bin.gz;2;0;2;5.65 MB;2.82 MB
/releases/18.06.7/targets/sunxi/cortexa53/openwrt-18.06.7-sunxi-cortexa53-sun50i-h5-nanopi-neo-plus2-ext4-sdcard.img.gz;2;0;2;2.41 MB;1.20 MB
/releases/19.07.0/targets/apm821xx/sata/openwrt-19.07.0-apm821xx-sata-wd_mybooklive-squashfs-factory.img.gz;2;0;2;5.60 MB;2.80 MB
/releases/18.06.0/targets/sunxi/cortexa7/openwrt-18.06.0-sunxi-cortexa7-sun8i-h3-orangepi-2-squashfs-sdcard.img.gz;2;0;2;4.56 MB;2.28 MB
/releases/18.06.3/targets/at91/legacy/openwrt-18.06.3-at91-legacy-at91sam9x25ek-ext4-root.ubi.gz;2;0;2;2.56 MB;1.28 MB
/releases/18.06.7/targets/omap/generic/openwrt-18.06.7-omap-am335x-evm-ubifs-sdcard.img.gz;2;0;2;6.18 MB;3.09 MB
/releases/18.06.3/targets/sunxi/cortexa7/openwrt-18.06.3-sunxi-cortexa7-sun8i-h3-orangepi-pc-squashfs-sdcard.img.gz;2;0;2;4.69 MB;2.35 MB
/releases/19.07.0/targets/mvebu/cortexa53/openwrt-19.07.0-mvebu-cortexa53-globalscale_espressobin-v7-ext4-sdcard.img.gz;2;0;2;12.76 MB;6.38 MB
/releases/18.06.7/targets/armvirt/64/openwrt-18.06.7-armvirt-64-root.ext4.gz;2;0;2;2.31 MB;1.16 MB
/releases/19.07.0-rc2/targets/sunxi/cortexa7/openwrt-19.07.0-rc2-sunxi-cortexa7-sun8i-h3-orangepi-2-ext4-sdcard.img.gz;2;0;2;5.74 MB;2.87 MB
/releases/18.06.3/targets/mxs/generic/openwrt-18.06.3-mxs-duckbill-sdcard.img.gz;2;0;2;11.13 MB;5.57 MB
/releases/18.06.0/targets/omap/generic/openwrt-18.06.0-omap-am335x-boneblack-ubifs-sdcard.img.gz;2;0;2;6.06 MB;3.03 MB
/releases/19.07.2/targets/omap/generic/openwrt-19.07.2-omap-ti_am335x-bone-black-squashfs-sdcard.img.gz;2;0;2;1.47 MB;751.54 KB
/releases/18.06.1/targets/x86/geode/openwrt-18.06.1-x86-geode-rootfs-squashfs.img.gz;2;0;2;3.75 MB;1.88 MB
/releases/17.01.4/targets/oxnas/generic/lede-17.01.4-oxnas-pogoplug-pro-squashfs-sysupgrade.tar;2;0;2;639.50 KB;319.75 KB
/releases/18.06.7/targets/oxnas/ox820/openwrt-18.06.7-oxnas-ox820-cloudengines-pogoplug-series-3-ubifs-sysupgrade.tar;2;0;2;7.94 MB;3.97 MB
/releases/18.06.4/targets/rb532/generic/openwrt-18.06.4-rb532-default-rootfs.tar.gz;2;0;2;3.55 MB;1.78 MB
/releases/17.01.5/targets/sunxi/generic/lede-17.01.5-sunxi-sun7i-a20-olinuxino-micro-ext4-sdcard.img.gz;2;0;2;4.92 MB;2.46 MB
/releases/17.01.6/targets/ramips/mt7621/lede-17.01.6-ramips-mt7621-ubnt-erx-squashfs-sysupgrade.tar;2;0;2;463.50 KB;231.75 KB
/releases/18.06.4/targets/at91/legacy/openwrt-18.06.4-at91-legacy-at91sam9263ek-ext4-root.ubi.gz;2;0;2;2.51 MB;1.26 MB
/snapshots/faillogs/arm_arm926ej-s/packages/node/host-compile.txt;2;0;2;4.04 MB;2.02 MB
/releases/19.07.0/targets/brcm2708/bcm2709/openwrt-19.07.0-brcm2708-bcm2709-rpi-2-ext4-factory.img.gz;2;0;2;23.95 MB;11.98 MB
/releases/19.07.2/targets/at91/sam9x/openwrt-19.07.2-at91-sam9x-at91sam9m10g45ek-ext4-root.ubi.gz;2;0;2;2.62 MB;1.31 MB
/releases/17.01.1/targets/x86/64/lede-17.01.1-x86-64-rootfs-ext4.img.gz;2;0;2;2.48 MB;1.24 MB
/releases/19.07.2/targets/sunxi/cortexa7/openwrt-19.07.2-sunxi-cortexa7-sun8i-h3-nanopi-m1-plus-ext4-sdcard.img.gz;2;0;2;13.88 MB;6.94 MB
/releases/18.06.5/targets/sunxi/cortexa53/openwrt-18.06.5-sunxi-cortexa53-sun50i-h5-nanopi-neo-plus2-squashfs-sdcard.img.gz;2;0;2;5.78 MB;2.89 MB
/releases/17.01.5/targets/zynq/generic/lede-17.01.5-zynq-zed-uramdisk.image.gz;2;0;2;1.90 MB;972.99 KB
/releases/17.01.5/targets/gemini/raidsonic/lede-17.01.5-gemini-raidsonic-sysupgrade-ib4220.tar.gz;2;0;2;9.14 MB;4.57 MB
/releases/19.07.3/targets/sunxi/cortexa7/openwrt-19.07.3-sunxi-cortexa7-sun8i-h3-orangepi-plus-ext4-sdcard.img.gz;2;0;2;5.86 MB;2.93 MB
/releases/17.01.1/targets/sunxi/generic/lede-17.01.1-sunxi-sun5i-a13-olinuxino-squashfs-sdcard.img.gz;2;0;2;223.50 KB;111.75 KB
/releases/18.06.5/targets/imx6/generic/openwrt-18.06.5-imx6-rootfs.tar.gz;2;0;2;2.08 MB;1.04 MB
/releases/18.06.2/targets/at91/legacy/openwrt-18.06.2-at91-legacy-ethernut5-ext4-root.ubi.gz;2;0;2;2.51 MB;1.26 MB
/releases/18.06.5/targets/sunxi/cortexa53/openwrt-18.06.5-sunxi-cortexa53-sun50i-a64-sopine-baseboard-squashfs-sdcard.img.gz;2;0;2;5.76 MB;2.88 MB
/releases/18.06.4/targets/oxnas/ox820/openwrt-18.06.4-oxnas-ox820-mitrastar-stg212-squashfs-sysupgrade.tar;2;0;2;4.98 MB;2.49 MB
/releases/18.06.3/targets/sunxi/cortexa7/openwrt-18.06.3-sunxi-cortexa7-sun7i-a20-olinuxino-lime-ext4-sdcard.img.gz;2;0;2;5.47 MB;2.74 MB
/releases/19.07.3/targets/oxnas/ox820/openwrt-19.07.3-oxnas-ox820-cloudengines_pogoplug-series-3-squashfs-sysupgrade.tar;2;0;2;5.15 MB;2.58 MB
/releases/17.01.4/targets/sunxi/generic/lede-17.01.4-sunxi-sun7i-a20-cubietruck-ext4-sdcard.img.gz;2;0;2;735.50 KB;367.75 KB
/releases/19.07.0/targets/mvebu/cortexa53/openwrt-19.07.0-mvebu-cortexa53-globalscale_espressobin-v7-emmc-ext4-sdcard.img.gz;2;0;2;12.76 MB;6.38 MB
/releases/17.01.2/targets/x86/geode/lede-17.01.2-x86-geode-combined-ext4.img.gz;2;0;2;271.50 KB;135.75 KB
/releases/17.01.0/targets/archs38/generic/lede-17.01.0-r3205-59508e3-archs38-generic-root.ext4.gz;2;0;2;2.69 MB;1.34 MB
/releases/18.06.5/targets/oxnas/ox820/openwrt-18.06.5-oxnas-ox820-shuttle-kd20-ubifs-sysupgrade.tar;2;0;2;9.06 MB;4.53 MB
/releases/18.06.1/targets/at91/sama5d4/openwrt-18.06.1-at91-sama5d4-at91-sama5d4_xplained-ext4-root.ubi.gz;2;0;2;2.44 MB;1.22 MB
/releases/18.06.0/targets/oxnas/ox820/openwrt-18.06.0-oxnas-ox820-akitio-mycloud-ubifs-sysupgrade.tar;2;0;2;8.31 MB;4.16 MB
/releases/17.01.4/targets/arc770/generic/lede-17.01.4-arc770-generic-root.ext4.gz;2;0;2;2.77 MB;1.39 MB
/releases/19.07.1/targets/x86/geode/openwrt-19.07.1-x86-geode-combined-ext4.img.gz;2;0;2;7.46 MB;3.73 MB
/releases/18.06.0-rc1/targets/omap/generic/openwrt-18.06.0-rc1-omap-am335x-boneblack-ext4-sdcard.img.gz;2;0;2;8.18 MB;4.09 MB
/releases/18.06.5/targets/sunxi/cortexa7/openwrt-18.06.5-sunxi-cortexa7-sun7i-a20-bananapi-ext4-sdcard.img.gz;2;0;2;5.62 MB;2.81 MB
/releases/18.06.5/targets/sunxi/cortexa8/openwrt-18.06.5-sunxi-cortexa8-sun4i-a10-cubieboard-ext4-sdcard.img.gz;2;0;2;5.41 MB;2.70 MB
/releases/19.07.2/targets/at91/sam9x/openwrt-19.07.2-at91-sam9x-rootfs.tar.gz;2;0;2;2.28 MB;1.14 MB
/releases/18.06.1/targets/x86/64/openwrt-18.06.1-x86-64-rootfs-squashfs.img.gz;2;0;2;2.63 MB;1.32 MB
/releases/17.01.2/targets/x86/64/lede-17.01.2-x86-64-rootfs-ext4.img.gz;2;0;2;255.50 KB;127.75 KB
/releases/18.06.6/targets/oxnas/ox820/openwrt-18.06.6-oxnas-ox820-akitio-mycloud-ubifs-sysupgrade.tar;2;0;2;8.42 MB;4.21 MB
/releases/19.07.0-rc2/targets/sunxi/cortexa7/openwrt-19.07.0-rc2-sunxi-cortexa7-sun8i-h2-plus-orangepi-r1-squashfs-sdcard.img.gz;2;0;2;5.03 MB;2.51 MB
/releases/18.06.6/targets/sunxi/cortexa7/openwrt-18.06.6-sunxi-cortexa7-sun7i-a20-bananapro-ext4-sdcard.img.gz;2;0;2;6.23 MB;3.11 MB
/snapshots/faillogs/i386_pentium-mmx/packages/node/host-compile.txt;2;0;2;4.02 MB;2.01 MB
/releases/19.07.1/targets/mvebu/cortexa72/openwrt-19.07.1-mvebu-cortexa72-marvell_macchiatobin-squashfs-sdcard.img.gz;2;0;2;5.78 MB;2.89 MB
/releases/18.06.2/targets/at91/sama5d2/openwrt-18.06.2-at91-sama5d2-at91-sama5d2_xplained-ext4-sdcard.img.gz;2;0;2;5.72 MB;2.86 MB
/releases/17.01.5/targets/zynq/generic/lede-17.01.5-zynq-rootfs.tar.gz;2;0;2;1.97 MB;1006.60 KB
/releases/18.06.6/targets/sunxi/cortexa8/openwrt-18.06.6-sunxi-cortexa8-sun4i-a10-olinuxino-lime-ext4-sdcard.img.gz;2;0;2;5.41 MB;2.70 MB
/snapshots/faillogs/arm_cortex-a5_vfpv4/packages/node/host-compile.txt;2;0;2;4.04 MB;2.02 MB
/releases/19.07.1/targets/oxnas/ox820/openwrt-19.07.1-oxnas-ox820-cloudengines_pogoplug-series-3-squashfs-sysupgrade.tar;2;0;2;5.03 MB;2.51 MB
/snapshots/faillogs/aarch64_generic/packages/perl-parse-recdescent/host-compile.txt;2;0;2;888 Bytes;444 Bytes
/releases/18.06.4/targets/omap/generic/openwrt-18.06.4-omap-am335x-boneblack-ext4-sdcard.img.gz;2;0;2;5.94 MB;2.97 MB
/releases/18.06.3/targets/x86/64/openwrt-18.06.3-x86-64-generic-rootfs.tar.gz;2;0;2;2.97 MB;1.49 MB
/releases/18.06.0/targets/sunxi/cortexa8/openwrt-18.06.0-sunxi-cortexa8-sun4i-a10-pcduino-squashfs-sdcard.img.gz;2;0;2;5.00 MB;2.50 MB
/releases/19.07.0-rc2/targets/sunxi/cortexa7/openwrt-19.07.0-rc2-sunxi-cortexa7-sun7i-a20-lamobo-r1-squashfs-sdcard.img.gz;2;0;2;5.65 MB;2.83 MB
/releases/18.06.3/targets/at91/sama5d2/openwrt-18.06.3-at91-sama5d2-at91-sama5d2_xplained-ext4-root.ubi.gz;2;0;2;2.49 MB;1.25 MB
/releases/17.01.0-rc1/targets/x86/64/lede-17.01.0-rc1-r3042-ec095b5-x86-64-generic-rootfs.tar.gz;2;0;2;2.85 MB;1.42 MB
/releases/18.06.5/targets/sunxi/cortexa8/openwrt-18.06.5-sunxi-cortexa8-sun5i-a13-olimex-som-squashfs-sdcard.img.gz;2;0;2;4.88 MB;2.44 MB
/releases/18.06.3/targets/armvirt/64/openwrt-18.06.3-armvirt-64-root.squashfs.gz;2;0;2;3.14 MB;1.57 MB
/releases/18.06.7/targets/at91/sama5d3/openwrt-18.06.7-at91-sama5d3-at91-sama5d3_xplained-ext4-zImage.gz;2;0;2;1.84 MB;943.54 KB
/releases/19.07.0/targets/mvebu/cortexa72/openwrt-19.07.0-mvebu-cortexa72-marvell_armada8040-db-squashfs-sdcard.img.gz;2;0;2;11.15 MB;5.58 MB
/releases/18.06.3/targets/at91/sama5d2/openwrt-18.06.3-at91-sama5d2-at91-sama5d2_ptc_ek-ext4-root.ubi.gz;2;0;2;2.49 MB;1.25 MB
/releases/19.07.2/targets/at91/sama5/openwrt-19.07.2-at91-sama5-at91-sama5d2_ptc_ek-ext4-sdcard.img.gz;2;0;2;6.11 MB;3.05 MB
/releases/18.06.3/targets/ramips/mt7621/openwrt-18.06.3-ramips-mt7621-ubnt-erx-sfp-squashfs-sysupgrade.tar;2;0;2;3.70 MB;1.85 MB
/releases/18.06.5/targets/sunxi/cortexa7/openwrt-18.06.5-sunxi-cortexa7-sun8i-h2-plus-orangepi-r1-ext4-sdcard.img.gz;2;0;2;5.44 MB;2.72 MB
/releases/19.07.0-rc1/targets/oxnas/ox820/openwrt-19.07.0-rc1-oxnas-ox820-cloudengines_pogoplugpro-squashfs-sysupgrade.tar;2;0;2;5.82 MB;2.91 MB
/releases/19.07.3/targets/brcm63xx/generic/openwrt-19.07.3-brcm63xx-generic-livebox-vmlinux.gz;2;0;2;2.44 MB;1.22 MB
/releases/19.07.2/targets/sunxi/cortexa7/openwrt-19.07.2-sunxi-cortexa7-sun7i-a20-bananapi-ext4-sdcard.img.gz;2;0;2;11.29 MB;5.64 MB
/snapshots/faillogs/mips_mips32/packages/node/host-compile.txt;2;0;2;4.30 MB;2.15 MB
/releases/18.06.6/targets/sunxi/cortexa8/openwrt-18.06.6-sunxi-cortexa8-sun5i-a13-olimex-som-ext4-sdcard.img.gz;2;0;2;5.84 MB;2.92 MB
/releases/17.01.7/targets/brcm63xx/generic/lede-17.01.7-brcm63xx-generic-livebox-vmlinux.gz;2;0;2;1.91 MB;975.87 KB
/releases/19.07.0-rc2/targets/sunxi/cortexa7/openwrt-19.07.0-rc2-sunxi-cortexa7-sun8i-h3-nanopi-m1-plus-ext4-sdcard.img.gz;2;0;2;7.19 MB;3.60 MB
/releases/17.01.2/targets/apm821xx/nand/lede-17.01.2-apm821xx-nand-mx60-squashfs-sysupgrade.tar;2;0;2;3.73 MB;1.87 MB
/releases/18.06.7/targets/at91/sama5d2/openwrt-18.06.7-at91-sama5d2-at91-sama5d27_som1_ek-ext4-sdcard.img.gz;2;0;2;5.73 MB;2.86 MB
/releases/19.07.3/targets/sunxi/cortexa7/openwrt-19.07.3-sunxi-cortexa7-sun8i-h3-orangepi-one-ext4-sdcard.img.gz;2;0;2;5.76 MB;2.88 MB
/releases/18.06.1/targets/brcm2708/bcm2708/openwrt-18.06.1-brcm2708-bcm2708-rpi-ext4-sysupgrade.img.gz;2;0;2;11.50 MB;5.75 MB
/releases/19.07.0/targets/oxnas/ox820/openwrt-19.07.0-oxnas-ox820-cloudengines_pogoplugpro-squashfs-sysupgrade.tar;2;0;2;5.64 MB;2.82 MB
/releases/17.01.4/targets/sunxi/generic/lede-17.01.4-sunxi-sun4i-a10-olinuxino-lime-ext4-sdcard.img.gz;2;0;2;527.50 KB;263.75 KB
/releases/18.06.3/targets/armvirt/32/openwrt-18.06.3-armvirt-32-root.ext4.gz;2;0;2;4.25 MB;2.12 MB
/releases/19.07.2/targets/at91/sam9x/openwrt-19.07.2-at91-sam9x-usb_a9263-ext4-factory.bin.gz;2;0;2;6.00 MB;3.00 MB
/releases/19.07.2/targets/at91/sama5/openwrt-19.07.2-at91-sama5-at91-sama5d27_som1_ek-ext4-zImage.gz;2;0;2;3.47 MB;1.73 MB
/releases/18.06.3/targets/armvirt/32/openwrt-18.06.3-armvirt-32-default-rootfs.tar.gz;2;0;2;3.71 MB;1.85 MB
/releases/17.01.2/targets/kirkwood/generic/lede-17.01.2-kirkwood-linksys-viper-squashfs-sysupgrade.tar;2;0;2;335.49 KB;167.75 KB
/releases/19.07.3/targets/layerscape/armv8_64b/openwrt-19.07.3-layerscape-armv8_64b-ls1046ardb-sdboot-ext4-sdcard.img.gz;2;0;2;8.44 MB;4.22 MB
/releases/19.07.2/targets/mvebu/cortexa53/openwrt-19.07.2-mvebu-cortexa53-marvell_armada-3720-db-squashfs-sdcard.img.gz;2;0;2;6.75 MB;3.37 MB
/releases/18.06-SNAPSHOT/targets/at91/legacy/openwrt-18.06-snapshot-r8080-9f2a40c72f-at91-legacy-usb_a9260-ext4-factory.bin.gz;2;0;2;10.98 MB;5.49 MB
/releases/19.07.2/targets/sunxi/cortexa7/openwrt-19.07.2-sunxi-cortexa7-sun7i-a20-bananapi-squashfs-sdcard.img.gz;2;0;2;9.59 MB;4.80 MB
/releases/18.06.0-rc1/targets/sunxi/cortexa7/openwrt-18.06.0-rc1-sunxi-cortexa7-sun6i-a31-m9-ext4-sdcard.img.gz;2;0;2;8.06 MB;4.03 MB
/releases/19.07.0-rc2/targets/sunxi/cortexa8/openwrt-19.07.0-rc2-sunxi-cortexa8-sun4i-a10-cubieboard-ext4-sdcard.img.gz;2;0;2;5.64 MB;2.82 MB
/releases/17.01.0-rc2/targets/sunxi/generic/lede-17.01.0-rc2-r3131-42f3c1f-sunxi-sun7i-a20-cubietruck-ext4-sdcard.img.gz;2;0;2;2.64 MB;1.32 MB
/releases/18.06.0/targets/oxnas/ox820/openwrt-18.06.0-oxnas-ox820-shuttle-kd20-squashfs-sysupgrade.tar;2;0;2;5.41 MB;2.71 MB
/releases/17.01.5/targets/sunxi/generic/lede-17.01.5-sunxi-sun7i-a20-bananapro-squashfs-sdcard.img.gz;2;0;2;4.74 MB;2.37 MB
/releases/17.01.0-rc2/targets/sunxi/generic/lede-17.01.0-rc2-r3131-42f3c1f-sunxi-sun4i-a10-pcduino-squashfs-sdcard.img.gz;2;0;2;2.78 MB;1.39 MB
/releases/17.01.0/targets/sunxi/generic/lede-17.01.0-r3205-59508e3-sunxi-sun6i-a31-m9-squashfs-sdcard.img.gz;2;0;2;351.50 KB;175.75 KB
/releases/19.07.2/targets/sunxi/cortexa8/openwrt-19.07.2-sunxi-cortexa8-sun4i-a10-marsboard-squashfs-sdcard.img.gz;2;0;2;9.44 MB;4.72 MB
/releases/19.07.2/targets/sunxi/cortexa8/openwrt-19.07.2-sunxi-cortexa8-sun4i-a10-olinuxino-lime-squashfs-sdcard.img.gz;2;0;2;9.44 MB;4.72 MB
/releases/19.07.3/targets/archs38/generic/openwrt-19.07.3-archs38-generic-root.ext4.gz;2;0;2;2.95 MB;1.47 MB
/releases/19.07.0/targets/armvirt/64/openwrt-19.07.0-armvirt-64-root.ext4.gz;2;0;2;4.62 MB;2.31 MB
/releases/18.06.4/targets/omap/generic/openwrt-18.06.4-omap-omap4-panda-ubifs-sdcard.img.gz;2;0;2;6.05 MB;3.03 MB
/releases/17.01.0-rc2/targets/gemini/raidsonic/lede-17.01.0-rc2-r3131-42f3c1f-gemini-raidsonic-nas4220-rd.gz;2;0;2;4.39 MB;2.20 MB
/releases/18.06.1/targets/at91/legacy/openwrt-18.06.1-at91-legacy-at91sam9x35ek-ext4-root.ubi.gz;2;0;2;2.60 MB;1.30 MB
/releases/18.06.5/targets/sunxi/cortexa7/openwrt-18.06.5-sunxi-cortexa7-sun8i-h3-nanopi-m1-plus-squashfs-sdcard.img.gz;2;0;2;5.61 MB;2.81 MB
/releases/17.01.0-rc1/targets/kirkwood/generic/lede-17.01.0-rc1-r3042-ec095b5-kirkwood-goflexnet-squashfs-sysupgrade.tar;2;0;2;2.78 MB;1.39 MB
/releases/18.06.1/targets/armvirt/64/openwrt-18.06.1-armvirt-64-root.squashfs.gz;2;0;2;3.14 MB;1.57 MB
/releases/18.06.0/targets/sunxi/cortexa7/openwrt-18.06.0-sunxi-cortexa7-sun7i-a20-olinuxino-micro-squashfs-sdcard.img.gz;2;0;2;4.63 MB;2.31 MB
/releases/19.07.0-rc2/targets/mvebu/cortexa53/openwrt-19.07.0-rc2-mvebu-cortexa53-globalscale_espressobin-v7-ext4-sdcard.img.gz;2;0;2;6.51 MB;3.26 MB
/releases/19.07.0-rc2/targets/sunxi/cortexa7/openwrt-19.07.0-rc2-sunxi-cortexa7-sun8i-h3-bananapi-m2-plus-ext4-sdcard.img.gz;2;0;2;7.21 MB;3.61 MB
/releases/18.06.6/targets/sunxi/cortexa7/openwrt-18.06.6-sunxi-cortexa7-sun8i-h2-plus-orangepi-r1-ext4-sdcard.img.gz;2;0;2;5.43 MB;2.71 MB
/releases/18.06.6/targets/at91/legacy/openwrt-18.06.6-at91-legacy-at91sam9g35ek-ext4-root.ubi.gz;2;0;2;2.50 MB;1.25 MB
/releases/18.06.0/targets/sunxi/cortexa53/openwrt-18.06.0-sunxi-cortexa53-sun50i-h5-nanopi-neo-plus2-squashfs-sdcard.img.gz;2;0;2;5.87 MB;2.93 MB
/releases/19.07.3/targets/brcm63xx/smp/openwrt-19.07.3-brcm63xx-smp-livebox-vmlinux.gz;2;0;2;2.56 MB;1.28 MB
/releases/18.06.0-rc1/targets/gemini/generic/openwrt-18.06.0-rc1-gemini-sysupgrade-ib4220b.tar.gz;2;0;2;20.63 MB;10.31 MB
/releases/18.06.3/targets/at91/sama5d4/openwrt-18.06.3-at91-sama5d4-at91-sama5d4_xplained-ext4-zImage.gz;2;0;2;3.20 MB;1.60 MB
/releases/18.06.7/targets/mvebu/cortexa9/openwrt-18.06.7-mvebu-cortexa9-turris-omnia-sysupgrade.img.gz;2;0;2;5.37 MB;2.68 MB
/releases/18.06.3/targets/sunxi/cortexa8/openwrt-18.06.3-sunxi-cortexa8-sun4i-a10-olinuxino-lime-squashfs-sdcard.img.gz;2;0;2;4.57 MB;2.29 MB
/releases/18.06.6/targets/sunxi/cortexa7/openwrt-18.06.6-sunxi-cortexa7-sun7i-a20-olinuxino-lime2-ext4-sdcard.img.gz;2;0;2;5.57 MB;2.79 MB
/releases/18.06.3/targets/mvebu/cortexa53/openwrt-18.06.3-mvebu-cortexa53-globalscale-espressobin-ext4-sdcard.img.gz;2;0;2;6.29 MB;3.15 MB
/releases/18.06.3/targets/at91/legacy/openwrt-18.06.3-at91-legacy-at91sam9g15ek-ext4-root.ubi.gz;2;0;2;2.51 MB;1.26 MB
/releases/18.06.5/targets/at91/sama5d2/openwrt-18.06.5-at91-sama5d2-at91-sama5d2_ptc_ek-ext4-root.ubi.gz;2;0;2;2.48 MB;1.24 MB
/releases/18.06.2/targets/at91/legacy/openwrt-18.06.2-at91-legacy-at91sam9g20ek-ext4-zImage.gz;2;0;2;3.24 MB;1.62 MB
/releases/17.01.2/targets/oxnas/generic/lede-17.01.2-oxnas-stg212-ubifs-sysupgrade.tar;2;0;2;351.50 KB;175.75 KB
/releases/18.06.3/targets/sunxi/cortexa7/openwrt-18.06.3-sunxi-cortexa7-sun8i-h3-nanopi-neo-ext4-sdcard.img.gz;2;0;2;5.40 MB;2.70 MB
/releases/17.01.4/targets/sunxi/generic/lede-17.01.4-sunxi-sun8i-h3-orangepi-plus-ext4-sdcard.img.gz;2;0;2;559.50 KB;279.75 KB
/releases/18.06.6/targets/brcm63xx/generic/openwrt-18.06.6-brcm63xx-generic-livebox-vmlinux.gz;2;0;2;1.44 MB;735.54 KB
/releases/18.06.1/targets/sunxi/cortexa53/openwrt-18.06.1-sunxi-cortexa53-sun50i-a64-pine64-plus-ext4-sdcard.img.gz;2;0;2;6.51 MB;3.25 MB
/releases/17.01.1/targets/archs38/generic/lede-17.01.1-archs38-generic-root.ext4.gz;2;0;2;2.70 MB;1.35 MB
/releases/19.07.0/targets/mvebu/cortexa72/openwrt-19.07.0-mvebu-cortexa72-marvell_armada7040-db-squashfs-sdcard.img.gz;2;0;2;11.15 MB;5.58 MB
/snapshots/faillogs/i386_pentium4/packages/frr/host-compile.txt;2;0;2;15.90 KB;7.95 KB
/releases/18.06.2/targets/armvirt/64/openwrt-18.06.2-armvirt-64-root.squashfs.gz;2;0;2;3.14 MB;1.57 MB
/releases/18.06.4/targets/at91/legacy/openwrt-18.06.4-at91-legacy-at91sam9g20ek_2mmc-ext4-zImage.gz;2;0;2;3.24 MB;1.62 MB
/releases/19.07.0-rc2/targets/sunxi/cortexa7/openwrt-19.07.0-rc2-sunxi-cortexa7-sun8i-h2-plus-orangepi-zero-ext4-sdcard.img.gz;2;0;2;5.85 MB;2.92 MB
/releases/19.07.2/targets/at91/sam9x/openwrt-19.07.2-at91-sam9x-at91sam9g35ek-ext4-root.ubi.gz;2;0;2;2.64 MB;1.32 MB
/releases/17.01.2/targets/zynq/generic/lede-17.01.2-zynq-zybo-uramdisk.image.gz;2;0;2;831.50 KB;415.75 KB
/releases/17.01.0/targets/sunxi/generic/lede-17.01.0-r3205-59508e3-sunxi-sun7i-a20-cubieboard2-ext4-sdcard.img.gz;2;0;2;431.50 KB;215.75 KB
/releases/18.06.2/targets/at91/legacy/openwrt-18.06.2-at91-legacy-at91sam9x25ek-ext4-root.ubi.gz;2;0;2;2.49 MB;1.25 MB
/releases/19.07.0/targets/mvebu/cortexa9/openwrt-19.07.0-mvebu-cortexa9-solidrun_clearfog-pro-a1-squashfs-sdcard.img.gz;2;0;2;9.44 MB;4.72 MB
/releases/19.07.1/targets/x86/generic/openwrt-19.07.1-x86-generic-rootfs-squashfs.img.gz;2;0;2;3.03 MB;1.52 MB
/releases/18.06.0-rc1/targets/sunxi/cortexa7/openwrt-18.06.0-rc1-sunxi-cortexa7-sun6i-a31-m9-squashfs-sdcard.img.gz;2;0;2;5.00 MB;2.50 MB
/releases/18.06.6/targets/omap/generic/openwrt-18.06.6-omap-omap3-beagle-ubifs-sdcard.img.gz;2;0;2;6.20 MB;3.10 MB
/releases/19.07.0-rc1/targets/arc770/generic/openwrt-19.07.0-rc1-arc770-generic-Default-sdcard-vfat-ext4.img.gz;2;0;2;5.94 MB;2.97 MB
/releases/18.06.2/targets/at91/sama5d4/openwrt-18.06.2-at91-sama5d4-at91-sama5d4_xplained-ext4-root.ubi.gz;2;0;2;2.44 MB;1.22 MB
/releases/18.06.6/targets/sunxi/cortexa53/openwrt-18.06.6-sunxi-cortexa53-sun50i-a64-sopine-baseboard-squashfs-sdcard.img.gz;2;0;2;5.78 MB;2.89 MB
/releases/18.06.6/targets/sunxi/cortexa7/openwrt-18.06.6-sunxi-cortexa7-sun8i-h3-orangepi-pc-ext4-sdcard.img.gz;2;0;2;5.41 MB;2.71 MB
/releases/18.06.0-rc2/targets/ar71xx/nand/openwrt-18.06.0-rc2-ar71xx-nand-wi2a-ac200i-squashfs-sysupgrade.tar;2;0;2;6.96 MB;3.48 MB
/releases/18.06.6/targets/at91/legacy/openwrt-18.06.6-at91-legacy-at91sam9g15ek-ext4-root.ubi.gz;2;0;2;2.51 MB;1.26 MB
/releases/17.01.5/targets/sunxi/generic/lede-17.01.5-sunxi-sun5i-a13-olimex-som-ext4-sdcard.img.gz;2;0;2;5.33 MB;2.67 MB
/releases/18.06.1/targets/x86/geode/openwrt-18.06.1-x86-geode-combined-squashfs.img.gz;2;0;2;6.21 MB;3.10 MB
/releases/18.06.2/targets/mvebu/cortexa72/openwrt-18.06.2-mvebu-cortexa72-armada-macchiatobin-ext4-sdcard.img.gz;2;0;2;6.32 MB;3.16 MB
/releases/17.01.4/targets/kirkwood/generic/lede-17.01.4-kirkwood-dockstar-squashfs-sysupgrade.tar;2;0;2;271.50 KB;135.75 KB
/releases/18.06.6/targets/sunxi/cortexa7/openwrt-18.06.6-sunxi-cortexa7-sun7i-a20-olinuxino-micro-squashfs-sdcard.img.gz;2;0;2;4.65 MB;2.33 MB
/releases/19.07.2/targets/sunxi/cortexa8/openwrt-19.07.2-sunxi-cortexa8-sun4i-a10-cubieboard-squashfs-sdcard.img.gz;2;0;2;9.44 MB;4.72 MB
/releases/18.06.2/targets/sunxi/cortexa7/openwrt-18.06.2-sunxi-cortexa7-sun8i-h3-orangepi-plus-ext4-sdcard.img.gz;2;0;2;5.40 MB;2.70 MB
/releases/18.06.0-rc1/targets/ar71xx/generic/openwrt-18.06.0-rc1-ar71xx-generic-vmlinux.lzma;2;0;2;1.72 MB;879.77 KB
/releases/18.06.5/targets/at91/legacy/openwrt-18.06.5-at91-legacy-usb_a9263-ext4-factory.bin.gz;2;0;2;5.64 MB;2.82 MB
/releases/18.06.3/targets/sunxi/cortexa53/openwrt-18.06.3-sunxi-cortexa53-sun50i-h5-nanopi-neo-plus2-ext4-sdcard.img.gz;2;0;2;6.56 MB;3.28 MB
/snapshots/faillogs/mips_24kc/packages/node/host-compile.txt;2;0;2;4.02 MB;2.01 MB
/releases/19.07.2/targets/oxnas/ox820/openwrt-19.07.2-oxnas-ox820-mitrastar_stg-212-ubifs-sysupgrade.tar;2;0;2;2.47 MB;1.23 MB
/releases/18.06.2/targets/at91/legacy/openwrt-18.06.2-at91-legacy-usb_a9263-ext4-factory.bin.gz;2;0;2;5.62 MB;2.81 MB
/snapshots/faillogs/mipsel_mips32/packages/node/host-compile.txt;2;0;2;4.03 MB;2.01 MB
/releases/19.07.2/targets/at91/sama5/openwrt-19.07.2-at91-sama5-at91-sama5d4_xplained-ext4-zImage.gz;2;0;2;3.65 MB;1.83 MB
/releases/17.01.1/targets/x86/legacy/lede-17.01.1-x86-legacy-rootfs-ext4.img.gz;2;0;2;319.50 KB;159.75 KB
/releases/17.01.5/targets/sunxi/generic/lede-17.01.5-sunxi-sun7i-a20-olinuxino-micro-squashfs-sdcard.img.gz;2;0;2;4.15 MB;2.08 MB
/releases/18.06.3/targets/at91/sama5d2/openwrt-18.06.3-at91-sama5d2-at91-sama5d2_ptc_ek-ext4-sdcard.img.gz;2;0;2;5.73 MB;2.87 MB
/releases/18.06.6/targets/octeon/generic/openwrt-18.06.6-octeon-er-squashfs-sysupgrade.tar;2;0;2;9.08 MB;4.54 MB
/releases/19.07.1/targets/at91/sam9x/openwrt-19.07.1-at91-sam9x-at91sam9263ek-ext4-root.ubi.gz;2;0;2;2.64 MB;1.32 MB
/releases/17.01.0-rc1/targets/ar71xx/mikrotik/lede-17.01.0-rc1-r3042-ec095b5-ar71xx-mikrotik-defaultnowifi-rootfs.tar.gz;2;0;2;2.62 MB;1.31 MB
/releases/19.07.0/targets/archs38/generic/openwrt-19.07.0-archs38-generic-root.ext4.gz;2;0;2;5.75 MB;2.88 MB
/releases/18.06.6/targets/ar71xx/nand/openwrt-18.06.6-ar71xx-nand-wndr3700v4-squashfs-sysupgrade.tar;2;0;2;4.67 MB;2.33 MB
/releases/19.07.3/targets/omap/generic/openwrt-19.07.3-omap-ti_omap3-beagle-ext4-sdcard.img.gz;2;0;2;6.82 MB;3.41 MB
/releases/17.01.5/targets/sunxi/generic/lede-17.01.5-sunxi-sun4i-a10-cubieboard-squashfs-sdcard.img.gz;2;0;2;4.13 MB;2.07 MB
/releases/17.01.0/targets/sunxi/generic/lede-17.01.0-r3205-59508e3-sunxi-sun4i-a10-cubieboard-squashfs-sdcard.img.gz;2;0;2;639.50 KB;319.75 KB
/releases/18.06.2/targets/sunxi/cortexa7/openwrt-18.06.2-sunxi-cortexa7-sun7i-a20-bananapro-ext4-sdcard.img.gz;2;0;2;6.21 MB;3.11 MB
/releases/19.07.1/targets/at91/sama5/openwrt-19.07.1-at91-sama5-at91-sama5d2_ptc_ek-ext4-root.ubi.gz;2;0;2;2.62 MB;1.31 MB
/releases/18.06.0/targets/brcm2708/bcm2710/openwrt-18.06.0-brcm2708-bcm2710-rpi-3-ext4-sysupgrade.img.gz;2;0;2;17.61 MB;8.80 MB
/releases/18.06.0/targets/sunxi/cortexa7/openwrt-18.06.0-sunxi-cortexa7-sun6i-a31-m9-squashfs-sdcard.img.gz;2;0;2;4.86 MB;2.43 MB
/releases/17.01.0-rc1/targets/oxnas/generic/lede-17.01.0-rc1-r3042-ec095b5-oxnas-akitio-ubifs-sysupgrade.tar;2;0;2;3.37 MB;1.69 MB
/releases/18.06.7/targets/ar71xx/nand/openwrt-18.06.7-ar71xx-nand-wndr4300-squashfs-sysupgrade.tar;2;0;2;4.82 MB;2.41 MB
/releases/17.01.4/targets/zynq/generic/lede-17.01.4-zynq-zybo-uramdisk.image.gz;2;0;2;303.50 KB;151.75 KB
/releases/19.07.0/targets/mediatek/mt7623/openwrt-19.07.0-mediatek-mt7623-7623a-unielec-u7623-02-emmc-512m-squashfs-sysupgrade-emmc.bin.gz;2;0;2;10.05 MB;5.03 MB
/releases/19.07.0-rc2/targets/at91/sama5/openwrt-19.07.0-rc2-at91-sama5-at91-sama5d4_xplained-ext4-sdcard.img.gz;2;0;2;6.24 MB;3.12 MB
/releases/18.06.6/targets/sunxi/cortexa53/openwrt-18.06.6-sunxi-cortexa53-sun50i-h5-orangepi-zero-plus-ext4-sdcard.img.gz;2;0;2;6.48 MB;3.24 MB
/releases/17.01.4/targets/octeon/generic/lede-17.01.4-octeon-er-squashfs-sysupgrade.tar;2;0;2;2.52 MB;1.26 MB
/releases/18.06.7/targets/at91/sama5d2/openwrt-18.06.7-at91-sama5d2-at91-sama5d27_som1_ek-ext4-zImage.gz;2;0;2;3.22 MB;1.61 MB
/releases/18.06.3/targets/sunxi/cortexa7/openwrt-18.06.3-sunxi-cortexa7-sun6i-a31-m9-ext4-sdcard.img.gz;2;0;2;5.92 MB;2.96 MB
/releases/19.07.0/targets/oxnas/ox820/openwrt-19.07.0-oxnas-ox820-mitrastar_stg-212-ubifs-sysupgrade.tar;2;0;2;9.18 MB;4.59 MB
/releases/18.06.3/targets/sunxi/cortexa7/openwrt-18.06.3-sunxi-cortexa7-sun8i-h3-orangepi-2-ext4-sdcard.img.gz;2;0;2;5.42 MB;2.71 MB
/releases/19.07.2/targets/at91/sam9x/openwrt-19.07.2-at91-sam9x-wb45n-ext4-root.ubi.gz;2;0;2;3.88 MB;1.94 MB
/releases/17.01.1/targets/apm821xx/nand/lede-17.01.1-apm821xx-nand-WNDR4700-squashfs-sysupgrade.tar;2;0;2;4.51 MB;2.26 MB
/releases/18.06.0/targets/armvirt/32/openwrt-18.06.0-armvirt-32-rootfs.cpio.gz;2;0;2;3.71 MB;1.85 MB
/releases/18.06.0-rc1/targets/ar71xx/nand/openwrt-18.06.0-rc1-ar71xx-nand-mr18-squashfs-sysupgrade.tar;2;0;2;9.12 MB;4.56 MB
/releases/18.06.5/targets/oxnas/ox820/openwrt-18.06.5-oxnas-ox820-cloudengines-pogoplug-pro-ubifs-sysupgrade.tar;2;0;2;7.96 MB;3.98 MB
/releases/18.06.4/targets/oxnas/ox820/openwrt-18.06.4-oxnas-ox820-cloudengines-pogoplug-pro-ubifs-sysupgrade.tar;2;0;2;7.96 MB;3.98 MB
/releases/18.06.6/targets/at91/sama5d2/openwrt-18.06.6-at91-sama5d2-at91-sama5d2_xplained-ext4-root.ubi.gz;2;0;2;2.48 MB;1.24 MB
/releases/18.06.7/targets/ar71xx/nand/openwrt-18.06.7-ar71xx-nand-rambutan-squashfs-sysupgrade.tar;2;0;2;3.99 MB;2.00 MB
/releases/17.01.1/targets/omap/generic/lede-17.01.1-omap-default-rootfs.tar.gz;2;0;2;431.50 KB;215.75 KB
/releases/18.06.2/targets/omap/generic/openwrt-18.06.2-omap-am335x-evm-ubifs-sdcard.img.gz;2;0;2;1.47 MB;751.54 KB
/releases/17.01.0-rc1/targets/kirkwood/generic/lede-17.01.0-rc1-r3042-ec095b5-kirkwood-iconnect-squashfs-sysupgrade.tar;2;0;2;3.20 MB;1.60 MB
/releases/18.06.6/targets/at91/legacy/openwrt-18.06.6-at91-legacy-at91sam9x25ek-ext4-root.ubi.gz;2;0;2;2.51 MB;1.26 MB
/releases/19.07.2/targets/sunxi/cortexa53/openwrt-19.07.2-sunxi-cortexa53-sun50i-h5-orangepi-pc2-ext4-sdcard.img.gz;2;0;2;13.61 MB;6.80 MB
/releases/19.07.3/targets/sunxi/cortexa7/openwrt-19.07.3-sunxi-cortexa7-sun7i-a20-lamobo-r1-squashfs-sdcard.img.gz;2;0;2;5.51 MB;2.76 MB
/releases/18.06.0-rc1/targets/octeon/generic/openwrt-18.06.0-rc1-octeon-erlite-squashfs-sysupgrade.tar;2;0;2;11.81 MB;5.91 MB
/releases/18.06.1/targets/sunxi/cortexa7/openwrt-18.06.1-sunxi-cortexa7-sun6i-a31-m9-ext4-sdcard.img.gz;2;0;2;5.90 MB;2.95 MB
/releases/18.06.5/targets/at91/sama5d4/openwrt-18.06.5-at91-sama5d4-at91-sama5d4_xplained-ext4-zImage.gz;2;0;2;3.21 MB;1.61 MB
/releases/18.06.5/targets/sunxi/cortexa8/openwrt-18.06.5-sunxi-cortexa8-sun5i-a13-olinuxino-ext4-sdcard.img.gz;2;0;2;5.86 MB;2.93 MB
/releases/17.01.5/targets/sunxi/generic/lede-17.01.5-sunxi-sun6i-a31-m9-squashfs-sdcard.img.gz;2;0;2;4.49 MB;2.24 MB
/releases/18.06.2/targets/sunxi/cortexa7/openwrt-18.06.2-sunxi-cortexa7-sun7i-a20-olinuxino-micro-ext4-sdcard.img.gz;2;0;2;5.48 MB;2.74 MB
/releases/18.06.7/targets/oxnas/ox820/openwrt-18.06.7-oxnas-ox820-akitio-mycloud-ubifs-sysupgrade.tar;2;0;2;8.33 MB;4.16 MB
/releases/17.01.5/targets/sunxi/generic/lede-17.01.5-sunxi-sun7i-a20-lamobo-r1-squashfs-sdcard.img.gz;2;0;2;4.71 MB;2.36 MB
/releases/18.06.0/targets/omap/generic/openwrt-18.06.0-omap-omap4-panda-ext4-sdcard.img.gz;2;0;2;5.82 MB;2.91 MB
/releases/19.07.0-rc2/targets/at91/sama5/openwrt-19.07.0-rc2-at91-sama5-at91-sama5d4_xplained-ext4-zImage.gz;2;0;2;3.49 MB;1.75 MB
/releases/19.07.0/targets/armvirt/32/openwrt-19.07.0-armvirt-32-rootfs.cpio.gz;2;0;2;40 Bytes;20 Bytes
/releases/18.06.0/targets/sunxi/cortexa8/openwrt-18.06.0-sunxi-cortexa8-sun5i-a13-olinuxino-ext4-sdcard.img.gz;2;0;2;5.84 MB;2.92 MB
/releases/17.01.1/targets/sunxi/generic/lede-17.01.1-sunxi-sun5i-a13-olimex-som-ext4-sdcard.img.gz;2;0;2;319.50 KB;159.75 KB
/releases/17.01.1/targets/sunxi/generic/lede-17.01.1-sunxi-sun7i-a20-bananapi-squashfs-sdcard.img.gz;2;0;2;543.50 KB;271.75 KB
/releases/18.06.2/targets/sunxi/cortexa7/openwrt-18.06.2-sunxi-cortexa7-sun7i-a20-olinuxino-lime2-emmc-squashfs-sdcard.img.gz;2;0;2;4.71 MB;2.36 MB
/releases/18.06.2/targets/sunxi/cortexa8/openwrt-18.06.2-sunxi-cortexa8-sun5i-a13-olinuxino-ext4-sdcard.img.gz;2;0;2;5.85 MB;2.92 MB
/snapshots/faillogs/arm_cortex-a9_vfpv3-d16/packages/node/host-compile.txt;2;0;2;4.05 MB;2.03 MB
/releases/18.06.0/targets/sunxi/cortexa7/openwrt-18.06.0-sunxi-cortexa7-sun7i-a20-olinuxino-lime2-squashfs-sdcard.img.gz;2;0;2;4.70 MB;2.35 MB
/releases/18.06.4/targets/sunxi/cortexa7/openwrt-18.06.4-sunxi-cortexa7-sun7i-a20-pcduino3-ext4-sdcard.img.gz;2;0;2;5.91 MB;2.95 MB
/releases/17.01.2/targets/zynq/generic/lede-17.01.2-zynq-zc702-uramdisk.image.gz;2;0;2;335.50 KB;167.75 KB
/releases/17.01.4/targets/oxnas/generic/lede-17.01.4-oxnas-akitio-ubifs-sysupgrade.tar;2;0;2;207.50 KB;103.75 KB
/releases/18.06.4/targets/x86/generic/openwrt-18.06.4-x86-generic-rootfs-squashfs.img.gz;2;0;2;2.44 MB;1.22 MB
/releases/19.07.2/targets/sunxi/cortexa7/openwrt-19.07.2-sunxi-cortexa7-sun8i-h3-orangepi-plus-ext4-sdcard.img.gz;2;0;2;11.22 MB;5.61 MB
/releases/18.06.3/targets/sunxi/cortexa7/openwrt-18.06.3-sunxi-cortexa7-sun7i-a20-olinuxino-micro-squashfs-sdcard.img.gz;2;0;2;4.65 MB;2.32 MB
/releases/18.06.2/targets/sunxi/cortexa7/openwrt-18.06.2-sunxi-cortexa7-sun7i-a20-olinuxino-lime-ext4-sdcard.img.gz;2;0;2;5.47 MB;2.73 MB
/releases/18.06.5/targets/at91/legacy/openwrt-18.06.5-at91-legacy-at91sam9g35ek-ext4-root.ubi.gz;2;0;2;2.51 MB;1.26 MB
/releases/17.01.2/targets/sunxi/generic/lede-17.01.2-sunxi-sun7i-a20-cubietruck-ext4-sdcard.img.gz;2;0;2;607.50 KB;303.75 KB
/releases/18.06.2/targets/sunxi/cortexa7/openwrt-18.06.2-sunxi-cortexa7-sun7i-a20-cubietruck-ext4-sdcard.img.gz;2;0;2;6.22 MB;3.11 MB
/releases/19.07.0-rc2/targets/sunxi/cortexa7/openwrt-19.07.0-rc2-sunxi-cortexa7-sun7i-a20-cubietruck-ext4-sdcard.img.gz;2;0;2;6.52 MB;3.26 MB
/releases/17.01.5/targets/x86/geode/lede-17.01.5-x86-geode-rootfs-ext4.img.gz;2;0;2;4.56 MB;2.28 MB
/snapshots/targets/scheduled_for_removal/ar71xx/generic/openwrt-ar71xx-generic-vmlinux.lzma;2;0;2;175.54 KB;87.77 KB
/releases/18.06.5/targets/at91/sama5d2/openwrt-18.06.5-at91-sama5d2-at91-sama5d2_ptc_ek-ext4-sdcard.img.gz;2;0;2;5.75 MB;2.87 MB
/releases/18.06.3/targets/sunxi/cortexa7/openwrt-18.06.3-sunxi-cortexa7-sun8i-h3-orangepi-2-squashfs-sdcard.img.gz;2;0;2;4.60 MB;2.30 MB
/releases/17.01.2/targets/oxnas/generic/lede-17.01.2-oxnas-kd20-ubifs-sysupgrade.tar;2;0;2;415.50 KB;207.75 KB
/releases/18.06.5/targets/omap/generic/openwrt-18.06.5-omap-am335x-boneblack-ext4-sdcard.img.gz;2;0;2;5.93 MB;2.96 MB
/releases/18.06.1/targets/brcm2708/bcm2709/openwrt-18.06.1-brcm2708-bcm2709-rpi-2-squashfs-sysupgrade.img.gz;2;0;2;10.10 MB;5.05 MB
/releases/18.06.6/targets/sunxi/cortexa7/openwrt-18.06.6-sunxi-cortexa7-sun7i-a20-cubietruck-ext4-sdcard.img.gz;2;0;2;6.24 MB;3.12 MB
/releases/19.07.3/targets/sunxi/cortexa53/openwrt-19.07.3-sunxi-cortexa53-sun50i-h5-orangepi-pc2-ext4-sdcard.img.gz;2;0;2;6.95 MB;3.48 MB
/releases/18.06.4/targets/imx6/generic/openwrt-18.06.4-imx6-rootfs.tar.gz;2;0;2;2.09 MB;1.05 MB
/releases/19.07.2/targets/omap/generic/openwrt-19.07.2-omap-ti_omap3-beagle-squashfs-sdcard.img.gz;2;0;2;1.45 MB;743.54 KB
/releases/18.06.0/targets/sunxi/cortexa8/openwrt-18.06.0-sunxi-cortexa8-sun5i-a13-olimex-som-squashfs-sdcard.img.gz;2;0;2;4.80 MB;2.40 MB
/releases/18.06.2/targets/at91/legacy/openwrt-18.06.2-at91-legacy-at91sam9g20ek_2mmc-ext4-zImage.gz;2;0;2;3.22 MB;1.61 MB
/releases/18.06.3/targets/at91/sama5d3/openwrt-18.06.3-at91-sama5d3-at91-sama5d3_xplained-ext4-root.ubi.gz;2;0;2;2.49 MB;1.25 MB
/releases/18.06.0-rc2/targets/brcm2708/bcm2708/openwrt-18.06.0-rc2-brcm2708-bcm2708-rpi-squashfs-sdcard.img.gz;2;0;2;1.67 MB;855.54 KB
/releases/17.01.0-rc2/targets/sunxi/generic/lede-17.01.0-rc2-r3131-42f3c1f-sunxi-sun7i-a20-bananapi-squashfs-sdcard.img.gz;2;0;2;2.86 MB;1.43 MB
/releases/17.01.1/targets/sunxi/generic/lede-17.01.1-sunxi-sun4i-a10-pcduino-squashfs-sdcard.img.gz;2;0;2;239.50 KB;119.75 KB
/releases/19.07.1/targets/oxnas/ox820/openwrt-19.07.1-oxnas-ox820-shuttle_kd20-squashfs-sysupgrade.tar;2;0;2;5.65 MB;2.83 MB
/releases/19.07.2/targets/mxs/generic/openwrt-19.07.2-mxs-root.ext4.gz;2;0;2;1.44 MB;735.54 KB
/releases/19.07.1/targets/brcm2708/bcm2708/openwrt-19.07.1-brcm2708-bcm2708-rpi-ext4-sysupgrade.img.gz;2;0;2;23.01 MB;11.51 MB
/releases/18.06.6/targets/sunxi/cortexa8/openwrt-18.06.6-sunxi-cortexa8-sun4i-a10-cubieboard-squashfs-sdcard.img.gz;2;0;2;4.50 MB;2.25 MB
/releases/19.07.0/targets/mvebu/cortexa53/openwrt-19.07.0-mvebu-cortexa53-globalscale_espressobin-v7-emmc-squashfs-sdcard.img.gz;2;0;2;11.11 MB;5.56 MB
/releases/17.01.7/targets/sunxi/generic/lede-17.01.7-sunxi-sun7i-a20-olinuxino-lime-squashfs-sdcard.img.gz;2;0;2;463.50 KB;231.75 KB
/releases/17.01.3/targets/armvirt/generic/lede-17.01.3-armvirt-root.ext4.gz;2;0;2;2.06 MB;1.03 MB
/releases/18.06.0/targets/sunxi/cortexa53/openwrt-18.06.0-sunxi-cortexa53-sun50i-h5-nanopi-neo-plus2-ext4-sdcard.img.gz;2;0;2;6.51 MB;3.26 MB
/releases/17.01.5/targets/ath25/generic/lede-17.01.5-ath25-generic-kernel.gz;2;0;2;1.91 MB;975.88 KB
/releases/18.06.1/targets/sunxi/cortexa7/openwrt-18.06.1-sunxi-cortexa7-sun7i-a20-olinuxino-lime2-squashfs-sdcard.img.gz;2;0;2;4.70 MB;2.35 MB
/releases/19.07.2/targets/at91/sama5/openwrt-19.07.2-at91-sama5-at91-sama5d2_xplained-ext4-zImage.gz;2;0;2;4.06 MB;2.03 MB
/releases/18.06.3/targets/at91/sama5d3/openwrt-18.06.3-at91-sama5d3-rootfs.tar.gz;2;0;2;2.11 MB;1.05 MB
/releases/18.06.7/targets/oxnas/ox820/openwrt-18.06.7-oxnas-ox820-cloudengines-pogoplug-pro-ubifs-sysupgrade.tar;2;0;2;7.94 MB;3.97 MB
/releases/18.06.0-rc2/targets/oxnas/ox820/openwrt-18.06.0-rc2-oxnas-ox820-akitio-mycloud-squashfs-sysupgrade.tar;2;0;2;7.61 MB;3.81 MB
/releases/17.01.6/targets/arc770/generic/lede-17.01.6-arc770-generic-Default-sdcard-vfat-ext4.img.gz;2;0;2;5.58 MB;2.79 MB
/releases/19.07.0-rc2/targets/sunxi/cortexa8/openwrt-19.07.0-rc2-sunxi-cortexa8-sun4i-a10-marsboard-ext4-sdcard.img.gz;2;0;2;5.75 MB;2.87 MB
/releases/18.06.2/targets/mvebu/cortexa53/openwrt-18.06.2-mvebu-cortexa53-globalscale-espressobin-ext4-sdcard.img.gz;2;0;2;6.28 MB;3.14 MB
/releases/19.07.1/targets/at91/sama5/openwrt-19.07.1-at91-sama5-at91-sama5d2_xplained-ext4-root.ubi.gz;2;0;2;2.76 MB;1.38 MB
/releases/18.06.3/targets/brcm2708/bcm2708/openwrt-18.06.3-brcm2708-bcm2708-rpi-ext4-sysupgrade.img.gz;2;0;2;8.87 MB;4.43 MB
/releases/17.01.5/targets/apm821xx/nand/lede-17.01.5-apm821xx-nand-WNDR4700-squashfs-sysupgrade.tar;2;0;2;7.67 MB;3.83 MB
/releases/18.06.3/targets/mvebu/cortexa9/omnia-medkit-openwrt-18.06.3-mvebu-cortexa9-turris-omnia-initramfs.tar.gz;2;0;2;3.87 MB;1.94 MB
/releases/18.06.5/targets/x86/geode/openwrt-18.06.5-x86-geode-combined-ext4.img.gz;2;0;2;7.19 MB;3.60 MB
/releases/17.01.0/targets/gemini/raidsonic/lede-17.01.0-r3205-59508e3-gemini-raidsonic-sysupgrade-ib4220.tar.gz;2;0;2;239.49 KB;119.75 KB
/releases/18.06.5/targets/at91/sama5d4/openwrt-18.06.5-at91-sama5d4-at91-sama5d4_xplained-ext4-sdcard.img.gz;2;0;2;5.72 MB;2.86 MB
/releases/18.06.5/targets/at91/legacy/openwrt-18.06.5-at91-legacy-at91sam9g25ek-ext4-root.ubi.gz;2;0;2;2.50 MB;1.25 MB
/releases/18.06.9/targets/brcm2708/bcm2708/openwrt-18.06.9-brcm2708-bcm2708-rpi-ext4-factory.img.gz;2;0;2;17.47 MB;8.73 MB
/releases/18.06.5/targets/at91/legacy/openwrt-18.06.5-at91-legacy-at91sam9g20ek_2mmc-ext4-root.ubi.gz;2;0;2;2.51 MB;1.26 MB
/releases/18.06.1/targets/oxnas/ox820/openwrt-18.06.1-oxnas-ox820-shuttle-kd20-ubifs-sysupgrade.tar;2;0;2;9.05 MB;4.53 MB
/releases/19.07.3/targets/sunxi/cortexa7/openwrt-19.07.3-sunxi-cortexa7-sun8i-h3-nanopi-neo-squashfs-sdcard.img.gz;2;0;2;4.81 MB;2.41 MB
/releases/18.06.5/targets/sunxi/cortexa7/openwrt-18.06.5-sunxi-cortexa7-sun7i-a20-bananapro-squashfs-sdcard.img.gz;2;0;2;5.24 MB;2.62 MB
/releases/18.06.1/targets/at91/sama5d3/openwrt-18.06.1-at91-sama5d3-rootfs.tar.gz;2;0;2;2.10 MB;1.05 MB
/releases/17.01.6/targets/zynq/generic/lede-17.01.6-zynq-zed-uramdisk.image.gz;2;0;2;1.98 MB;1013.60 KB
/releases/17.01-SNAPSHOT/targets/sunxi/generic/lede-17.01-snapshot-r4046-beaa2ec-sunxi-sun5i-a13-olimex-som-squashfs-sdcard.img.gz;2;0;2;351.49 KB;175.75 KB
/releases/17.01.0/targets/sunxi/generic/lede-17.01.0-r3205-59508e3-sunxi-sun7i-a20-olinuxino-lime-ext4-sdcard.img.gz;2;0;2;671.50 KB;335.75 KB
/releases/18.06.3/targets/at91/legacy/openwrt-18.06.3-at91-legacy-at91sam9g35ek-ext4-root.ubi.gz;2;0;2;2.51 MB;1.26 MB
/releases/17.01.2/targets/oxnas/generic/lede-17.01.2-oxnas-akitio-ubifs-sysupgrade.tar;2;0;2;623.50 KB;311.75 KB
/releases/18.06.0/targets/imx6/generic/openwrt-18.06.0-imx6-rootfs.tar.gz;2;0;2;2.07 MB;1.04 MB
/releases/18.06.4/targets/mvebu/cortexa53/openwrt-18.06.4-mvebu-cortexa53-globalscale-espressobin-squashfs-sdcard.img.gz;2;0;2;5.52 MB;2.76 MB
/releases/18.06.7/targets/sunxi/cortexa53/openwrt-18.06.7-sunxi-cortexa53-sun50i-a64-sopine-baseboard-squashfs-sdcard.img.gz;2;0;2;1.55 MB;791.54 KB
/releases/18.06.6/targets/sunxi/cortexa7/openwrt-18.06.6-sunxi-cortexa7-sun7i-a20-olinuxino-lime2-squashfs-sdcard.img.gz;2;0;2;4.72 MB;2.36 MB
/releases/17.01.4/targets/sunxi/generic/lede-17.01.4-sunxi-sun4i-a10-cubieboard-ext4-sdcard.img.gz;2;0;2;575.50 KB;287.75 KB
/releases/18.06.5/targets/armvirt/32/openwrt-18.06.5-armvirt-32-rootfs.cpio.gz;2;0;2;40 Bytes;20 Bytes
/releases/19.07.0-rc2/targets/sunxi/cortexa7/openwrt-19.07.0-rc2-sunxi-cortexa7-sun7i-a20-lamobo-r1-ext4-sdcard.img.gz;2;0;2;6.74 MB;3.37 MB
/releases/18.06.3/targets/at91/legacy/openwrt-18.06.3-at91-legacy-tny_a9263-ext4-factory.bin.gz;2;0;2;5.61 MB;2.81 MB
/releases/18.06.5/targets/at91/legacy/openwrt-18.06.5-at91-legacy-at91sam9263ek-ext4-zImage.gz;2;0;2;3.33 MB;1.67 MB
/releases/18.06.7/targets/x86/geode/openwrt-18.06.7-x86-geode-rootfs-squashfs.img.gz;2;0;2;1.89 MB;967.54 KB
/releases/19.07.1/targets/zynq/generic/openwrt-19.07.1-zynq-digilent_zynq-zybo-squashfs-sdcard.img.gz;2;0;2;6.01 MB;3.00 MB
/releases/17.01.0/targets/arc770/generic/lede-17.01.0-r3205-59508e3-arc770-generic-root.ext4.gz;2;0;2;2.75 MB;1.38 MB
/releases/18.06.2/targets/sunxi/cortexa53/openwrt-18.06.2-sunxi-cortexa53-sun50i-h5-nanopi-neo-plus2-ext4-sdcard.img.gz;2;0;2;6.54 MB;3.27 MB
/releases/18.06.0-rc2/targets/oxnas/ox820/openwrt-18.06.0-rc2-oxnas-ox820-shuttle-kd20-ubifs-sysupgrade.tar;2;0;2;12.00 MB;6.00 MB
/releases/19.07.0/targets/mvebu/cortexa53/openwrt-19.07.0-mvebu-cortexa53-globalscale_espressobin-squashfs-sdcard.img.gz;2;0;2;11.11 MB;5.56 MB
/releases/19.07.2/targets/at91/sama5/openwrt-19.07.2-at91-sama5-at91-sama5d3_xplained-ext4-sdcard.img.gz;2;0;2;6.26 MB;3.13 MB
/snapshots/faillogs/arm_cortex-a7/packages/node/host-compile.txt;2;0;2;4.03 MB;2.01 MB
/releases/18.06.2/targets/sunxi/cortexa7/openwrt-18.06.2-sunxi-cortexa7-sun7i-a20-cubieboard2-squashfs-sdcard.img.gz;2;0;2;4.73 MB;2.37 MB
/releases/17.01.0/targets/kirkwood/generic/lede-17.01.0-r3205-59508e3-kirkwood-linksys-viper-squashfs-sysupgrade.tar;2;0;2;3.00 MB;1.50 MB
/releases/18.06.4/targets/at91/legacy/openwrt-18.06.4-at91-legacy-at91sam9g20ek-ext4-zImage.gz;2;0;2;3.23 MB;1.61 MB
/releases/17.01.0-rc1/targets/kirkwood/generic/lede-17.01.0-rc1-r3042-ec095b5-kirkwood-pogo_e02-squashfs-sysupgrade.tar;2;0;2;3.09 MB;1.55 MB
/releases/17.01.0-rc2/targets/sunxi/generic/lede-17.01.0-rc2-r3131-42f3c1f-sunxi-sun7i-a20-cubieboard2-squashfs-sdcard.img.gz;2;0;2;3.14 MB;1.57 MB
/releases/18.06.2/targets/at91/legacy/openwrt-18.06.2-at91-legacy-at91sam9g20ek-ext4-root.ubi.gz;2;0;2;2.51 MB;1.25 MB
/releases/17.01.2/targets/x86/legacy/lede-17.01.2-x86-legacy-generic-rootfs.tar.gz;2;0;2;271.50 KB;135.75 KB
/releases/18.06.7/targets/at91/legacy/openwrt-18.06.7-at91-legacy-at91sam9g35ek-ext4-root.ubi.gz;2;0;2;2.44 MB;1.22 MB
/snapshots/faillogs/mips_mips32/packages/frr/host-compile.txt;2;0;2;16.29 KB;8.15 KB
/releases/18.06.4/targets/at91/legacy/openwrt-18.06.4-at91-legacy-usb_a9g20-ext4-factory.bin.gz;2;0;2;5.61 MB;2.81 MB
/releases/17.01.1/targets/sunxi/generic/lede-17.01.1-sunxi-sun7i-a20-cubieboard2-ext4-sdcard.img.gz;2;0;2;383.50 KB;191.75 KB
/releases/18.06.5/targets/sunxi/cortexa7/openwrt-18.06.5-sunxi-cortexa7-sun7i-a20-lamobo-r1-squashfs-sdcard.img.gz;2;0;2;5.22 MB;2.61 MB
/releases/18.06.3/targets/sunxi/cortexa7/openwrt-18.06.3-sunxi-cortexa7-sun8i-h2-plus-orangepi-r1-ext4-sdcard.img.gz;2;0;2;5.42 MB;2.71 MB
/releases/18.06.3/targets/x86/geode/openwrt-18.06.3-x86-geode-rootfs-squashfs.img.gz;2;0;2;3.76 MB;1.88 MB
/releases/17.01.1/targets/zynq/generic/lede-17.01.1-zynq-zybo-uramdisk.image.gz;2;0;2;479.50 KB;239.75 KB
/releases/18.06.0/targets/sunxi/cortexa7/openwrt-18.06.0-sunxi-cortexa7-sun7i-a20-cubieboard2-ext4-sdcard.img.gz;2;0;2;5.46 MB;2.73 MB
/releases/19.07.2/targets/tegra/generic/openwrt-19.07.2-tegra-compulab_trimslice-squashfs-sdcard.img.gz;2;0;2;10.76 MB;5.38 MB
/releases/18.06.5/targets/x86/generic/openwrt-18.06.5-x86-generic-rootfs-squashfs.img.gz;2;0;2;2.60 MB;1.30 MB
/releases/19.07.3/targets/ar71xx/nand/openwrt-19.07.3-ar71xx-nand-wndr3700v4-squashfs-sysupgrade.tar;2;0;2;4.62 MB;2.31 MB
/releases/17.01.1/targets/x86/geode/lede-17.01.1-x86-geode-combined-ext4.img.gz;2;0;2;223.50 KB;111.75 KB
/releases/17.01.0-rc1/targets/kirkwood/generic/lede-17.01.0-rc1-r3042-ec095b5-kirkwood-ib62x0-squashfs-sysupgrade.tar;2;0;2;3.00 MB;1.50 MB
/releases/17.01-SNAPSHOT/targets/sunxi/generic/lede-17.01-snapshot-r4046-beaa2ec-sunxi-sun4i-a10-pcduino-squashfs-sdcard.img.gz;2;0;2;191.49 KB;95.75 KB
/releases/17.01.2/targets/x86/legacy/lede-17.01.2-x86-legacy-combined-ext4.img.gz;2;0;2;271.50 KB;135.75 KB
/releases/17.01.5/targets/at91/legacy/lede-17.01.5-at91-legacy-default-rootfs.tar.gz;2;0;2;4.17 MB;2.08 MB
/releases/17.01.7/targets/sunxi/generic/lede-17.01.7-sunxi-sun7i-a20-olinuxino-micro-ext4-sdcard.img.gz;2;0;2;351.50 KB;175.75 KB
/releases/17.01.5/targets/kirkwood/generic/lede-17.01.5-kirkwood-goflexnet-squashfs-sysupgrade.tar;2;0;2;6.50 MB;3.25 MB
/releases/18.06.0/targets/armvirt/64/openwrt-18.06.0-armvirt-64-root.ext4.gz;2;0;2;2.35 MB;1.18 MB
/releases/19.07.0-rc2/targets/gemini/generic/openwrt-19.07.0-rc2-gemini-itian_sq201-ext4-factory.bin.gz;2;0;2;9.08 MB;4.54 MB
/releases/18.06.6/targets/at91/sama5d2/openwrt-18.06.6-at91-sama5d2-at91-sama5d2_ptc_ek-ext4-sdcard.img.gz;2;0;2;1.45 MB;743.54 KB
/releases/19.07.3/targets/mvebu/cortexa53/openwrt-19.07.3-mvebu-cortexa53-globalscale_espressobin-v7-emmc-squashfs-sdcard.img.gz;2;0;2;8.32 MB;4.16 MB
/releases/19.07.0-rc2/targets/sunxi/cortexa7/openwrt-19.07.0-rc2-sunxi-cortexa7-sun8i-h3-orangepi-pc-squashfs-sdcard.img.gz;2;0;2;4.96 MB;2.48 MB
/releases/19.07.2/targets/zynq/generic/openwrt-19.07.2-zynq-xlnx_zynq-zc702-squashfs-sdcard.img.gz;2;0;2;6.03 MB;3.02 MB
/releases/19.07.2/targets/at91/sama5/openwrt-19.07.2-at91-sama5-at91-sama5d2_ptc_ek-ext4-zImage.gz;2;0;2;3.58 MB;1.79 MB
/releases/18.06.3/targets/x86/geode/openwrt-18.06.3-x86-geode-rootfs-ext4.img.gz;2;0;2;4.67 MB;2.33 MB
/releases/18.06.7/targets/ath25/generic/openwrt-18.06.7-ath25-generic-kernel.gz;2;0;2;1.42 MB;727.54 KB
/releases/18.06.6/targets/sunxi/cortexa7/openwrt-18.06.6-sunxi-cortexa7-sun7i-a20-lamobo-r1-squashfs-sdcard.img.gz;2;0;2;5.23 MB;2.61 MB
/releases/17.01.1/targets/sunxi/generic/lede-17.01.1-sunxi-sun4i-a10-pcduino-ext4-sdcard.img.gz;2;0;2;207.50 KB;103.75 KB
/releases/19.07.3/targets/sunxi/cortexa53/openwrt-19.07.3-sunxi-cortexa53-sun50i-a64-sopine-baseboard-ext4-sdcard.img.gz;2;0;2;6.85 MB;3.43 MB
/releases/18.06.7/targets/sunxi/cortexa8/openwrt-18.06.7-sunxi-cortexa8-sun4i-a10-cubieboard-squashfs-sdcard.img.gz;2;0;2;5.71 MB;2.86 MB
/releases/18.06.3/targets/at91/sama5d4/openwrt-18.06.3-at91-sama5d4-at91-sama5d4_xplained-ext4-root.ubi.gz;2;0;2;2.43 MB;1.21 MB
/releases/18.06.5/targets/sunxi/cortexa7/openwrt-18.06.5-sunxi-cortexa7-sun8i-h3-orangepi-2-ext4-sdcard.img.gz;2;0;2;5.42 MB;2.71 MB
/releases/18.06.2/targets/armvirt/32/openwrt-18.06.2-armvirt-32-root.squashfs.gz;2;0;2;1.63 MB;835.62 KB
/releases/19.07.1/targets/oxnas/ox820/openwrt-19.07.1-oxnas-ox820-shuttle_kd20-ubifs-sysupgrade.tar;2;0;2;9.29 MB;4.65 MB
/releases/19.07.0-rc2/targets/sunxi/cortexa7/openwrt-19.07.0-rc2-sunxi-cortexa7-sun6i-a31-m9-ext4-sdcard.img.gz;2;0;2;6.18 MB;3.09 MB
/releases/17.01.5/targets/sunxi/generic/lede-17.01.5-sunxi-sun7i-a20-lamobo-r1-ext4-sdcard.img.gz;2;0;2;5.67 MB;2.83 MB
/releases/18.06.5/targets/sunxi/cortexa8/openwrt-18.06.5-sunxi-cortexa8-sun4i-a10-pcduino-squashfs-sdcard.img.gz;2;0;2;4.91 MB;2.45 MB
/releases/18.06.3/targets/sunxi/cortexa53/openwrt-18.06.3-sunxi-cortexa53-sun50i-h5-orangepi-zero-plus-ext4-sdcard.img.gz;2;0;2;6.53 MB;3.27 MB
/releases/17.01.5/targets/omap/generic/lede-17.01.5-omap-default-rootfs.tar.gz;2;0;2;2.12 MB;1.06 MB
/releases/18.06.5/targets/sunxi/cortexa7/openwrt-18.06.5-sunxi-cortexa7-sun7i-a20-olinuxino-lime-squashfs-sdcard.img.gz;2;0;2;4.64 MB;2.32 MB
/releases/18.06.4/targets/omap/generic/openwrt-18.06.4-omap-rootfs.tar.gz;2;0;2;2.07 MB;1.04 MB
/releases/17.01.4/targets/sunxi/generic/lede-17.01.4-sunxi-sun7i-a20-cubieboard2-ext4-sdcard.img.gz;2;0;2;223.50 KB;111.75 KB
/releases/18.06.0/targets/sunxi/cortexa7/openwrt-18.06.0-sunxi-cortexa7-sun8i-h3-orangepi-plus-ext4-sdcard.img.gz;2;0;2;5.39 MB;2.69 MB
/releases/19.07.0-rc2/targets/sunxi/cortexa7/openwrt-19.07.0-rc2-sunxi-cortexa7-sun7i-a20-olinuxino-micro-squashfs-sdcard.img.gz;2;0;2;5.04 MB;2.52 MB
/releases/17.01.0/targets/kirkwood/generic/lede-17.01.0-r3205-59508e3-kirkwood-dockstar-squashfs-sysupgrade.tar;2;0;2;3.19 MB;1.59 MB
/releases/18.06.5/targets/sunxi/cortexa7/openwrt-18.06.5-sunxi-cortexa7-sun7i-a20-olinuxino-lime2-emmc-ext4-sdcard.img.gz;2;0;2;5.57 MB;2.78 MB
/releases/19.07.2/targets/sunxi/cortexa7/openwrt-19.07.2-sunxi-cortexa7-sun8i-h3-bananapi-m2-plus-ext4-sdcard.img.gz;2;0;2;13.93 MB;6.96 MB
/releases/18.06.1/targets/oxnas/ox820/openwrt-18.06.1-oxnas-ox820-cloudengines-pogoplug-series-3-ubifs-sysupgrade.tar;2;0;2;4.17 MB;2.09 MB
/releases/18.06.3/targets/at91/legacy/openwrt-18.06.3-at91-legacy-at91sam9263ek-ext4-zImage.gz;2;0;2;3.24 MB;1.62 MB
/releases/19.07.0/targets/brcm2708/bcm2709/openwrt-19.07.0-brcm2708-bcm2709-rpi-2-squashfs-sysupgrade.img.gz;2;0;2;21.53 MB;10.77 MB
/releases/18.06.0/targets/x86/geode/openwrt-18.06.0-x86-geode-rootfs-ext4.img.gz;2;0;2;4.67 MB;2.33 MB
/releases/18.06.5/targets/sunxi/cortexa8/openwrt-18.06.5-sunxi-cortexa8-sun5i-a13-olimex-som-ext4-sdcard.img.gz;2;0;2;5.84 MB;2.92 MB
/releases/17.01-SNAPSHOT/targets/sunxi/generic/lede-17.01-snapshot-r4046-beaa2ec-sunxi-sun7i-a20-bananapro-squashfs-sdcard.img.gz;2;0;2;415.49 KB;207.75 KB
/releases/18.06.6/targets/sunxi/cortexa7/openwrt-18.06.6-sunxi-cortexa7-sun7i-a20-lamobo-r1-ext4-sdcard.img.gz;2;0;2;6.26 MB;3.13 MB
/releases/18.06.1/targets/at91/legacy/openwrt-18.06.1-at91-legacy-rootfs.tar.gz;2;0;2;2.30 MB;1.15 MB
/snapshots/faillogs/arm_xscale/packages/perl-inline/host-compile.txt;2;0;2;391 Bytes;195 Bytes
/releases/19.07.1/targets/at91/sam9x/openwrt-19.07.1-at91-sam9x-at91sam9g20ek-ext4-zImage.gz;2;0;2;3.49 MB;1.74 MB
/releases/18.06.5/targets/oxnas/ox820/openwrt-18.06.5-oxnas-ox820-shuttle-kd20-squashfs-sysupgrade.tar;2;0;2;5.46 MB;2.73 MB
/releases/18.06.3/targets/x86/geode/openwrt-18.06.3-x86-geode-combined-ext4.img.gz;2;0;2;7.28 MB;3.64 MB
/releases/18.06.6/targets/at91/legacy/openwrt-18.06.6-at91-legacy-at91sam9263ek-ext4-root.ubi.gz;2;0;2;2.43 MB;1.22 MB
/releases/18.06.5/targets/at91/sama5d2/openwrt-18.06.5-at91-sama5d2-at91-sama5d2_xplained-ext4-zImage.gz;2;0;2;3.35 MB;1.67 MB
/releases/18.06.1/targets/gemini/generic/openwrt-18.06.1-gemini-dns313-bootpart.tar.gz;2;0;2;2.40 MB;1.20 MB
/releases/18.06.7/targets/x86/legacy/openwrt-18.06.7-x86-legacy-rootfs-ext4.img.gz;2;0;2;1.45 MB;743.54 KB
/releases/19.07.2/targets/mvebu/cortexa9/openwrt-19.07.2-mvebu-cortexa9-solidrun_clearfog-pro-a1-squashfs-sdcard.img.gz;2;0;2;1.42 MB;727.54 KB
/releases/17.01.1/targets/sunxi/generic/lede-17.01.1-sunxi-sun7i-a20-bananapro-ext4-sdcard.img.gz;2;0;2;431.50 KB;215.75 KB
/releases/18.06.6/targets/ramips/mt7621/openwrt-18.06.6-ramips-mt7621-mir3g-squashfs-sysupgrade.tar;2;0;2;4.43 MB;2.21 MB
/releases/18.06.3/targets/at91/sama5d2/openwrt-18.06.3-at91-sama5d2-rootfs.tar.gz;2;0;2;2.12 MB;1.06 MB
/releases/18.06.7/targets/ar71xx/nand/openwrt-18.06.7-ar71xx-nand-wndr3700v4-squashfs-sysupgrade.tar;2;0;2;4.59 MB;2.29 MB
/releases/17.01.0/targets/sunxi/generic/lede-17.01.0-r3205-59508e3-sunxi-sun4i-a10-pcduino-squashfs-sdcard.img.gz;2;0;2;223.50 KB;111.75 KB
/releases/18.06.3/targets/armvirt/32/openwrt-18.06.3-armvirt-32-rootfs.cpio.gz;2;0;2;40 Bytes;20 Bytes
/releases/17.01.5/targets/kirkwood/generic/lede-17.01.5-kirkwood-iconnect-squashfs-sysupgrade.tar;2;0;2;6.50 MB;3.25 MB
/releases/17.01.3/targets/apm821xx/nand/lede-17.01.3-apm821xx-nand-mx60-squashfs-sysupgrade.tar;2;0;2;3.73 MB;1.87 MB
/releases/17.01.7/targets/at91/sama5d3/lede-17.01.7-at91-sama5d3-at91sama5d3xplained-rootfs.tar.gz;2;0;2;415.50 KB;207.75 KB
/releases/19.07.1/targets/tegra/generic/openwrt-19.07.1-tegra-compulab_trimslice-ext4-sdcard.img.gz;2;0;2;6.55 MB;3.27 MB
/releases/18.06.0/targets/sunxi/cortexa7/openwrt-18.06.0-sunxi-cortexa7-sun7i-a20-cubieboard2-squashfs-sdcard.img.gz;2;0;2;4.62 MB;2.31 MB
/releases/18.06.0/targets/mxs/generic/openwrt-18.06.0-mxs-duckbill-sdcard.img.gz;2;0;2;11.12 MB;5.56 MB
/releases/19.07.2/targets/at91/sama5/openwrt-19.07.2-at91-sama5-at91-sama5d2_xplained-ext4-root.ubi.gz;2;0;2;2.62 MB;1.31 MB
/releases/18.06.1/targets/apm821xx/nand/openwrt-18.06.1-apm821xx-nand-meraki_mx60-squashfs-sysupgrade.tar;2;0;2;10.10 MB;5.05 MB
/releases/18.06.2/targets/sunxi/cortexa7/openwrt-18.06.2-sunxi-cortexa7-sun7i-a20-lamobo-r1-squashfs-sdcard.img.gz;2;0;2;5.31 MB;2.65 MB
/releases/19.07.2/targets/sunxi/cortexa7/openwrt-19.07.2-sunxi-cortexa7-sun8i-h3-orangepi-pc-ext4-sdcard.img.gz;2;0;2;11.23 MB;5.61 MB
/releases/18.06.1/targets/rb532/generic/openwrt-18.06.1-rb532-default-rootfs.tar.gz;2;0;2;3.53 MB;1.77 MB
/releases/18.06.6/targets/at91/sama5d2/openwrt-18.06.6-at91-sama5d2-at91-sama5d27_som1_ek-ext4-sdcard.img.gz;2;0;2;5.73 MB;2.87 MB
/releases/18.06.7/targets/at91/sama5d2/openwrt-18.06.7-at91-sama5d2-at91-sama5d2_xplained-ext4-zImage.gz;2;0;2;2.33 MB;1.16 MB
/releases/19.07.2/targets/brcm2708/bcm2708/openwrt-19.07.2-brcm2708-bcm2708-rpi-squashfs-sysupgrade.img.gz;2;0;2;20.69 MB;10.34 MB
/releases/19.07.0-rc1/targets/mvebu/cortexa9/openwrt-19.07.0-rc1-mvebu-cortexa9-cznic_turris-omnia-sysupgrade.img.gz;2;0;2;6.36 MB;3.18 MB
/releases/18.06.5/targets/at91/sama5d3/openwrt-18.06.5-at91-sama5d3-at91-sama5d3_xplained-ext4-sdcard.img.gz;2;0;2;5.81 MB;2.91 MB
/releases/18.06.0/targets/gemini/generic/openwrt-18.06.0-gemini-nas4220b-rd.gz;2;0;2;6.20 MB;3.10 MB
/releases/17.01.1/targets/oxnas/generic/lede-17.01.1-oxnas-pogoplug-pro-ubifs-sysupgrade.tar;2;0;2;351.50 KB;175.75 KB
/releases/17.01.0/targets/sunxi/generic/lede-17.01.0-r3205-59508e3-sunxi-sun7i-a20-bananapi-squashfs-sdcard.img.gz;2;0;2;543.50 KB;271.75 KB
/releases/19.07.3/targets/archs38/generic/openwrt-19.07.3-archs38-generic-Default-sdcard-vfat-ext4.img.gz;2;0;2;6.02 MB;3.01 MB
/releases/17.01.2/targets/ramips/mt7621/lede-17.01.2-ramips-mt7621-ubnt-erx-squashfs-sysupgrade.tar;2;0;2;303.50 KB;151.75 KB
/releases/18.06.3/targets/sunxi/cortexa7/openwrt-18.06.3-sunxi-cortexa7-sun7i-a20-bananapro-squashfs-sdcard.img.gz;2;0;2;5.25 MB;2.63 MB
/releases/18.06.1/targets/sunxi/cortexa7/openwrt-18.06.1-sunxi-cortexa7-sun7i-a20-olinuxino-lime-squashfs-sdcard.img.gz;2;0;2;4.63 MB;2.31 MB
/releases/18.06.5/targets/omap/generic/openwrt-18.06.5-omap-omap3-beagle-ext4-sdcard.img.gz;2;0;2;6.02 MB;3.01 MB
/releases/18.06.7/targets/oxnas/ox820/openwrt-18.06.7-oxnas-ox820-shuttle-kd20-ubifs-sysupgrade.tar;2;0;2;9.06 MB;4.53 MB
/releases/19.07.2/targets/zynq/generic/openwrt-19.07.2-zynq-digilent_zynq-zybo-z7-squashfs-sdcard.img.gz;2;0;2;6.01 MB;3.00 MB
/releases/17.01.5/targets/sunxi/generic/lede-17.01.5-sunxi-sun7i-a20-bananapi-ext4-sdcard.img.gz;2;0;2;4.91 MB;2.46 MB
/releases/18.06.6/targets/oxnas/ox820/openwrt-18.06.6-oxnas-ox820-shuttle-kd20-ubifs-sysupgrade.tar;2;0;2;9.06 MB;4.53 MB
/releases/18.06.7/targets/at91/legacy/openwrt-18.06.7-at91-legacy-at91sam9g20ek-ext4-root.ubi.gz;2;0;2;2.03 MB;1.02 MB
/releases/18.06.0/targets/sunxi/cortexa7/openwrt-18.06.0-sunxi-cortexa7-sun8i-h3-orangepi-pc-ext4-sdcard.img.gz;2;0;2;5.41 MB;2.70 MB
/releases/18.06.6/targets/sunxi/cortexa53/openwrt-18.06.6-sunxi-cortexa53-sun50i-h5-orangepi-zero-plus-squashfs-sdcard.img.gz;2;0;2;5.70 MB;2.85 MB
/releases/19.07.0-rc2/targets/sunxi/cortexa7/openwrt-19.07.0-rc2-sunxi-cortexa7-sun8i-h3-nanopi-neo-ext4-sdcard.img.gz;2;0;2;5.84 MB;2.92 MB
/releases/18.06.3/targets/at91/legacy/openwrt-18.06.3-at91-legacy-ethernut5-ext4-root.ubi.gz;2;0;2;2.51 MB;1.26 MB
/releases/18.06.6/targets/sunxi/cortexa8/openwrt-18.06.6-sunxi-cortexa8-sun5i-a13-olimex-som-squashfs-sdcard.img.gz;2;0;2;4.88 MB;2.44 MB
/releases/18.06.5/targets/x86/64/openwrt-18.06.5-x86-64-rootfs-ext4.img.gz;2;0;2;3.24 MB;1.62 MB
/releases/17.01.1/targets/oxnas/generic/lede-17.01.1-oxnas-stg212-squashfs-sysupgrade.tar;2;0;2;207.50 KB;103.75 KB
/releases/18.06.1/targets/sunxi/cortexa7/openwrt-18.06.1-sunxi-cortexa7-sun8i-h3-nanopi-m1-plus-ext4-sdcard.img.gz;2;0;2;6.64 MB;3.32 MB
/releases/18.06.2/targets/sunxi/cortexa7/openwrt-18.06.2-sunxi-cortexa7-sun7i-a20-cubietruck-squashfs-sdcard.img.gz;2;0;2;5.37 MB;2.69 MB
/releases/18.06.0-rc1/targets/ar71xx/nand/openwrt-18.06.0-rc1-ar71xx-nand-z1-squashfs-sysupgrade.tar;2;0;2;9.64 MB;4.82 MB
/releases/18.06.0-rc1/targets/sunxi/cortexa7/openwrt-18.06.0-rc1-sunxi-cortexa7-sun8i-h2-plus-orangepi-r1-ext4-sdcard.img.gz;2;0;2;8.02 MB;4.01 MB
/releases/19.07.2/targets/at91/sam9x/openwrt-19.07.2-at91-sam9x-at91sam9263ek-ext4-zImage.gz;2;0;2;3.63 MB;1.81 MB
/releases/18.06.1/targets/sunxi/cortexa7/openwrt-18.06.1-sunxi-cortexa7-sun8i-h3-orangepi-2-ext4-sdcard.img.gz;2;0;2;5.54 MB;2.77 MB
/releases/17.01.4/targets/sunxi/generic/lede-17.01.4-sunxi-sun7i-a20-olinuxino-micro-squashfs-sdcard.img.gz;2;0;2;223.50 KB;111.75 KB
/releases/18.06.5/targets/sunxi/cortexa7/openwrt-18.06.5-sunxi-cortexa7-sun7i-a20-olinuxino-lime2-ext4-sdcard.img.gz;2;0;2;5.57 MB;2.78 MB
/releases/18.06.6/targets/at91/sama5d4/openwrt-18.06.6-at91-sama5d4-at91-sama5d4_xplained-ext4-sdcard.img.gz;2;0;2;4.34 MB;2.17 MB
/releases/19.07.0-rc1/targets/mvebu/cortexa9/omnia-medkit-openwrt-19.07.0-rc1-mvebu-cortexa9-cznic_turris-omnia-initramfs.tar.gz;2;0;2;3.97 MB;1.99 MB
/releases/18.06.0/targets/x86/geode/openwrt-18.06.0-x86-geode-combined-ext4.img.gz;2;0;2;7.19 MB;3.60 MB
/releases/17.01.0/targets/sunxi/generic/lede-17.01.0-r3205-59508e3-sunxi-sun7i-a20-olinuxino-lime-squashfs-sdcard.img.gz;2;0;2;543.50 KB;271.75 KB
/releases/18.06.9/targets/ar71xx/mikrotik/openwrt-18.06.9-ar71xx-mikrotik-vmlinux-initramfs.lzma;2;0;2;639.08 KB;319.54 KB
/releases/19.07.0/targets/brcm2708/bcm2709/openwrt-19.07.0-brcm2708-bcm2709-rpi-2-ext4-sysupgrade.img.gz;2;0;2;23.95 MB;11.98 MB
/releases/18.06.2/targets/ar71xx/nand/openwrt-18.06.2-ar71xx-nand-rambutan-squashfs-sysupgrade.tar;2;0;2;3.84 MB;1.92 MB
/releases/17.01.1/targets/sunxi/generic/lede-17.01.1-sunxi-sun7i-a20-cubietruck-squashfs-sdcard.img.gz;2;0;2;351.50 KB;175.75 KB
/releases/18.06.0/targets/oxnas/ox820/openwrt-18.06.0-oxnas-ox820-shuttle-kd20-factory.tar.gz;2;0;2;7.12 MB;3.56 MB
/releases/17.01.6/targets/at91/sama5d3/lede-17.01.6-at91-sama5d3-at91sama5d3xplained-rootfs.tar.gz;2;0;2;1.84 MB;943.75 KB
/releases/19.07.0-rc2/targets/gemini/generic/openwrt-19.07.0-rc2-gemini-dlink_dns-313-ext4-factory.bin.gz;2;0;2;8.79 MB;4.39 MB
/releases/18.06.6/targets/sunxi/cortexa7/openwrt-18.06.6-sunxi-cortexa7-sun7i-a20-olinuxino-micro-ext4-sdcard.img.gz;2;0;2;5.48 MB;2.74 MB
/releases/18.06.6/targets/at91/legacy/openwrt-18.06.6-at91-legacy-usb_a9260-ext4-factory.bin.gz;2;0;2;5.64 MB;2.82 MB
/releases/18.06.4/targets/oxnas/ox820/openwrt-18.06.4-oxnas-ox820-shuttle-kd20-factory.tar.gz;2;0;2;7.13 MB;3.57 MB
/releases/17.01.2/targets/sunxi/generic/lede-17.01.2-sunxi-sun4i-a10-pcduino-ext4-sdcard.img.gz;2;0;2;223.50 KB;111.75 KB
/releases/18.06.4/targets/at91/legacy/openwrt-18.06.4-at91-legacy-wb45n-ext4-root.ubi.gz;2;0;2;3.72 MB;1.86 MB
/releases/18.06.5/targets/at91/sama5d3/openwrt-18.06.5-at91-sama5d3-rootfs.tar.gz;2;0;2;2.12 MB;1.06 MB
/releases/17.01.0-rc2/targets/sunxi/generic/lede-17.01.0-rc2-r3131-42f3c1f-sunxi-sun7i-a20-olinuxino-lime-squashfs-sdcard.img.gz;2;0;2;2.64 MB;1.32 MB
/releases/18.06.4/targets/ar71xx/nand/openwrt-18.06.4-ar71xx-nand-r6100-squashfs-sysupgrade.tar;2;0;2;4.93 MB;2.46 MB
/releases/17.01.7/targets/x86/64/lede-17.01.7-x86-64-rootfs-ext4.img.gz;2;0;2;3.18 MB;1.59 MB
/releases/17.01.0-rc2/targets/sunxi/generic/lede-17.01.0-rc2-r3131-42f3c1f-sunxi-sun4i-a10-olinuxino-lime-ext4-sdcard.img.gz;2;0;2;2.95 MB;1.48 MB
/releases/17.01.5/targets/ipq806x/generic/lede-17.01.5-ipq806x-AP148-ubifs-nand-sysupgrade.tar;2;0;2;8.86 MB;4.43 MB
/releases/19.07.0-rc2/targets/sunxi/cortexa7/openwrt-19.07.0-rc2-sunxi-cortexa7-sun6i-a31-m9-squashfs-sdcard.img.gz;2;0;2;5.34 MB;2.67 MB
/releases/18.06.0/targets/oxnas/ox820/openwrt-18.06.0-oxnas-ox820-akitio-mycloud-squashfs-sysupgrade.tar;2;0;2;4.96 MB;2.48 MB
/releases/18.06.3/targets/sunxi/cortexa7/openwrt-18.06.3-sunxi-cortexa7-sun7i-a20-olinuxino-lime2-emmc-ext4-sdcard.img.gz;2;0;2;5.75 MB;2.88 MB
/releases/17.01.5/targets/apm821xx/nand/lede-17.01.5-apm821xx-nand-mx60-squashfs-sysupgrade.tar;2;0;2;7.36 MB;3.68 MB
/releases/18.06.1/targets/x86/legacy/openwrt-18.06.1-x86-legacy-rootfs-squashfs.img.gz;2;0;2;2.61 MB;1.31 MB
/releases/18.06.5/targets/ath25/generic/openwrt-18.06.5-ath25-generic-kernel.gz;2;0;2;2.20 MB;1.10 MB
/releases/19.07.0-rc2/targets/sunxi/cortexa7/openwrt-19.07.0-rc2-sunxi-cortexa7-sun8i-h3-nanopi-neo-squashfs-sdcard.img.gz;2;0;2;4.92 MB;2.46 MB
/releases/18.06.0-rc2/targets/sunxi/cortexa8/openwrt-18.06.0-rc2-sunxi-cortexa8-sun4i-a10-marsboard-squashfs-sdcard.img.gz;2;0;2;4.59 MB;2.29 MB
/releases/18.06.0/targets/sunxi/cortexa53/openwrt-18.06.0-sunxi-cortexa53-sun50i-a64-sopine-baseboard-squashfs-sdcard.img.gz;2;0;2;5.74 MB;2.87 MB
/releases/18.06.5/targets/sunxi/cortexa7/openwrt-18.06.5-sunxi-cortexa7-sun8i-h3-nanopi-neo-ext4-sdcard.img.gz;2;0;2;5.40 MB;2.70 MB
/releases/17.01.2/targets/rb532/generic/lede-17.01.2-rb532-default-rootfs.tar.gz;2;0;2;239.50 KB;119.75 KB
/releases/18.06.0/targets/sunxi/cortexa7/openwrt-18.06.0-sunxi-cortexa7-sun8i-h3-nanopi-neo-ext4-sdcard.img.gz;2;0;2;5.37 MB;2.68 MB
/releases/18.06.0-rc1/targets/omap/generic/openwrt-18.06.0-rc1-omap-am335x-boneblack-ubifs-sdcard.img.gz;2;0;2;6.15 MB;3.08 MB
/releases/19.07.3/targets/gemini/generic/openwrt-19.07.3-gemini-itian_sq201-ext4-factory.bin.gz;2;0;2;8.80 MB;4.40 MB
/releases/17.01.5/targets/sunxi/generic/lede-17.01.5-sunxi-sun4i-a10-olinuxino-lime-squashfs-sdcard.img.gz;2;0;2;4.15 MB;2.07 MB
/releases/18.06.2/targets/at91/sama5d2/openwrt-18.06.2-at91-sama5d2-rootfs.tar.gz;2;0;2;2.12 MB;1.06 MB
/releases/19.07.2/targets/at91/sam9x/openwrt-19.07.2-at91-sam9x-at91sam9g20ek_2mmc-ext4-root.ubi.gz;2;0;2;2.82 MB;1.41 MB
/releases/18.06.3/targets/armvirt/64/openwrt-18.06.3-armvirt-64-rootfs.cpio.gz;2;0;2;40 Bytes;20 Bytes
/releases/18.06.6/targets/rb532/generic/openwrt-18.06.6-rb532-default-rootfs.tar.gz;2;0;2;3.55 MB;1.78 MB
/releases/17.01.0/targets/sunxi/generic/lede-17.01.0-r3205-59508e3-sunxi-sun7i-a20-lamobo-r1-ext4-sdcard.img.gz;2;0;2;431.50 KB;215.75 KB
/releases/17.01.5/targets/sunxi/generic/lede-17.01.5-sunxi-sun7i-a20-cubietruck-ext4-sdcard.img.gz;2;0;2;5.67 MB;2.83 MB
/releases/17.01.0/targets/sunxi/generic/lede-17.01.0-r3205-59508e3-sunxi-sun7i-a20-lamobo-r1-squashfs-sdcard.img.gz;2;0;2;207.50 KB;103.75 KB
/releases/18.06.6/targets/brcm2708/bcm2709/openwrt-18.06.6-brcm2708-bcm2709-rpi-2-squashfs-sysupgrade.img.gz;2;0;2;3.84 MB;1.92 MB
/releases/18.06.2/targets/sunxi/cortexa8/openwrt-18.06.2-sunxi-cortexa8-sun5i-a13-olinuxino-squashfs-sdcard.img.gz;2;0;2;4.90 MB;2.45 MB
/releases/18.06.0/targets/sunxi/cortexa7/openwrt-18.06.0-sunxi-cortexa7-sun7i-a20-olinuxino-lime-squashfs-sdcard.img.gz;2;0;2;4.62 MB;2.31 MB
/releases/18.06.0-rc1/targets/x86/generic/openwrt-18.06.0-rc1-x86-generic-combined-squashfs.img.gz;2;0;2;9.46 MB;4.73 MB
/releases/18.06.1/targets/sunxi/cortexa8/openwrt-18.06.1-sunxi-cortexa8-sun5i-a13-olimex-som-ext4-sdcard.img.gz;2;0;2;5.82 MB;2.91 MB
/releases/18.06.5/targets/x86/generic/openwrt-18.06.5-x86-generic-rootfs-ext4.img.gz;2;0;2;3.16 MB;1.58 MB
/releases/18.06.2/targets/at91/legacy/openwrt-18.06.2-at91-legacy-usb_a9260-ext4-factory.bin.gz;2;0;2;5.62 MB;2.81 MB
/releases/18.06.0/targets/sunxi/cortexa8/openwrt-18.06.0-sunxi-cortexa8-sun5i-a13-olimex-som-ext4-sdcard.img.gz;2;0;2;5.95 MB;2.97 MB
/releases/19.07.2/targets/sunxi/cortexa7/openwrt-19.07.2-sunxi-cortexa7-sun7i-a20-lamobo-r1-ext4-sdcard.img.gz;2;0;2;6.57 MB;3.29 MB
/releases/18.06.5/targets/oxnas/ox820/openwrt-18.06.5-oxnas-ox820-cloudengines-pogoplug-series-3-ubifs-sysupgrade.tar;2;0;2;7.96 MB;3.98 MB
/releases/18.06.4/targets/ar71xx/nand/openwrt-18.06.4-ar71xx-nand-wndr4300-squashfs-sysupgrade.tar;2;0;2;4.70 MB;2.35 MB
/releases/18.06.0-rc1/targets/ar71xx/nand/openwrt-18.06.0-rc1-ar71xx-nand-c-60-squashfs-sysupgrade.tar;2;0;2;7.07 MB;3.53 MB
/releases/18.06.6/targets/oxnas/ox820/openwrt-18.06.6-oxnas-ox820-shuttle-kd20-factory.tar.gz;2;0;2;7.15 MB;3.58 MB
/releases/19.07.3/targets/sunxi/cortexa8/openwrt-19.07.3-sunxi-cortexa8-sun5i-a13-olimex-som-squashfs-sdcard.img.gz;2;0;2;5.24 MB;2.62 MB
/releases/19.07.1/targets/armvirt/32/openwrt-19.07.1-armvirt-32-root.ext4.gz;2;0;2;2.33 MB;1.16 MB
/releases/19.07.3/targets/sunxi/cortexa7/openwrt-19.07.3-sunxi-cortexa7-sun8i-h3-orangepi-2-squashfs-sdcard.img.gz;2;0;2;4.83 MB;2.42 MB
/releases/19.07.1/targets/at91/sama5/openwrt-19.07.1-at91-sama5-at91-sama5d2_ptc_ek-ext4-zImage.gz;2;0;2;3.45 MB;1.72 MB
/releases/17.01-SNAPSHOT/targets/brcm2708/bcm2710/lede-17.01-snapshot-r4046-beaa2ec-brcm2708-bcm2710-rpi-3-ext4-sdcard.img.gz;2;0;2;8.32 MB;4.16 MB
/releases/18.06.5/targets/omap/generic/openwrt-18.06.5-omap-am335x-evm-ext4-sdcard.img.gz;2;0;2;6.01 MB;3.00 MB
/releases/19.07.3/targets/mvebu/cortexa72/openwrt-19.07.3-mvebu-cortexa72-marvell_armada7040-db-squashfs-sdcard.img.gz;2;0;2;7.49 MB;3.75 MB
/releases/18.06.2/targets/sunxi/cortexa7/openwrt-18.06.2-sunxi-cortexa7-sun7i-a20-cubieboard2-ext4-sdcard.img.gz;2;0;2;5.46 MB;2.73 MB
/releases/18.06.0/targets/sunxi/cortexa7/openwrt-18.06.0-sunxi-cortexa7-sun8i-h3-nanopi-m1-plus-squashfs-sdcard.img.gz;2;0;2;5.59 MB;2.80 MB
/releases/18.06.0-rc1/targets/sunxi/cortexa7/openwrt-18.06.0-rc1-sunxi-cortexa7-sun7i-a20-pcduino3-squashfs-sdcard.img.gz;2;0;2;4.89 MB;2.44 MB
/releases/19.07.2/targets/oxnas/ox820/openwrt-19.07.2-oxnas-ox820-cloudengines_pogoplugpro-squashfs-sysupgrade.tar;2;0;2;1.86 MB;951.54 KB
/releases/19.07.3/targets/oxnas/ox820/openwrt-19.07.3-oxnas-ox820-shuttle_kd20-factory.tar.gz;2;0;2;7.45 MB;3.72 MB
/releases/17.01.5/targets/mediatek/generic/lede-17.01.5-mediatek-eMMC-sysupgrade.tar;2;0;2;7.36 MB;3.68 MB
/releases/18.06.1/targets/sunxi/cortexa8/openwrt-18.06.1-sunxi-cortexa8-sun4i-a10-cubieboard-squashfs-sdcard.img.gz;2;0;2;4.56 MB;2.28 MB
/releases/19.07.0-rc2/targets/sunxi/cortexa53/openwrt-19.07.0-rc2-sunxi-cortexa53-sun50i-h5-nanopi-neo2-squashfs-sdcard.img.gz;2;0;2;6.15 MB;3.08 MB
/releases/17.01.7/targets/sunxi/generic/lede-17.01.7-sunxi-sun7i-a20-bananapro-squashfs-sdcard.img.gz;2;0;2;447.50 KB;223.75 KB
/releases/18.06.7/targets/at91/sama5d3/openwrt-18.06.7-at91-sama5d3-at91-sama5d3_xplained-ext4-root.ubi.gz;2;0;2;1.50 MB;767.54 KB
//releases/19.07.3/targets/zynq/generic/openwrt-19.07.3-zynq-digilent_zynq-zybo-squashfs-sdcard.img.gz;2;0;2;11.72 MB;5.86 MB
/releases/17.01.1/targets/oxnas/generic/lede-17.01.1-oxnas-pogoplug-pro-squashfs-sysupgrade.tar;2;0;2;415.50 KB;207.75 KB
/releases/18.06.1/targets/oxnas/ox820/openwrt-18.06.1-oxnas-ox820-mitrastar-stg212-ubifs-sysupgrade.tar;2;0;2;8.31 MB;4.16 MB
/releases/18.06.0/targets/omap/generic/openwrt-18.06.0-omap-am335x-evm-ubifs-sdcard.img.gz;2;0;2;6.12 MB;3.06 MB
/releases/17.01.4/targets/sunxi/generic/lede-17.01.4-sunxi-sun7i-a20-cubieboard2-squashfs-sdcard.img.gz;2;0;2;223.50 KB;111.75 KB
/releases/18.06.0-rc1/targets/sunxi/cortexa7/openwrt-18.06.0-rc1-sunxi-cortexa7-sun7i-a20-olinuxino-micro-ext4-sdcard.img.gz;2;0;2;5.41 MB;2.71 MB
/releases/17.01.1/targets/x86/legacy/lede-17.01.1-x86-legacy-combined-ext4.img.gz;2;0;2;255.50 KB;127.75 KB
/releases/18.06.6/targets/mvebu/cortexa72/openwrt-18.06.6-mvebu-cortexa72-armada-macchiatobin-ext4-sdcard.img.gz;2;0;2;6.25 MB;3.13 MB
/releases/18.06.1/targets/sunxi/cortexa7/openwrt-18.06.1-sunxi-cortexa7-sun7i-a20-pcduino3-squashfs-sdcard.img.gz;2;0;2;4.95 MB;2.47 MB
/releases/18.06.3/targets/gemini/generic/openwrt-18.06.3-gemini-nas4220b-rd.gz;2;0;2;7.27 MB;3.63 MB
/releases/18.06.2/targets/sunxi/cortexa53/openwrt-18.06.2-sunxi-cortexa53-sun50i-a64-sopine-baseboard-ext4-sdcard.img.gz;2;0;2;6.54 MB;3.27 MB
/releases/19.07.3/targets/ar71xx/nand/openwrt-19.07.3-ar71xx-nand-c-60-squashfs-sysupgrade.tar;2;0;2;4.20 MB;2.10 MB
/releases/17.01.5/targets/x86/64/lede-17.01.5-x86-64-rootfs-ext4.img.gz;2;0;2;3.18 MB;1.59 MB
/releases/18.06.3/targets/mvebu/cortexa72/openwrt-18.06.3-mvebu-cortexa72-armada-macchiatobin-ext4-sdcard.img.gz;2;0;2;6.33 MB;3.16 MB
/releases/17.01.5/targets/kirkwood/generic/lede-17.01.5-kirkwood-pogo_e02-squashfs-sysupgrade.tar;2;0;2;6.48 MB;3.24 MB
/releases/18.06.0-rc1/targets/sunxi/cortexa7/openwrt-18.06.0-rc1-sunxi-cortexa7-sun7i-a20-cubieboard2-squashfs-sdcard.img.gz;2;0;2;7.09 MB;3.55 MB
/releases/19.07.1/targets/sunxi/cortexa7/openwrt-19.07.1-sunxi-cortexa7-sun8i-h3-nanopi-m1-plus-squashfs-sdcard.img.gz;2;0;2;6.09 MB;3.04 MB
/releases/17.01.0/targets/sunxi/generic/lede-17.01.0-r3205-59508e3-sunxi-sun7i-a20-bananapro-ext4-sdcard.img.gz;2;0;2;463.50 KB;231.75 KB
/releases/17.01.4/targets/sunxi/generic/lede-17.01.4-sunxi-sun7i-a20-pcduino3-ext4-sdcard.img.gz;2;0;2;415.50 KB;207.75 KB
/releases/18.06.6/targets/at91/sama5d2/openwrt-18.06.6-at91-sama5d2-rootfs.tar.gz;2;0;2;1.47 MB;751.54 KB
/releases/18.06.7/targets/x86/legacy/openwrt-18.06.7-x86-legacy-generic-rootfs.tar.gz;2;0;2;2.50 MB;1.25 MB
/releases/18.06.0-rc1/targets/ar71xx/nand/openwrt-18.06.0-rc1-ar71xx-nand-hiveap-121-squashfs-sysupgrade.tar;2;0;2;6.48 MB;3.24 MB
/releases/18.06.6/targets/sunxi/cortexa8/openwrt-18.06.6-sunxi-cortexa8-sun5i-a13-olinuxino-ext4-sdcard.img.gz;2;0;2;5.86 MB;2.93 MB
/releases/17.01.5/targets/sunxi/generic/lede-17.01.5-sunxi-sun7i-a20-cubieboard2-ext4-sdcard.img.gz;2;0;2;4.84 MB;2.42 MB
/snapshots/targets//rockchip/armv8/openwrt-rockchip-armv8-friendlyarm_nanopi-r2s-squashfs-sysupgrade.img.gz;2;2;4;17.49 MB;4.37 MB
/releases/18.06.2/targets/oxnas/ox820/openwrt-18.06.2-oxnas-ox820-mitrastar-stg212-squashfs-sysupgrade.tar;2;0;2;1.44 MB;735.54 KB
/releases/18.06.5/targets/x86/legacy/openwrt-18.06.5-x86-legacy-rootfs-squashfs.img.gz;2;0;2;2.46 MB;1.23 MB
/releases/17.01.0-rc2/targets/sunxi/generic/lede-17.01.0-rc2-r3131-42f3c1f-sunxi-sun7i-a20-cubietruck-squashfs-sdcard.img.gz;2;0;2;4.36 MB;2.18 MB
/releases/18.06.5/targets/sunxi/cortexa7/openwrt-18.06.5-sunxi-cortexa7-sun6i-a31-m9-squashfs-sdcard.img.gz;2;0;2;4.96 MB;2.48 MB
/releases/17.01.1/targets/sunxi/generic/lede-17.01.1-sunxi-sun7i-a20-lamobo-r1-ext4-sdcard.img.gz;2;0;2;351.50 KB;175.75 KB
/releases/19.07.0-rc2/targets/sunxi/cortexa7/openwrt-19.07.0-rc2-sunxi-cortexa7-sun8i-h3-orangepi-plus-squashfs-sdcard.img.gz;2;0;2;5.07 MB;2.53 MB
/releases/17.01.1/targets/sunxi/generic/lede-17.01.1-sunxi-sun7i-a20-olinuxino-lime-squashfs-sdcard.img.gz;2;0;2;223.50 KB;111.75 KB
/releases/18.06.0/targets/brcm2708/bcm2710/openwrt-18.06.0-brcm2708-bcm2710-rpi-3-squashfs-sysupgrade.img.gz;2;0;2;8.15 MB;4.07 MB
/releases/17.01.1/targets/sunxi/generic/lede-17.01.1-sunxi-sun4i-a10-olinuxino-lime-ext4-sdcard.img.gz;2;0;2;287.50 KB;143.75 KB
/releases/18.06.4/targets/at91/sama5d3/openwrt-18.06.4-at91-sama5d3-rootfs.tar.gz;2;0;2;2.11 MB;1.05 MB
/releases/18.06.5/targets/oxnas/ox820/openwrt-18.06.5-oxnas-ox820-shuttle-kd20-factory.tar.gz;2;0;2;7.15 MB;3.58 MB
/releases/18.06.0/targets/mxs/generic/openwrt-18.06.0-mxs-root.ext4.gz;2;0;2;5.37 MB;2.68 MB
/releases/18.06.0-rc1/targets/brcm63xx/generic/openwrt-18.06.0-rc1-brcm63xx-generic-livebox-vmlinux.gz;2;0;2;3.88 MB;1.94 MB
/releases/18.06.4/targets/oxnas/ox820/openwrt-18.06.4-oxnas-ox820-akitio-mycloud-squashfs-sysupgrade.tar;2;0;2;5.00 MB;2.50 MB
/releases/18.06.3/targets/at91/legacy/openwrt-18.06.3-at91-legacy-usb_a9260-ext4-factory.bin.gz;2;0;2;5.61 MB;2.80 MB
/releases/18.06.0/targets/sunxi/cortexa7/openwrt-18.06.0-sunxi-cortexa7-sun8i-h3-nanopi-neo-squashfs-sdcard.img.gz;2;0;2;4.67 MB;2.34 MB
/releases/19.07.2/targets/at91/sam9x/openwrt-19.07.2-at91-sam9x-tny_a9260-ext4-factory.bin.gz;2;0;2;6.01 MB;3.01 MB
/releases/18.06.6/targets/at91/legacy/openwrt-18.06.6-at91-legacy-tny_a9263-ext4-factory.bin.gz;2;0;2;5.62 MB;2.81 MB
/releases/17.01.5/targets/sunxi/generic/lede-17.01.5-sunxi-sun7i-a20-bananapi-squashfs-sdcard.img.gz;2;0;2;4.09 MB;2.04 MB
/releases/18.06.6/targets/brcm2708/bcm2709/openwrt-18.06.6-brcm2708-bcm2709-rpi-2-ext4-sysupgrade.img.gz;2;0;2;1.78 MB;911.54 KB
/releases/18.06.3/targets/at91/legacy/openwrt-18.06.3-at91-legacy-at91sam9g20ek_2mmc-ext4-root.ubi.gz;2;0;2;2.78 MB;1.39 MB
/releases/18.06.6/targets/sunxi/cortexa7/openwrt-18.06.6-sunxi-cortexa7-sun8i-h3-orangepi-2-squashfs-sdcard.img.gz;2;0;2;4.65 MB;2.32 MB
/releases/18.06.7/targets/at91/legacy/openwrt-18.06.7-at91-legacy-tny_a9g20-ext4-factory.bin.gz;2;0;2;2.89 MB;1.44 MB
/releases/18.06.4/targets/at91/sama5d4/openwrt-18.06.4-at91-sama5d4-rootfs.tar.gz;2;0;2;2.11 MB;1.05 MB
/releases/17.01.1/targets/zynq/generic/lede-17.01.1-zynq-zed-uramdisk.image.gz;2;0;2;415.50 KB;207.75 KB
/releases/18.06.3/targets/x86/legacy/openwrt-18.06.3-x86-legacy-rootfs-squashfs.img.gz;2;0;2;2.46 MB;1.23 MB
/releases/18.06.5/targets/mxs/generic/openwrt-18.06.5-mxs-duckbill-sdcard.img.gz;2;0;2;11.22 MB;5.61 MB
/releases/19.07.2/targets/sunxi/cortexa8/openwrt-19.07.2-sunxi-cortexa8-sun5i-a13-olimex-som-ext4-sdcard.img.gz;2;0;2;12.11 MB;6.05 MB
/releases/17.01.4/targets/sunxi/generic/lede-17.01.4-sunxi-sun5i-a13-olimex-som-ext4-sdcard.img.gz;2;0;2;383.50 KB;191.75 KB
/releases/19.07.0/targets/mvebu/cortexa53/openwrt-19.07.0-mvebu-cortexa53-marvell_armada-3720-db-ext4-sdcard.img.gz;2;0;2;12.76 MB;6.38 MB
/releases/18.06.0/targets/sunxi/cortexa53/openwrt-18.06.0-sunxi-cortexa53-sun50i-a64-pine64-plus-squashfs-sdcard.img.gz;2;0;2;5.74 MB;2.87 MB
/releases/18.06.1/targets/at91/legacy/openwrt-18.06.1-at91-legacy-wb45n-ext4-root.ubi.gz;2;0;2;3.88 MB;1.94 MB
/releases/18.06.3/targets/oxnas/ox820/openwrt-18.06.3-oxnas-ox820-shuttle-kd20-ubifs-sysupgrade.tar;2;0;2;9.06 MB;4.53 MB
/releases/18.06.3/targets/oxnas/ox820/openwrt-18.06.3-oxnas-ox820-shuttle-kd20-squashfs-sysupgrade.tar;2;0;2;5.43 MB;2.72 MB
/releases/18.06.3/targets/oxnas/ox820/openwrt-18.06.3-oxnas-ox820-cloudengines-pogoplug-series-3-squashfs-sysupgrade.tar;2;0;2;4.84 MB;2.42 MB
/releases/19.07.1/targets/oxnas/ox820/openwrt-19.07.1-oxnas-ox820-mitrastar_stg-212-squashfs-sysupgrade.tar;2;0;2;5.51 MB;2.75 MB
/releases/18.06.6/targets/sunxi/cortexa53/openwrt-18.06.6-sunxi-cortexa53-sun50i-a64-pine64-plus-squashfs-sdcard.img.gz;2;0;2;5.78 MB;2.89 MB
/releases/19.07.0-rc2/targets/sunxi/cortexa7/openwrt-19.07.0-rc2-sunxi-cortexa7-sun8i-h3-orangepi-one-ext4-sdcard.img.gz;2;0;2;6.04 MB;3.02 MB
/releases/18.06.6/targets/sunxi/cortexa7/openwrt-18.06.6-sunxi-cortexa7-sun7i-a20-cubieboard2-squashfs-sdcard.img.gz;2;0;2;4.65 MB;2.33 MB
/releases/18.06.5/targets/sunxi/cortexa7/openwrt-18.06.5-sunxi-cortexa7-sun8i-h3-orangepi-plus-squashfs-sdcard.img.gz;2;0;2;4.60 MB;2.30 MB
/releases/18.06.2/targets/octeon/generic/openwrt-18.06.2-octeon-er-squashfs-sysupgrade.tar;2;0;2;1.42 MB;727.54 KB
/releases/19.07.1/targets/sunxi/cortexa53/openwrt-19.07.1-sunxi-cortexa53-sun50i-h5-nanopi-neo-plus2-squashfs-sdcard.img.gz;2;0;2;11.99 MB;5.99 MB
/releases/18.06.0/targets/sunxi/cortexa7/openwrt-18.06.0-sunxi-cortexa7-sun7i-a20-lamobo-r1-ext4-sdcard.img.gz;2;0;2;6.23 MB;3.12 MB
/releases/18.06.4/targets/brcm63xx/generic/openwrt-18.06.4-brcm63xx-generic-livebox-vmlinux.gz;2;0;2;2.19 MB;1.09 MB
/releases/17.01.7/targets/sunxi/generic/lede-17.01.7-sunxi-sun4i-a10-olinuxino-lime-squashfs-sdcard.img.gz;2;0;2;4.16 MB;2.08 MB
/releases/17.01.4/targets/sunxi/generic/lede-17.01.4-sunxi-sun7i-a20-lamobo-r1-squashfs-sdcard.img.gz;2;0;2;223.50 KB;111.75 KB
/releases/18.06.5/targets/sunxi/cortexa8/openwrt-18.06.5-sunxi-cortexa8-sun4i-a10-cubieboard-squashfs-sdcard.img.gz;2;0;2;4.57 MB;2.29 MB
/releases/18.06.3/targets/x86/legacy/openwrt-18.06.3-x86-legacy-generic-rootfs.tar.gz;2;0;2;2.89 MB;1.44 MB
/releases/18.06.2/targets/gemini/generic/openwrt-18.06.2-gemini-nas4220b-rd.gz;2;0;2;6.17 MB;3.09 MB
/releases/17.01.1/targets/mxs/generic/lede-17.01.1-mxs-root.ext4.gz;2;0;2;399.50 KB;199.75 KB
/releases/18.06.5/targets/x86/legacy/openwrt-18.06.5-x86-legacy-combined-squashfs.img.gz;2;0;2;6.20 MB;3.10 MB
/releases/19.07.0/targets/ar71xx/nand/openwrt-19.07.0-ar71xx-nand-z1-squashfs-sysupgrade.tar;2;0;2;7.73 MB;3.87 MB
/releases/19.07.0-rc2/targets/x86/64/openwrt-19.07.0-rc2-x86-64-rootfs-ext4.img.gz;2;0;2;7.82 MB;3.91 MB
/releases/17.01.0-rc1/targets/oxnas/generic/lede-17.01.0-rc1-r3042-ec095b5-oxnas-pogoplug-pro-ubifs-sysupgrade.tar;2;0;2;3.17 MB;1.59 MB
/releases/18.06.1/targets/sunxi/cortexa53/openwrt-18.06.1-sunxi-cortexa53-sun50i-a64-sopine-baseboard-ext4-sdcard.img.gz;2;0;2;6.53 MB;3.26 MB
/releases/18.06.0/targets/oxnas/ox820/openwrt-18.06.0-oxnas-ox820-mitrastar-stg212-squashfs-sysupgrade.tar;2;0;2;4.94 MB;2.47 MB
/releases/17.01.0-rc2/targets/ipq806x/generic/lede-17.01.0-rc2-r3131-42f3c1f-ipq806x-R7800-squashfs-sysupgrade.tar;2;0;2;2.58 MB;1.29 MB
/releases/faillogs-18.06/arm_arm926ej-s/packages/node/host-compile.txt;2;0;2;7.03 MB;3.52 MB
/releases/18.06.6/targets/at91/sama5d2/openwrt-18.06.6-at91-sama5d2-at91-sama5d27_som1_ek-ext4-zImage.gz;2;0;2;3.22 MB;1.61 MB
/releases/18.06.4/targets/at91/legacy/openwrt-18.06.4-at91-legacy-tny_a9260-ext4-factory.bin.gz;2;0;2;5.61 MB;2.81 MB
/releases/18.06.4/targets/oxnas/ox820/openwrt-18.06.4-oxnas-ox820-mitrastar-stg212-ubifs-sysupgrade.tar;2;0;2;8.30 MB;4.15 MB
/releases/17.01.5/targets/sunxi/generic/lede-17.01.5-sunxi-sun7i-a20-pcduino3-squashfs-sdcard.img.gz;2;0;2;4.47 MB;2.24 MB
/releases/18.06.0/targets/sunxi/cortexa8/openwrt-18.06.0-sunxi-cortexa8-sun4i-a10-cubieboard-squashfs-sdcard.img.gz;2;0;2;4.55 MB;2.28 MB
/releases/17.01.7/targets/sunxi/generic/lede-17.01.7-sunxi-sun5i-a13-olimex-som-squashfs-sdcard.img.gz;2;0;2;271.50 KB;135.75 KB
/releases/18.06.1/targets/sunxi/cortexa7/openwrt-18.06.1-sunxi-cortexa7-sun6i-a31-m9-squashfs-sdcard.img.gz;2;0;2;4.88 MB;2.44 MB
/snapshots/faillogs/arm_cortex-a8_neon/packages/ola/host-compile.txt;2;0;2;20.70 KB;10.35 KB
/releases/18.06.6/targets/oxnas/ox820/openwrt-18.06.6-oxnas-ox820-cloudengines-pogoplug-series-3-squashfs-sysupgrade.tar;2;0;2;4.84 MB;2.42 MB
/releases/17.01.2/targets/oxnas/generic/lede-17.01.2-oxnas-kd20-factory.tar.gz;2;0;2;431.50 KB;215.75 KB
/releases/17.01.1/targets/zynq/generic/lede-17.01.1-zynq-zc702-uramdisk.image.gz;2;0;2;351.50 KB;175.75 KB
/releases/18.06.1/targets/sunxi/cortexa7/openwrt-18.06.1-sunxi-cortexa7-sun7i-a20-olinuxino-lime2-emmc-squashfs-sdcard.img.gz;2;0;2;4.68 MB;2.34 MB
/releases/19.07.2/targets/oxnas/ox820/openwrt-19.07.2-oxnas-ox820-cloudengines_pogoplug-series-3-ubifs-sysupgrade.tar;2;0;2;1.36 MB;695.54 KB
/releases/19.07.0/targets/mvebu/cortexa72/openwrt-19.07.0-mvebu-cortexa72-marvell_armada8040-db-ext4-sdcard.img.gz;2;0;2;12.80 MB;6.40 MB
/releases/18.06.1/targets/mxs/generic/openwrt-18.06.1-mxs-root.ext4.gz;2;0;2;1.44 MB;735.54 KB
/releases/18.06.4/targets/sunxi/cortexa7/openwrt-18.06.4-sunxi-cortexa7-sun8i-h3-orangepi-plus-squashfs-sdcard.img.gz;2;0;2;4.60 MB;2.30 MB
/releases/18.06.6/targets/oxnas/ox820/openwrt-18.06.6-oxnas-ox820-mitrastar-stg212-squashfs-sysupgrade.tar;2;0;2;5.11 MB;2.55 MB
/releases/18.06.7/targets/mxs/generic/openwrt-18.06.7-mxs-duckbill-sdcard.img.gz;2;0;2;11.15 MB;5.57 MB
/releases/18.06.4/targets/at91/sama5d4/openwrt-18.06.4-at91-sama5d4-at91-sama5d4_xplained-ext4-sdcard.img.gz;2;0;2;5.73 MB;2.87 MB
//releases/19.07.3/targets/zynq/generic/openwrt-19.07.3-zynq-xlnx_zynq-zc702-squashfs-sdcard.img.gz;2;0;2;11.77 MB;5.88 MB
/releases/17.01.0-rc2/targets/ramips/mt7621/lede-17.01.0-rc2-r3131-42f3c1f-ramips-mt7621-ubnt-erx-squashfs-sysupgrade.tar;2;0;2;3.16 MB;1.58 MB
/releases/18.06.3/targets/sunxi/cortexa7/openwrt-18.06.3-sunxi-cortexa7-sun7i-a20-bananapi-ext4-sdcard.img.gz;2;0;2;5.62 MB;2.81 MB
/releases/18.06.7/targets/at91/legacy/openwrt-18.06.7-at91-legacy-at91sam9g20ek_2mmc-ext4-root.ubi.gz;2;0;2;2.51 MB;1.26 MB
/releases/18.06.2/targets/sunxi/cortexa7/openwrt-18.06.2-sunxi-cortexa7-sun7i-a20-bananapi-squashfs-sdcard.img.gz;2;0;2;4.64 MB;2.32 MB
/releases/17.01.1/targets/sunxi/generic/lede-17.01.1-sunxi-sun8i-h3-orangepi-plus-ext4-sdcard.img.gz;2;0;2;223.50 KB;111.75 KB
/releases/18.06.6/targets/at91/sama5d4/openwrt-18.06.6-at91-sama5d4-rootfs.tar.gz;2;0;2;2.12 MB;1.06 MB
/releases/18.06.0/targets/sunxi/cortexa7/openwrt-18.06.0-sunxi-cortexa7-sun6i-a31-m9-ext4-sdcard.img.gz;2;0;2;5.90 MB;2.95 MB
/releases/17.01.5/targets/sunxi/generic/lede-17.01.5-sunxi-sun5i-a13-olimex-som-squashfs-sdcard.img.gz;2;0;2;4.47 MB;2.24 MB
/releases/18.06.2/targets/sunxi/cortexa8/openwrt-18.06.2-sunxi-cortexa8-sun4i-a10-marsboard-ext4-sdcard.img.gz;2;0;2;5.40 MB;2.70 MB
/releases/18.06.0/targets/rb532/generic/openwrt-18.06.0-rb532-default-rootfs.tar.gz;2;0;2;3.55 MB;1.77 MB
/snapshots/faillogs/arm_xscale/packages/python3/host-compile.txt;2;0;2;1.59 MB;814.72 KB
/releases/18.06.0/targets/sunxi/cortexa7/openwrt-18.06.0-sunxi-cortexa7-sun7i-a20-lamobo-r1-squashfs-sdcard.img.gz;2;0;2;5.20 MB;2.60 MB
/releases/19.07.0-rc2/targets/at91/sama5/openwrt-19.07.0-rc2-at91-sama5-at91-sama5d2_xplained-ext4-root.ubi.gz;2;0;2;2.59 MB;1.29 MB
/releases/19.07.3/targets/mvebu/cortexa53/openwrt-19.07.3-mvebu-cortexa53-globalscale_espressobin-v7-ext4-sdcard.img.gz;2;0;2;6.75 MB;3.38 MB
/releases/18.06.3/targets/sunxi/cortexa7/openwrt-18.06.3-sunxi-cortexa7-sun8i-h3-orangepi-plus-squashfs-sdcard.img.gz;2;0;2;4.60 MB;2.30 MB
/releases/17.01.2/targets/sunxi/generic/lede-17.01.2-sunxi-sun6i-a31-m9-ext4-sdcard.img.gz;2;0;2;223.50 KB;111.75 KB
/releases/18.06.6/targets/sunxi/cortexa7/openwrt-18.06.6-sunxi-cortexa7-sun8i-h3-nanopi-neo-squashfs-sdcard.img.gz;2;0;2;4.58 MB;2.29 MB
/releases/19.07.2/targets/at91/sam9x/openwrt-19.07.2-at91-sam9x-at91sam9g25ek-ext4-root.ubi.gz;2;0;2;2.64 MB;1.32 MB
/releases/18.06.0-rc1/targets/ramips/mt7621/openwrt-18.06.0-rc1-ramips-mt7621-ubnt-erx-sfp-squashfs-sysupgrade.tar;2;0;2;3.54 MB;1.77 MB
/releases/18.06.1/targets/at91/sama5d2/openwrt-18.06.1-at91-sama5d2-at91-sama5d27_som1_ek-ext4-root.ubi.gz;2;0;2;2.49 MB;1.24 MB
/releases/18.06.0-rc1/targets/ar71xx/nand/openwrt-18.06.0-rc1-ar71xx-nand-wndr3700v4-squashfs-sysupgrade.tar;2;0;2;7.50 MB;3.75 MB
/releases/18.06.3/targets/sunxi/cortexa7/openwrt-18.06.3-sunxi-cortexa7-sun6i-a31-m9-squashfs-sdcard.img.gz;2;0;2;4.97 MB;2.49 MB
/releases/19.07.3/targets/mvebu/cortexa53/openwrt-19.07.3-mvebu-cortexa53-marvell_armada-3720-db-squashfs-sdcard.img.gz;2;0;2;5.65 MB;2.82 MB
/releases/18.06.5/targets/sunxi/cortexa7/openwrt-18.06.5-sunxi-cortexa7-sun7i-a20-olinuxino-lime2-emmc-squashfs-sdcard.img.gz;2;0;2;4.70 MB;2.35 MB
/releases/18.06.3/targets/omap/generic/openwrt-18.06.3-omap-omap4-panda-ext4-sdcard.img.gz;2;0;2;5.88 MB;2.94 MB
/releases/19.07.1/targets/at91/sama5/openwrt-19.07.1-at91-sama5-at91-sama5d27_som1_ek-ext4-zImage.gz;2;0;2;3.47 MB;1.73 MB
/releases/18.06.5/targets/omap/generic/openwrt-18.06.5-omap-omap3-beagle-ubifs-sdcard.img.gz;2;0;2;6.19 MB;3.10 MB
/releases/18.06.3/targets/sunxi/cortexa7/openwrt-18.06.3-sunxi-cortexa7-sun7i-a20-cubieboard2-ext4-sdcard.img.gz;2;0;2;5.46 MB;2.73 MB
/releases/19.07.1/targets/at91/sama5/openwrt-19.07.1-at91-sama5-rootfs.tar.gz;2;0;2;2.25 MB;1.13 MB
/releases/18.06.0-rc1/targets/sunxi/cortexa7/openwrt-18.06.0-rc1-sunxi-cortexa7-sun7i-a20-lamobo-r1-squashfs-sdcard.img.gz;2;0;2;7.83 MB;3.92 MB
/releases/18.06.5/targets/sunxi/cortexa8/openwrt-18.06.5-sunxi-cortexa8-sun5i-a13-olinuxino-squashfs-sdcard.img.gz;2;0;2;5.05 MB;2.53 MB
/releases/18.06.3/targets/at91/legacy/openwrt-18.06.3-at91-legacy-tny_a9g20-ext4-factory.bin.gz;2;0;2;5.61 MB;2.80 MB
/releases/18.06.3/targets/omap/generic/openwrt-18.06.3-omap-am335x-evm-ubifs-sdcard.img.gz;2;0;2;6.18 MB;3.09 MB
/releases/19.07.2/targets/at91/sam9x/openwrt-19.07.2-at91-sam9x-lmu5000-ext4-factory.bin.gz;2;0;2;6.03 MB;3.02 MB
/releases/18.06.5/targets/rb532/generic/openwrt-18.06.5-rb532-default-rootfs.tar.gz;2;0;2;3.55 MB;1.78 MB
/releases/17.01.2/targets/oxnas/generic/lede-17.01.2-oxnas-pogoplug-v3-ubifs-sysupgrade.tar;2;0;2;415.50 KB;207.75 KB
/releases/18.06.6/targets/x86/64/openwrt-18.06.6-x86-64-rootfs-ext4.img.gz;2;0;2;3.24 MB;1.62 MB
/releases/18.06.6/targets/oxnas/ox820/openwrt-18.06.6-oxnas-ox820-akitio-mycloud-squashfs-sysupgrade.tar;2;0;2;5.01 MB;2.50 MB
/releases/17.01.2/targets/kirkwood/generic/lede-17.01.2-kirkwood-goflexnet-squashfs-sysupgrade.tar;2;0;2;383.49 KB;191.75 KB
/releases/18.06.0-rc1/targets/ar71xx/nand/openwrt-18.06.0-rc1-ar71xx-nand-rambutan-squashfs-sysupgrade.tar;2;0;2;6.69 MB;3.35 MB
/releases/19.07.0/targets/apm821xx/sata/openwrt-19.07.0-apm821xx-sata-wd_mybooklive-squashfs-sysupgrade.img.gz;2;0;2;5.60 MB;2.80 MB
/releases/19.07.2/targets/sunxi/cortexa7/openwrt-19.07.2-sunxi-cortexa7-sun8i-h3-orangepi-plus-squashfs-sdcard.img.gz;2;0;2;9.53 MB;4.77 MB
/releases/18.06.1/targets/sunxi/cortexa7/openwrt-18.06.1-sunxi-cortexa7-sun7i-a20-bananapi-squashfs-sdcard.img.gz;2;0;2;4.63 MB;2.31 MB
/releases/18.06.1/targets/oxnas/ox820/openwrt-18.06.1-oxnas-ox820-shuttle-kd20-factory.tar.gz;2;0;2;7.13 MB;3.57 MB
/releases/18.06.6/targets/octeontx/generic/openwrt-18.06.6-octeontx-default-rootfs.tar.gz;2;0;2;2.04 MB;1.02 MB
/releases/18.06.4/targets/oxnas/ox820/openwrt-18.06.4-oxnas-ox820-akitio-mycloud-ubifs-sysupgrade.tar;2;0;2;8.32 MB;4.16 MB
/releases/18.06-SNAPSHOT/targets/at91/legacy/openwrt-18.06-snapshot-r8080-9f2a40c72f-at91-legacy-usb_a9g20-ext4-factory.bin.gz;2;0;2;10.98 MB;5.49 MB
/releases/17.01.4/targets/archs38/generic/lede-17.01.4-archs38-generic-root.ext4.gz;2;0;2;2.71 MB;1.35 MB
/releases/18.06.3/targets/omap/generic/openwrt-18.06.3-omap-omap3-beagle-ubifs-sdcard.img.gz;2;0;2;6.27 MB;3.14 MB
/releases/17.01.3/targets/arc770/generic/lede-17.01.3-arc770-generic-root.ext4.gz;2;0;2;2.77 MB;1.39 MB
/releases/17.01.4/targets/oxnas/generic/lede-17.01.4-oxnas-stg212-ubifs-sysupgrade.tar;2;0;2;223.50 KB;111.75 KB
/releases/18.06.6/targets/x86/geode/openwrt-18.06.6-x86-geode-combined-ext4.img.gz;2;0;2;7.20 MB;3.60 MB
/releases/18.06.4/targets/mxs/generic/openwrt-18.06.4-mxs-duckbill-sdcard.img.gz;2;0;2;11.31 MB;5.65 MB
/releases/18.06.2/targets/rb532/generic/openwrt-18.06.2-rb532-default-rootfs.tar.gz;2;0;2;3.55 MB;1.78 MB
/releases/18.06.4/targets/omap/generic/openwrt-18.06.4-omap-omap3-beagle-ubifs-sdcard.img.gz;2;0;2;6.19 MB;3.10 MB
/releases/19.07.3/targets/sunxi/cortexa53/openwrt-19.07.3-sunxi-cortexa53-sun50i-h5-nanopi-neo2-ext4-sdcard.img.gz;2;0;2;6.85 MB;3.42 MB
/releases/19.07.0/targets/armvirt/64/openwrt-19.07.0-armvirt-64-default-rootfs.tar.gz;2;0;2;4.09 MB;2.05 MB
/releases/18.06.2/targets/oxnas/ox820/openwrt-18.06.2-oxnas-ox820-cloudengines-pogoplug-pro-ubifs-sysupgrade.tar;2;0;2;1.42 MB;727.54 KB
/snapshots/faillogs/arm_cortex-a9_vfpv3-d16/packages/frr/host-compile.txt;2;0;2;15.90 KB;7.95 KB
/releases/19.07.2/targets/at91/sam9x/openwrt-19.07.2-at91-sam9x-at91sam9g20ek_2mmc-ext4-zImage.gz;2;0;2;3.50 MB;1.75 MB
/releases/18.06.3/targets/sunxi/cortexa7/openwrt-18.06.3-sunxi-cortexa7-sun7i-a20-bananapi-squashfs-sdcard.img.gz;2;0;2;4.65 MB;2.32 MB
/releases/19.07.0-rc2/targets/sunxi/cortexa7/openwrt-19.07.0-rc2-sunxi-cortexa7-sun7i-a20-cubietruck-squashfs-sdcard.img.gz;2;0;2;5.62 MB;2.81 MB
/releases/19.07.0/targets/oxnas/ox820/openwrt-19.07.0-oxnas-ox820-shuttle_kd20-ubifs-sysupgrade.tar;2;0;2;9.31 MB;4.65 MB
/releases/18.06.6/targets/omap/generic/openwrt-18.06.6-omap-am335x-evm-ubifs-sdcard.img.gz;2;0;2;6.18 MB;3.09 MB
/releases/19.07.3/targets/sunxi/cortexa7/openwrt-19.07.3-sunxi-cortexa7-sun8i-h3-orangepi-2-ext4-sdcard.img.gz;2;0;2;5.80 MB;2.90 MB
/releases/18.06.5/targets/sunxi/cortexa7/openwrt-18.06.5-sunxi-cortexa7-sun7i-a20-olinuxino-micro-squashfs-sdcard.img.gz;2;0;2;4.63 MB;2.32 MB
/releases/19.07.1/targets/at91/sam9x/openwrt-19.07.1-at91-sam9x-at91sam9263ek-ext4-zImage.gz;2;0;2;3.50 MB;1.75 MB
/releases/17.01.5/targets/sunxi/generic/lede-17.01.5-sunxi-sun7i-a20-pcduino3-ext4-sdcard.img.gz;2;0;2;5.53 MB;2.77 MB
/releases/19.07.0-rc2/targets/at91/sama5/openwrt-19.07.0-rc2-at91-sama5-at91-sama5d3_xplained-ext4-root.ubi.gz;2;0;2;2.59 MB;1.29 MB
/releases/17.01.7/targets/ipq806x/generic/lede-17.01.7-ipq806x-D7800-squashfs-sysupgrade.tar;2;0;2;1.34 MB;687.75 KB
/releases/17.01.0/targets/imx6/generic/lede-17.01.0-r3205-59508e3-imx6-ventana-squashfs-bootfs.tar.gz;2;0;2;335.50 KB;167.75 KB
/releases/18.06.5/targets/sunxi/cortexa8/openwrt-18.06.5-sunxi-cortexa8-sun4i-a10-marsboard-squashfs-sdcard.img.gz;2;0;2;4.71 MB;2.36 MB
/releases/18.06.0/targets/apm821xx/nand/openwrt-18.06.0-apm821xx-nand-netgear_wndr4700-squashfs-sysupgrade.tar;2;0;2;10.39 MB;5.20 MB
/releases/18.06.0-rc1/targets/ar71xx/nand/openwrt-18.06.0-rc1-ar71xx-nand-wndr4300-squashfs-sysupgrade.tar;2;0;2;7.51 MB;3.76 MB
/releases/18.06.4/targets/oxnas/ox820/openwrt-18.06.4-oxnas-ox820-cloudengines-pogoplug-series-3-squashfs-sysupgrade.tar;2;0;2;4.84 MB;2.42 MB
/releases/18.06.0/targets/apm821xx/sata/openwrt-18.06.0-apm821xx-sata-wd_mybooklive-ext4-rootfs.img.gz;2;0;2;11.18 MB;5.59 MB
/releases/19.07.0-rc2/targets/sunxi/cortexa7/openwrt-19.07.0-rc2-sunxi-cortexa7-sun7i-a20-bananapro-squashfs-sdcard.img.gz;2;0;2;5.54 MB;2.77 MB
/releases/19.07.0/targets/armvirt/32/openwrt-19.07.0-armvirt-32-root.squashfs.gz;2;0;2;3.07 MB;1.54 MB
/releases/18.06.1/targets/oxnas/ox820/openwrt-18.06.1-oxnas-ox820-cloudengines-pogoplug-series-3-squashfs-sysupgrade.tar;2;0;2;4.82 MB;2.41 MB
/releases/18.06.1/targets/at91/legacy/openwrt-18.06.1-at91-legacy-lmu5000-ext4-factory.bin.gz;2;0;2;5.60 MB;2.80 MB
/releases/19.07.0-rc1/targets/x86/generic/openwrt-19.07.0-rc1-x86-generic-rootfs-squashfs.img.gz;2;0;2;5.73 MB;2.86 MB
/releases/19.07.0-rc2/targets/sunxi/cortexa7/openwrt-19.07.0-rc2-sunxi-cortexa7-sun7i-a20-olinuxino-lime2-emmc-squashfs-sdcard.img.gz;2;0;2;5.55 MB;2.77 MB
/releases/19.07.0/targets/oxnas/ox820/openwrt-19.07.0-oxnas-ox820-akitio_mycloud-squashfs-sysupgrade.tar;2;0;2;5.19 MB;2.59 MB
/releases/faillogs-18.06/arm_fa526/packages/node/host-compile.txt;2;0;2;8.23 MB;4.11 MB
/releases/18.06.0/targets/sunxi/cortexa53/openwrt-18.06.0-sunxi-cortexa53-sun50i-a64-sopine-baseboard-ext4-sdcard.img.gz;2;0;2;6.61 MB;3.30 MB
/releases/18.06.0-rc2/targets/x86/generic/openwrt-18.06.0-rc2-x86-generic-combined-ext4.img.gz;2;0;2;15.08 MB;7.54 MB
/releases/18.06.1/targets/at91/sama5d4/openwrt-18.06.1-at91-sama5d4-at91-sama5d4_xplained-ext4-zImage.gz;2;0;2;3.16 MB;1.58 MB
/releases/18.06.4/targets/at91/legacy/openwrt-18.06.4-at91-legacy-at91sam9g20ek_2mmc-ext4-root.ubi.gz;2;0;2;2.51 MB;1.26 MB
/releases/18.06.7/targets/at91/sama5d4/openwrt-18.06.7-at91-sama5d4-at91-sama5d4_xplained-ext4-sdcard.img.gz;2;0;2;1.87 MB;959.54 KB
/releases/18.06.6/targets/x86/legacy/openwrt-18.06.6-x86-legacy-rootfs-ext4.img.gz;2;0;2;3.17 MB;1.59 MB
/releases/18.06.2/targets/at91/legacy/openwrt-18.06.2-at91-legacy-rootfs.tar.gz;2;0;2;2.15 MB;1.07 MB
/snapshots/targets/scheduled_for_removal/rb532/generic/openwrt-rb532-rootfs.tar.gz;2;0;2;143.54 KB;71.77 KB
/releases/18.06.5/targets/brcm63xx/generic/openwrt-18.06.5-brcm63xx-generic-livebox-vmlinux.gz;2;0;2;3.88 MB;1.94 MB
/releases/19.07.3/targets/sunxi/cortexa53/openwrt-19.07.3-sunxi-cortexa53-sun50i-a64-pine64-plus-squashfs-sdcard.img.gz;2;0;2;6.06 MB;3.03 MB
/releases/18.06.0-rc2/targets/oxnas/ox820/openwrt-18.06.0-rc2-oxnas-ox820-cloudengines-pogoplug-pro-squashfs-sysupgrade.tar;2;0;2;8.60 MB;4.30 MB
/releases/18.06.4/targets/at91/legacy/openwrt-18.06.4-at91-legacy-at91sam9g20ek-ext4-root.ubi.gz;2;0;2;2.50 MB;1.25 MB
/releases/18.06.1/targets/sunxi/cortexa53/openwrt-18.06.1-sunxi-cortexa53-sun50i-a64-pine64-plus-squashfs-sdcard.img.gz;2;0;2;5.88 MB;2.94 MB
/releases/17.01.4/targets/oxnas/generic/lede-17.01.4-oxnas-akitio-squashfs-sysupgrade.tar;2;0;2;223.50 KB;111.75 KB
/releases/17.01.4/targets/sunxi/generic/lede-17.01.4-sunxi-sun6i-a31-m9-ext4-sdcard.img.gz;2;0;2;479.50 KB;239.75 KB
/releases/18.06.6/targets/omap/generic/openwrt-18.06.6-omap-omap3-beagle-ext4-sdcard.img.gz;2;0;2;6.02 MB;3.01 MB
/releases/18.06.2/targets/at91/sama5d2/openwrt-18.06.2-at91-sama5d2-at91-sama5d2_xplained-ext4-root.ubi.gz;2;0;2;2.49 MB;1.25 MB
/releases/18.06.5/targets/at91/legacy/openwrt-18.06.5-at91-legacy-ethernut5-ext4-root.ubi.gz;2;0;2;2.51 MB;1.26 MB
/releases/18.06.0/targets/sunxi/cortexa8/openwrt-18.06.0-sunxi-cortexa8-sun4i-a10-marsboard-ext4-sdcard.img.gz;2;0;2;5.38 MB;2.69 MB
/releases/19.07.2/targets/mxs/generic/openwrt-19.07.2-mxs-duckbill-sdcard.img.gz;2;0;2;1.47 MB;751.54 KB
/releases/18.06.5/targets/sunxi/cortexa7/openwrt-18.06.5-sunxi-cortexa7-sun7i-a20-cubieboard2-ext4-sdcard.img.gz;2;0;2;5.63 MB;2.82 MB
/releases/18.06.3/targets/omap/generic/openwrt-18.06.3-omap-am335x-evm-ext4-sdcard.img.gz;2;0;2;5.99 MB;3.00 MB
/releases/faillogs-18.06/arm_xscale/packages/node/host-compile.txt;2;0;2;7.02 MB;3.51 MB
/releases/19.07.3/targets/apm821xx/sata/openwrt-19.07.3-apm821xx-sata-wd_mybooklive-squashfs-factory.img.gz;2;0;2;5.48 MB;2.74 MB
/releases/18.06.1/targets/sunxi/cortexa7/openwrt-18.06.1-sunxi-cortexa7-sun7i-a20-olinuxino-lime2-ext4-sdcard.img.gz;2;0;2;5.55 MB;2.78 MB
/releases/17.01.0-rc1/targets/gemini/raidsonic/lede-17.01.0-rc1-r3042-ec095b5-gemini-raidsonic-nas4220-hddapp.tgz;2;0;2;2.98 MB;1.49 MB
/releases/19.07.0/targets/oxnas/ox820/openwrt-19.07.0-oxnas-ox820-shuttle_kd20-squashfs-sysupgrade.tar;2;0;2;5.65 MB;2.83 MB
/releases/17.01.7/targets/brcm2708/bcm2708/lede-17.01.7-brcm2708-bcm2708-rpi-ext4-sdcard.img.gz;2;3;5;16.30 MB;3.26 MB
/releases/18.06.4/targets/omap/generic/openwrt-18.06.4-omap-am335x-evm-ubifs-sdcard.img.gz;2;0;2;6.18 MB;3.09 MB
/releases/18.06.3/targets/x86/64/openwrt-18.06.3-x86-64-rootfs-ext4.img.gz;2;0;2;3.22 MB;1.61 MB
/releases/17.01.0/targets/mxs/generic/lede-17.01.0-r3205-59508e3-mxs-duckbill-sdcard.img.gz;2;0;2;431.50 KB;215.75 KB
/releases/17.01.0/targets/mxs/generic/lede-17.01.0-r3205-59508e3-mxs-root.ext4.gz;2;0;2;367.50 KB;183.75 KB
/releases/17.01.0-rc1/targets/ipq806x/generic/lede-17.01.0-rc1-r3042-ec095b5-ipq806x-R7500v2-squashfs-sysupgrade.tar;2;0;2;3.17 MB;1.59 MB
/releases/18.06.1/targets/at91/legacy/openwrt-18.06.1-at91-legacy-at91sam9263ek-ext4-zImage.gz;2;0;2;3.21 MB;1.60 MB
/releases/18.06.6/targets/at91/sama5d3/openwrt-18.06.6-at91-sama5d3-at91-sama5d3_xplained-ext4-zImage.gz;2;0;2;3.21 MB;1.61 MB
/releases/19.07.2/targets/at91/sam9x/openwrt-19.07.2-at91-sam9x-at91sam9x25ek-ext4-root.ubi.gz;2;0;2;2.64 MB;1.32 MB
/releases/18.06.3/targets/mvebu/cortexa9/openwrt-18.06.3-mvebu-cortexa9-armada-388-clearfog-pro-squashfs-sdcard.img.gz;2;0;2;4.69 MB;2.34 MB
/snapshots/faillogs/mipsel_mips32/packages/frr/host-compile.txt;2;0;2;15.90 KB;7.95 KB
/releases/18.06.7/targets/at91/legacy/openwrt-18.06.7-at91-legacy-at91sam9g20ek_2mmc-ext4-zImage.gz;2;0;2;1.86 MB;951.54 KB
/releases/17.01.7/targets/sunxi/generic/lede-17.01.7-sunxi-sun7i-a20-lamobo-r1-squashfs-sdcard.img.gz;2;0;2;4.71 MB;2.35 MB
/releases/18.06.2/targets/omap/generic/openwrt-18.06.2-omap-omap4-panda-ubifs-sdcard.img.gz;2;0;2;1.44 MB;735.54 KB
/releases/18.06.0-rc2/targets/x86/64/openwrt-18.06.0-rc2-x86-64-rootfs-ext4.img.gz;2;0;2;6.17 MB;3.09 MB
/releases/faillogs-18.06/arc_archs/packages/node/host-compile.txt;2;0;2;6.75 MB;3.37 MB
/releases/19.07.3/targets/sunxi/cortexa7/openwrt-19.07.3-sunxi-cortexa7-sun7i-a20-bananapro-squashfs-sdcard.img.gz;2;0;2;5.56 MB;2.78 MB
/releases/17.01.0/targets/sunxi/generic/lede-17.01.0-r3205-59508e3-sunxi-sun7i-a20-olinuxino-micro-squashfs-sdcard.img.gz;2;0;2;287.50 KB;143.75 KB
/releases/18.06.0/targets/sunxi/cortexa53/openwrt-18.06.0-sunxi-cortexa53-sun50i-a64-pine64-plus-ext4-sdcard.img.gz;2;0;2;6.51 MB;3.26 MB
/releases/18.06.3/targets/archs38/generic/openwrt-18.06.3-archs38-generic-Default-sdcard-vfat-ext4.img.gz;2;0;2;11.85 MB;5.93 MB
/releases/17.01.0-rc2/targets/sunxi/generic/lede-17.01.0-rc2-r3131-42f3c1f-sunxi-sun4i-a10-cubieboard-ext4-sdcard.img.gz;2;0;2;2.80 MB;1.40 MB
/releases/18.06.7/targets/at91/legacy/openwrt-18.06.7-at91-legacy-tny_a9263-ext4-factory.bin.gz;2;0;2;5.64 MB;2.82 MB
/releases/18.06.6/targets/sunxi/cortexa53/openwrt-18.06.6-sunxi-cortexa53-sun50i-h5-nanopi-neo-plus2-ext4-sdcard.img.gz;2;0;2;6.55 MB;3.28 MB
/releases/19.07.0/targets/mvebu/cortexa72/openwrt-19.07.0-mvebu-cortexa72-marvell_armada7040-db-ext4-sdcard.img.gz;2;0;2;12.80 MB;6.40 MB
/releases/19.07.1/targets/at91/sam9x/openwrt-19.07.1-at91-sam9x-ethernut5-ext4-root.ubi.gz;2;0;2;2.64 MB;1.32 MB
/releases/18.06.4/targets/mxs/generic/openwrt-18.06.4-mxs-root.ext4.gz;2;0;2;5.41 MB;2.70 MB
/releases/18.06.4/targets/oxnas/ox820/openwrt-18.06.4-oxnas-ox820-cloudengines-pogoplug-series-3-ubifs-sysupgrade.tar;2;0;2;8.11 MB;4.06 MB
/releases/18.06.0-rc2/targets/sunxi/cortexa8/openwrt-18.06.0-rc2-sunxi-cortexa8-sun4i-a10-pcduino-ext4-sdcard.img.gz;2;0;2;5.98 MB;2.99 MB
/releases/19.07.1/targets/sunxi/cortexa7/openwrt-19.07.1-sunxi-cortexa7-sun7i-a20-olinuxino-micro-ext4-sdcard.img.gz;2;0;2;11.29 MB;5.65 MB
/releases/18.06.3/targets/sunxi/cortexa7/openwrt-18.06.3-sunxi-cortexa7-sun8i-h3-nanopi-neo-squashfs-sdcard.img.gz;2;0;2;4.56 MB;2.28 MB
/releases/18.06.1/targets/brcm2708/bcm2709/openwrt-18.06.1-brcm2708-bcm2709-rpi-2-squashfs-factory.img.gz;2;0;2;10.80 MB;5.40 MB
/releases/19.07.1/targets/omap/generic/openwrt-19.07.1-omap-ti_am335x-bone-black-squashfs-sdcard.img.gz;2;0;2;5.87 MB;2.93 MB
/releases/19.07.1/targets/pistachio/generic/openwrt-19.07.1-pistachio-rootfs.tar.gz;2;0;2;2.19 MB;1.09 MB
/releases/18.06.7/targets/at91/legacy/openwrt-18.06.7-at91-legacy-at91sam9263ek-ext4-root.ubi.gz;2;0;2;2.50 MB;1.25 MB
/releases/18.06.7/targets/mxs/generic/openwrt-18.06.7-mxs-root.ext4.gz;2;0;2;5.52 MB;2.76 MB
/releases/19.07.0/targets/mvebu/cortexa72/openwrt-19.07.0-mvebu-cortexa72-marvell_macchiatobin-ext4-sdcard.img.gz;2;0;2;12.81 MB;6.40 MB
/releases/17.01.0-rc2/targets/kirkwood/generic/lede-17.01.0-rc2-r3131-42f3c1f-kirkwood-iconnect-squashfs-sysupgrade.tar;2;0;2;543.49 KB;271.75 KB
/releases/18.06.7/targets/imx6/generic/openwrt-18.06.7-imx6-ventana-squashfs-bootfs.tar.gz;2;0;2;2.55 MB;1.28 MB
/releases/17.01.1/targets/apm821xx/nand/lede-17.01.1-apm821xx-nand-mx60-squashfs-sysupgrade.tar;2;0;2;3.72 MB;1.86 MB
/releases/17.01.0/targets/kirkwood/generic/lede-17.01.0-r3205-59508e3-kirkwood-linksys-audi-squashfs-sysupgrade.tar;2;0;2;3.42 MB;1.71 MB
/releases/17.01.4/targets/arc770/generic/lede-17.01.4-arc770-generic-Default-sdcard-vfat-ext4.img.gz;2;0;2;5.48 MB;2.74 MB
/releases/18.06.5/targets/oxnas/ox820/openwrt-18.06.5-oxnas-ox820-cloudengines-pogoplug-series-3-squashfs-sysupgrade.tar;2;0;2;4.85 MB;2.43 MB
/releases/18.06.4/targets/at91/legacy/openwrt-18.06.4-at91-legacy-tny_a9263-ext4-factory.bin.gz;2;0;2;5.61 MB;2.81 MB
/releases/19.07.1/targets/archs38/generic/openwrt-19.07.1-archs38-generic-Default-sdcard-vfat-ext4.img.gz;2;0;2;5.87 MB;2.94 MB
/releases/17.01.0/targets/sunxi/generic/lede-17.01.0-r3205-59508e3-sunxi-sun7i-a20-cubietruck-squashfs-sdcard.img.gz;2;0;2;335.50 KB;167.75 KB
/releases/18.06.5/targets/oxnas/ox820/openwrt-18.06.5-oxnas-ox820-cloudengines-pogoplug-pro-squashfs-sysupgrade.tar;2;0;2;4.85 MB;2.43 MB
/releases/18.06.6/targets/sunxi/cortexa7/openwrt-18.06.6-sunxi-cortexa7-sun8i-h3-orangepi-2-ext4-sdcard.img.gz;2;0;2;5.53 MB;2.77 MB
/releases/19.07.2/targets/x86/geode/openwrt-19.07.2-x86-geode-rootfs-squashfs.img.gz;2;0;2;3.86 MB;1.93 MB
/releases/18.06.0/targets/sunxi/cortexa8/openwrt-18.06.0-sunxi-cortexa8-sun4i-a10-cubieboard-ext4-sdcard.img.gz;2;0;2;5.39 MB;2.69 MB
/releases/18.06.2/targets/sunxi/cortexa7/openwrt-18.06.2-sunxi-cortexa7-sun7i-a20-bananapi-ext4-sdcard.img.gz;2;0;2;5.45 MB;2.73 MB
/releases/18.06.0-rc1/targets/sunxi/cortexa7/openwrt-18.06.0-rc1-sunxi-cortexa7-sun7i-a20-olinuxino-lime-ext4-sdcard.img.gz;2;0;2;5.48 MB;2.74 MB
/releases/18.06.0-rc2/targets/apm821xx/nand/openwrt-18.06.0-rc2-apm821xx-nand-meraki_mr24-squashfs-sysupgrade.tar;2;0;2;7.18 MB;3.59 MB
/releases/18.06.2/targets/omap/generic/openwrt-18.06.2-omap-rootfs.tar.gz;2;0;2;1.47 MB;751.54 KB
/releases/18.06.4/targets/at91/sama5d2/openwrt-18.06.4-at91-sama5d2-at91-sama5d2_xplained-ext4-root.ubi.gz;2;0;2;2.49 MB;1.25 MB
/releases/18.06.3/targets/mvebu/cortexa72/openwrt-18.06.3-mvebu-cortexa72-armada-macchiatobin-squashfs-sdcard.img.gz;2;0;2;5.53 MB;2.77 MB
/releases/18.06.1/targets/oxnas/ox820/openwrt-18.06.1-oxnas-ox820-cloudengines-pogoplug-pro-ubifs-sysupgrade.tar;2;0;2;7.92 MB;3.96 MB
/releases/17.01.3/targets/armvirt/generic/lede-17.01.3-armvirt-rootfs.cpio.gz;2;0;2;1.81 MB;926.52 KB
/releases/17.01.5/targets/sunxi/generic/lede-17.01.5-sunxi-sun4i-a10-pcduino-ext4-sdcard.img.gz;2;0;2;5.35 MB;2.68 MB
/releases/17.01.0/targets/sunxi/generic/lede-17.01.0-r3205-59508e3-sunxi-sun8i-h3-orangepi-plus-squashfs-sdcard.img.gz;2;0;2;223.50 KB;111.75 KB
/releases/18.06.5/targets/at91/legacy/openwrt-18.06.5-at91-legacy-usb_a9260-ext4-factory.bin.gz;2;0;2;5.56 MB;2.78 MB
/releases/18.06.1/targets/x86/generic/openwrt-18.06.1-x86-generic-rootfs-squashfs.img.gz;2;0;2;2.42 MB;1.21 MB
/releases/18.06.5/targets/at91/sama5d3/openwrt-18.06.5-at91-sama5d3-at91-sama5d3_xplained-ext4-zImage.gz;2;0;2;3.37 MB;1.68 MB
/releases/18.06.7/targets/oxnas/ox820/openwrt-18.06.7-oxnas-ox820-shuttle-kd20-squashfs-sysupgrade.tar;2;0;2;5.46 MB;2.73 MB
/releases/18.06.0-rc1/targets/x86/64/openwrt-18.06.0-rc1-x86-64-rootfs-ext4.img.gz;2;0;2;6.15 MB;3.08 MB
/releases/18.06.5/targets/at91/sama5d2/openwrt-18.06.5-at91-sama5d2-at91-sama5d27_som1_ek-ext4-sdcard.img.gz;2;0;2;5.73 MB;2.86 MB
/releases/19.07.0-rc2/targets/brcm2708/bcm2710/openwrt-19.07.0-rc2-brcm2708-bcm2710-rpi-3-squashfs-factory.img.gz;2;0;2;21.85 MB;10.93 MB
/releases/18.06.3/targets/archs38/generic/openwrt-18.06.3-archs38-generic-root.ext4.gz;2;0;2;5.63 MB;2.81 MB
/releases/19.07.1/targets/at91/sam9x/openwrt-19.07.1-at91-sam9x-usb_a9260-ext4-factory.bin.gz;2;0;2;6.00 MB;3.00 MB
/releases/18.06.3/targets/at91/legacy/openwrt-18.06.3-at91-legacy-tny_a9260-ext4-factory.bin.gz;2;0;2;5.63 MB;2.81 MB
/releases/18.06.3/targets/sunxi/cortexa7/openwrt-18.06.3-sunxi-cortexa7-sun7i-a20-olinuxino-micro-ext4-sdcard.img.gz;2;0;2;5.48 MB;2.74 MB
/releases/17.01.4/targets/kirkwood/generic/lede-17.01.4-kirkwood-pogo_e02-squashfs-sysupgrade.tar;2;0;2;6.46 MB;3.23 MB
/releases/18.06.2/targets/x86/legacy/openwrt-18.06.2-x86-legacy-rootfs-squashfs.img.gz;2;0;2;2.46 MB;1.23 MB
/releases/17.01.5/targets/sunxi/generic/lede-17.01.5-sunxi-sun4i-a10-olinuxino-lime-ext4-sdcard.img.gz;2;0;2;4.90 MB;2.45 MB
/releases/19.07.1/targets/x86/generic/openwrt-19.07.1-x86-generic-rootfs-ext4.img.gz;2;0;2;4.11 MB;2.06 MB
/releases/18.06.4/targets/at91/legacy/openwrt-18.06.4-at91-legacy-at91sam9x25ek-ext4-root.ubi.gz;2;0;2;2.68 MB;1.34 MB
/releases/18.06.0-rc1/targets/sunxi/cortexa8/openwrt-18.06.0-rc1-sunxi-cortexa8-sun4i-a10-marsboard-squashfs-sdcard.img.gz;2;0;2;7.55 MB;3.77 MB
/releases/18.06.6/targets/at91/legacy/openwrt-18.06.6-at91-legacy-at91sam9g20ek_2mmc-ext4-zImage.gz;2;0;2;3.24 MB;1.62 MB
/releases/18.06.5/targets/sunxi/cortexa7/openwrt-18.06.5-sunxi-cortexa7-sun6i-a31-m9-ext4-sdcard.img.gz;2;0;2;5.92 MB;2.96 MB
/releases/19.07.0/targets/x86/generic/openwrt-19.07.0-x86-generic-rootfs-ext4.img.gz;2;0;2;7.93 MB;3.97 MB
/releases/18.06.7/targets/at91/legacy/openwrt-18.06.7-at91-legacy-wb45n-ext4-root.ubi.gz;2;0;2;3.72 MB;1.86 MB
/releases/18.06.6/targets/oxnas/ox820/openwrt-18.06.6-oxnas-ox820-cloudengines-pogoplug-series-3-ubifs-sysupgrade.tar;2;0;2;7.94 MB;3.97 MB
/releases/19.07.1/targets/at91/sama5/openwrt-19.07.1-at91-sama5-at91-sama5d3_xplained-ext4-root.ubi.gz;2;0;2;2.62 MB;1.31 MB
/releases/17.01.0/targets/sunxi/generic/lede-17.01.0-r3205-59508e3-sunxi-sun4i-a10-cubieboard-ext4-sdcard.img.gz;2;0;2;335.50 KB;167.75 KB
/releases/17.01.0-rc2/targets/sunxi/generic/lede-17.01.0-rc2-r3131-42f3c1f-sunxi-sun7i-a20-olinuxino-lime-ext4-sdcard.img.gz;2;0;2;3.36 MB;1.68 MB
/releases/18.06.7/targets/armvirt/32/openwrt-18.06.7-armvirt-32-rootfs.cpio.gz;2;0;2;40 Bytes;20 Bytes
/releases/18.06.3/targets/rb532/generic/openwrt-18.06.3-rb532-default-rootfs.tar.gz;2;0;2;3.55 MB;1.78 MB
/releases/18.06.2/targets/at91/legacy/openwrt-18.06.2-at91-legacy-at91sam9x35ek-ext4-root.ubi.gz;2;0;2;2.43 MB;1.22 MB
/releases/18.06.0-rc2/targets/x86/64/openwrt-18.06.0-rc2-x86-64-generic-rootfs.tar.gz;2;0;2;5.64 MB;2.82 MB
/releases/18.06.3/targets/sunxi/cortexa53/openwrt-18.06.3-sunxi-cortexa53-sun50i-a64-sopine-baseboard-squashfs-sdcard.img.gz;2;0;2;5.88 MB;2.94 MB
/releases/18.06.5/targets/x86/64/openwrt-18.06.5-x86-64-rootfs-squashfs.img.gz;2;0;2;2.53 MB;1.26 MB
/releases/17.01.1/targets/oxnas/generic/lede-17.01.1-oxnas-pogoplug-v3-ubifs-sysupgrade.tar;2;0;2;479.50 KB;239.75 KB
/releases/19.07.3/targets/mvebu/cortexa9/omnia-medkit-openwrt-19.07.3-mvebu-cortexa9-cznic_turris-omnia-initramfs.tar.gz;2;0;2;3.89 MB;1.95 MB
/releases/18.06.5/targets/sunxi/cortexa8/openwrt-18.06.5-sunxi-cortexa8-sun4i-a10-marsboard-ext4-sdcard.img.gz;2;0;2;5.41 MB;2.70 MB
/releases/18.06.3/targets/oxnas/ox820/openwrt-18.06.3-oxnas-ox820-akitio-mycloud-squashfs-sysupgrade.tar;2;0;2;5.00 MB;2.50 MB
/releases/19.07.2/targets/octeon/generic/openwrt-19.07.2-octeon-er-squashfs-sysupgrade.tar;2;0;2;5.47 MB;2.73 MB
/releases/19.07.2/targets/x86/legacy/openwrt-19.07.2-x86-legacy-generic-rootfs.tar.gz;2;0;2;3.03 MB;1.51 MB
/releases/18.06.3/targets/sunxi/cortexa7/openwrt-18.06.3-sunxi-cortexa7-sun7i-a20-olinuxino-lime2-squashfs-sdcard.img.gz;2;0;2;4.72 MB;2.36 MB
/releases/18.06.7/targets/at91/sama5d2/openwrt-18.06.7-at91-sama5d2-at91-sama5d27_som1_ek-ext4-root.ubi.gz;2;0;2;2.50 MB;1.25 MB
/releases/18.06.5/targets/x86/geode/openwrt-18.06.5-x86-geode-combined-squashfs.img.gz;2;0;2;6.36 MB;3.18 MB
/releases/18.06.7/targets/ar71xx/nand/openwrt-18.06.7-ar71xx-nand-hiveap-121-squashfs-sysupgrade.tar;2;0;2;3.80 MB;1.90 MB
/releases/18.06.7/targets/at91/sama5d2/openwrt-18.06.7-at91-sama5d2-at91-sama5d2_ptc_ek-ext4-root.ubi.gz;2;0;2;1.45 MB;743.54 KB
/releases/18.06.0/targets/oxnas/ox820/openwrt-18.06.0-oxnas-ox820-cloudengines-pogoplug-series-3-squashfs-sysupgrade.tar;2;0;2;4.81 MB;2.40 MB
/releases/19.07.0-rc2/targets/mvebu/cortexa53/openwrt-19.07.0-rc2-mvebu-cortexa53-marvell_armada-3720-db-ext4-sdcard.img.gz;2;0;2;6.54 MB;3.27 MB
/releases/18.06.0/targets/at91/sama5d4/openwrt-18.06.0-at91-sama5d4-rootfs.tar.gz;2;0;2;2.10 MB;1.05 MB
/releases/17.01.0-rc1/targets/oxnas/generic/lede-17.01.0-rc1-r3042-ec095b5-oxnas-stg212-ubifs-sysupgrade.tar;2;0;2;3.36 MB;1.68 MB
/releases/19.07.0-rc1/targets/brcm2708/bcm2709/openwrt-19.07.0-rc1-brcm2708-bcm2709-rpi-2-ext4-factory.img.gz;2;0;2;12.05 MB;6.03 MB
/releases/18.06.5/targets/at91/legacy/openwrt-18.06.5-at91-legacy-at91sam9m10g45ek-ext4-root.ubi.gz;2;0;2;2.51 MB;1.26 MB
/releases/19.07.0-rc1/targets/archs38/generic/openwrt-19.07.0-rc1-archs38-generic-root.ext4.gz;2;0;2;3.01 MB;1.50 MB
/releases/18.06.5/targets/at91/legacy/openwrt-18.06.5-at91-legacy-at91sam9x25ek-ext4-root.ubi.gz;2;0;2;2.51 MB;1.26 MB
/releases/18.06.6/targets/sunxi/cortexa7/openwrt-18.06.6-sunxi-cortexa7-sun7i-a20-cubieboard2-ext4-sdcard.img.gz;2;0;2;5.48 MB;2.74 MB
/releases/19.07.0-rc2/targets/sunxi/cortexa7/openwrt-19.07.0-rc2-sunxi-cortexa7-sun7i-a20-olinuxino-lime2-ext4-sdcard.img.gz;2;0;2;5.81 MB;2.90 MB
/releases/17.01.0-rc1/targets/oxnas/generic/lede-17.01.0-rc1-r3042-ec095b5-oxnas-pogoplug-v3-ubifs-sysupgrade.tar;2;0;2;3.09 MB;1.55 MB
/releases/19.07.2/targets/at91/sam9x/openwrt-19.07.2-at91-sam9x-usb_a9260-ext4-factory.bin.gz;2;0;2;6.01 MB;3.01 MB
/releases/18.06.0-rc2/targets/oxnas/ox820/openwrt-18.06.0-rc2-oxnas-ox820-cloudengines-pogoplug-pro-ubifs-sysupgrade.tar;2;0;2;11.24 MB;5.62 MB
/releases/19.07.1/targets/at91/sama5/openwrt-19.07.1-at91-sama5-at91-sama5d27_som1_ek-ext4-root.ubi.gz;2;0;2;2.66 MB;1.33 MB
/releases/18.06.0/targets/mvebu/cortexa9/openwrt-18.06.0-mvebu-cortexa9-armada-388-clearfog-pro-squashfs-sdcard.img.gz;2;0;2;4.66 MB;2.33 MB
/releases/19.07.2/targets/tegra/generic/openwrt-19.07.2-tegra-compulab_trimslice-ext4-sdcard.img.gz;2;0;2;12.88 MB;6.44 MB
/releases/18.06.2/targets/sunxi/cortexa7/openwrt-18.06.2-sunxi-cortexa7-sun7i-a20-olinuxino-lime2-squashfs-sdcard.img.gz;2;0;2;4.71 MB;2.36 MB
/releases/17.01.7/targets/zynq/generic/lede-17.01.7-zynq-zc702-uramdisk.image.gz;2;0;2;255.50 KB;127.75 KB
/releases/18.06.6/targets/ar71xx/nand/openwrt-18.06.6-ar71xx-nand-wndr4300-squashfs-sysupgrade.tar;2;0;2;4.70 MB;2.35 MB
/releases/18.06.2/targets/at91/legacy/openwrt-18.06.2-at91-legacy-usb_a9g20-ext4-factory.bin.gz;2;0;2;5.61 MB;2.80 MB
/releases/17.01.1/targets/zynq/generic/lede-17.01.1-zynq-rootfs.tar.gz;2;0;2;383.50 KB;191.75 KB
/releases/19.07.1/targets/zynq/generic/openwrt-19.07.1-zynq-avnet_zynq-zed-squashfs-sdcard.img.gz;2;0;2;6.02 MB;3.01 MB
/releases/19.07.2/targets/sunxi/cortexa7/openwrt-19.07.2-sunxi-cortexa7-sun7i-a20-bananapro-squashfs-sdcard.img.gz;2;0;2;10.83 MB;5.42 MB
/releases/17.01.1/targets/sunxi/generic/lede-17.01.1-sunxi-sun8i-h3-orangepi-plus-squashfs-sdcard.img.gz;2;0;2;431.50 KB;215.75 KB
/releases/19.07.2/targets/sunxi/cortexa7/openwrt-19.07.2-sunxi-cortexa7-sun7i-a20-olinuxino-lime2-squashfs-sdcard.img.gz;2;0;2;9.74 MB;4.87 MB
/releases/18.06.3/targets/mxs/generic/openwrt-18.06.3-mxs-root.ext4.gz;2;0;2;5.42 MB;2.71 MB
/releases/17.01.5/targets/imx6/generic/lede-17.01.5-imx6-ventana-squashfs-bootfs.tar.gz;2;0;2;2.07 MB;1.04 MB
/releases/17.01.4/targets/rb532/generic/lede-17.01.4-rb532-default-rootfs.tar.gz;2;0;2;479.50 KB;239.75 KB
/releases/19.07.0-rc1/targets/mvebu/cortexa9/openwrt-19.07.0-rc1-mvebu-cortexa9-solidrun_clearfog-base-a1-squashfs-sdcard.img.gz;2;0;2;4.97 MB;2.49 MB
/releases/19.07.3/targets/sunxi/cortexa53/openwrt-19.07.3-sunxi-cortexa53-sun50i-h5-orangepi-zero-plus-squashfs-sdcard.img.gz;2;0;2;6.06 MB;3.03 MB
/releases/18.06.6/targets/sunxi/cortexa7/openwrt-18.06.6-sunxi-cortexa7-sun7i-a20-pcduino3-squashfs-sdcard.img.gz;2;0;2;4.98 MB;2.49 MB
/snapshots/faillogs/mips_24kc/packages/frr/host-compile.txt;2;0;2;15.90 KB;7.95 KB
/releases/17.01.0-rc2/targets/sunxi/generic/lede-17.01.0-rc2-r3131-42f3c1f-sunxi-sun5i-a13-olinuxino-squashfs-sdcard.img.gz;2;0;2;2.81 MB;1.41 MB
/releases/18.06.0/targets/sunxi/cortexa7/openwrt-18.06.0-sunxi-cortexa7-sun7i-a20-bananapro-ext4-sdcard.img.gz;2;0;2;6.18 MB;3.09 MB
/releases/19.07.0/targets/ar71xx/nand/openwrt-19.07.0-ar71xx-nand-wndr4300-squashfs-sysupgrade.tar;2;0;2;9.02 MB;4.51 MB
/releases/17.01.5/targets/gemini/raidsonic/lede-17.01.5-gemini-raidsonic-nas4220-hddapp.tgz;2;0;2;13.00 MB;6.50 MB
/releases/18.06.1/targets/oxnas/ox820/openwrt-18.06.1-oxnas-ox820-akitio-mycloud-squashfs-sysupgrade.tar;2;0;2;1.42 MB;727.54 KB
/releases/19.07.2/targets/sunxi/cortexa8/openwrt-19.07.2-sunxi-cortexa8-sun4i-a10-cubieboard-ext4-sdcard.img.gz;2;0;2;11.15 MB;5.58 MB
/releases/18.06.3/targets/at91/legacy/openwrt-18.06.3-at91-legacy-usb_a9263-ext4-factory.bin.gz;2;0;2;5.63 MB;2.81 MB
/snapshots/faillogs/i386_pentium-mmx/packages/frr/host-compile.txt;2;0;2;15.90 KB;7.95 KB
/releases/18.06.6/targets/sunxi/cortexa7/openwrt-18.06.6-sunxi-cortexa7-sun8i-h3-nanopi-m1-plus-squashfs-sdcard.img.gz;2;0;2;5.71 MB;2.86 MB
/releases/17.01.4/targets/x86/legacy/lede-17.01.4-x86-legacy-combined-ext4.img.gz;2;0;2;2.58 MB;1.29 MB
/releases/17.01.6/targets/sunxi/generic/lede-17.01.6-sunxi-sun5i-a13-olimex-som-squashfs-sdcard.img.gz;2;0;2;255.50 KB;127.75 KB
/releases/18.06.3/targets/at91/legacy/openwrt-18.06.3-at91-legacy-rootfs.tar.gz;2;0;2;2.15 MB;1.07 MB
/releases/18.06.1/targets/at91/legacy/openwrt-18.06.1-at91-legacy-tny_a9g20-ext4-factory.bin.gz;2;0;2;5.70 MB;2.85 MB
/releases/18.06.1/targets/at91/legacy/openwrt-18.06.1-at91-legacy-at91sam9g25ek-ext4-root.ubi.gz;2;0;2;2.49 MB;1.24 MB
/releases/18.06.6/targets/arc770/generic/openwrt-18.06.6-arc770-generic-Default-sdcard-vfat-ext4.img.gz;2;0;2;4.97 MB;2.49 MB
/releases/17.01.0-rc1/targets/oxnas/generic/lede-17.01.0-rc1-r3042-ec095b5-oxnas-akitio-squashfs-sysupgrade.tar;2;0;2;3.06 MB;1.53 MB
/releases/19.07.1/targets/at91/sama5/openwrt-19.07.1-at91-sama5-at91-sama5d2_ptc_ek-ext4-sdcard.img.gz;2;0;2;6.09 MB;3.05 MB
/releases/18.06.7/targets/at91/legacy/openwrt-18.06.7-at91-legacy-at91sam9x35ek-ext4-root.ubi.gz;2;0;2;2.51 MB;1.26 MB
/releases/18.06.5/targets/at91/sama5d2/openwrt-18.06.5-at91-sama5d2-at91-sama5d27_som1_ek-ext4-root.ubi.gz;2;0;2;2.42 MB;1.21 MB
/releases/18.06.3/targets/at91/sama5d2/openwrt-18.06.3-at91-sama5d2-at91-sama5d27_som1_ek-ext4-root.ubi.gz;2;0;2;2.49 MB;1.25 MB
/releases/18.06.3/targets/oxnas/ox820/openwrt-18.06.3-oxnas-ox820-cloudengines-pogoplug-pro-ubifs-sysupgrade.tar;2;0;2;7.96 MB;3.98 MB
/releases/17.01.0-rc1/targets/zynq/generic/lede-17.01.0-rc1-r3042-ec095b5-zynq-zc702-uramdisk.image.gz;2;0;2;255.49 KB;127.75 KB
/releases/18.06.7/targets/at91/legacy/openwrt-18.06.7-at91-legacy-rootfs.tar.gz;2;0;2;2.15 MB;1.08 MB
/releases/18.06.3/targets/sunxi/cortexa7/openwrt-18.06.3-sunxi-cortexa7-sun7i-a20-bananapro-ext4-sdcard.img.gz;2;0;2;6.22 MB;3.11 MB
/releases/17.01.0/targets/sunxi/generic/lede-17.01.0-r3205-59508e3-sunxi-sun4i-a10-olinuxino-lime-squashfs-sdcard.img.gz;2;0;2;223.50 KB;111.75 KB
/releases/19.07.0-rc2/targets/zynq/generic/openwrt-19.07.0-rc2-zynq-avnet_zynq-zed-squashfs-sdcard.img.gz;2;0;2;6.01 MB;3.01 MB
/releases/19.07.2/targets/x86/geode/openwrt-19.07.2-x86-geode-combined-squashfs.img.gz;2;0;2;6.57 MB;3.28 MB
/releases/17.01.2/targets/sunxi/generic/lede-17.01.2-sunxi-sun7i-a20-bananapi-ext4-sdcard.img.gz;2;0;2;527.50 KB;263.75 KB
/releases/18.06.3/targets/mvebu/cortexa9/openwrt-18.06.3-mvebu-cortexa9-armada-388-clearfog-base-squashfs-sdcard.img.gz;2;0;2;4.84 MB;2.42 MB
/releases/19.07.0/targets/brcm2708/bcm2708/openwrt-19.07.0-brcm2708-bcm2708-rpi-squashfs-factory.img.gz;2;0;2;20.66 MB;10.33 MB
/releases/17.01.2/targets/imx6/generic/lede-17.01.2-imx6-rootfs.tar.gz;2;0;2;607.50 KB;303.75 KB
/releases/18.06.5/targets/at91/legacy/openwrt-18.06.5-at91-legacy-lmu5000-ext4-factory.bin.gz;2;0;2;5.66 MB;2.83 MB
/releases/17.01.0/targets/mediatek/generic/lede-17.01.0-r3205-59508e3-mediatek-eMMC-sysupgrade.tar;2;0;2;7.22 MB;3.61 MB
/releases/18.06.1/targets/at91/sama5d4/openwrt-18.06.1-at91-sama5d4-rootfs.tar.gz;2;0;2;2.12 MB;1.06 MB
/releases/17.01.0-rc2/targets/mvebu/generic/lede-17.01.0-rc2-r3131-42f3c1f-mvebu-armada-388-clearfog-sdcard.img.gz;2;0;2;2.55 MB;1.27 MB
/releases/19.07.2/targets/oxnas/ox820/openwrt-19.07.2-oxnas-ox820-cloudengines_pogoplugpro-ubifs-sysupgrade.tar;2;0;2;1.44 MB;735.54 KB
/releases/18.06.3/targets/sunxi/cortexa7/openwrt-18.06.3-sunxi-cortexa7-sun7i-a20-cubietruck-ext4-sdcard.img.gz;2;0;2;6.25 MB;3.12 MB
/releases/18.06.0/targets/at91/sama5d2/openwrt-18.06.0-at91-sama5d2-at91-sama5d2_xplained-ext4-sdcard.img.gz;2;0;2;5.68 MB;2.84 MB
/releases/18.06.6/targets/at91/sama5d3/openwrt-18.06.6-at91-sama5d3-rootfs.tar.gz;2;0;2;2.12 MB;1.06 MB
/releases/19.07.0-rc1/targets/mvebu/cortexa53/openwrt-19.07.0-rc1-mvebu-cortexa53-marvell_armada-3720-db-squashfs-sdcard.img.gz;2;0;2;5.74 MB;2.87 MB
/releases/17.01-SNAPSHOT/targets/sunxi/generic/lede-17.01-snapshot-r4046-beaa2ec-sunxi-sun4i-a10-cubieboard-squashfs-sdcard.img.gz;2;0;2;271.49 KB;135.75 KB
/releases/17.01.4/targets/sunxi/generic/lede-17.01.4-sunxi-sun6i-a31-m9-squashfs-sdcard.img.gz;2;0;2;431.50 KB;215.75 KB
/releases/18.06.1/targets/x86/generic/openwrt-18.06.1-x86-generic-rootfs-ext4.img.gz;2;0;2;3.16 MB;1.58 MB
/releases/19.07.2/targets/at91/sam9x/openwrt-19.07.2-at91-sam9x-tny_a9g20-ext4-factory.bin.gz;2;0;2;6.01 MB;3.01 MB
/releases/18.06.5/targets/at91/legacy/openwrt-18.06.5-at91-legacy-wb45n-ext4-root.ubi.gz;2;0;2;3.64 MB;1.82 MB
/releases/18.06.5/targets/sunxi/cortexa53/openwrt-18.06.5-sunxi-cortexa53-sun50i-h5-nanopi-neo-plus2-ext4-sdcard.img.gz;2;0;2;6.55 MB;3.28 MB
/releases/17.01.2/targets/oxnas/generic/lede-17.01.2-oxnas-akitio-squashfs-sysupgrade.tar;2;0;2;319.50 KB;159.75 KB
/releases/18.06.1/targets/sunxi/cortexa7/openwrt-18.06.1-sunxi-cortexa7-sun8i-h3-nanopi-neo-squashfs-sdcard.img.gz;2;0;2;4.66 MB;2.33 MB
/releases/17.01.0/targets/sunxi/generic/lede-17.01.0-r3205-59508e3-sunxi-sun4i-a10-pcduino-ext4-sdcard.img.gz;2;0;2;351.50 KB;175.75 KB
/releases/18.06.6/targets/omap/generic/openwrt-18.06.6-omap-am335x-boneblack-ext4-sdcard.img.gz;2;0;2;5.93 MB;2.97 MB
/releases/19.07.2/targets/at91/sam9x/openwrt-19.07.2-at91-sam9x-at91sam9g15ek-ext4-root.ubi.gz;2;0;2;2.64 MB;1.32 MB
/releases/17.01.4/targets/sunxi/generic/lede-17.01.4-sunxi-sun4i-a10-pcduino-squashfs-sdcard.img.gz;2;0;2;367.50 KB;183.75 KB
/releases/19.07.2/targets/oxnas/ox820/openwrt-19.07.2-oxnas-ox820-mitrastar_stg-212-squashfs-sysupgrade.tar;2;0;2;1.50 MB;767.54 KB
/releases/18.06.4/targets/omap/generic/openwrt-18.06.4-omap-omap4-panda-ext4-sdcard.img.gz;2;0;2;5.89 MB;2.95 MB
/releases/18.06.0-rc1/targets/pistachio/generic/openwrt-18.06.0-rc1-pistachio-marduk-squashfs-sysupgrade.tar;2;0;2;7.61 MB;3.81 MB
/releases/18.06.5/targets/sunxi/cortexa53/openwrt-18.06.5-sunxi-cortexa53-sun50i-a64-sopine-baseboard-ext4-sdcard.img.gz;2;0;2;6.55 MB;3.27 MB
/releases/17.01.0-rc2/targets/sunxi/generic/lede-17.01.0-rc2-r3131-42f3c1f-sunxi-sun6i-a31-m9-ext4-sdcard.img.gz;2;0;2;2.72 MB;1.36 MB
/releases/18.06.6/targets/ramips/mt7621/openwrt-18.06.6-ramips-mt7621-ubnt-erx-squashfs-sysupgrade.tar;2;0;2;3.63 MB;1.81 MB
/releases/18.06.3/targets/imx6/generic/openwrt-18.06.3-imx6-ventana-squashfs-bootfs.tar.gz;2;0;2;1.42 MB;727.54 KB
/releases/18.06.2/targets/at91/sama5d2/openwrt-18.06.2-at91-sama5d2-at91-sama5d2_ptc_ek-ext4-sdcard.img.gz;2;0;2;5.73 MB;2.87 MB
/releases/17.01.5/targets/at91/sama5d3/lede-17.01.5-at91-sama5d3-at91sama5d3xplained-rootfs.tar.gz;2;0;2;2.24 MB;1.12 MB
/releases/17.01.1/targets/sunxi/generic/lede-17.01.1-sunxi-sun7i-a20-olinuxino-lime-ext4-sdcard.img.gz;2;0;2;399.50 KB;199.75 KB
/releases/18.06.6/targets/at91/legacy/openwrt-18.06.6-at91-legacy-at91sam9263ek-ext4-zImage.gz;2;0;2;3.36 MB;1.68 MB
/releases/18.06.5/targets/at91/sama5d4/openwrt-18.06.5-at91-sama5d4-rootfs.tar.gz;2;0;2;2.03 MB;1.01 MB
/releases/19.07.2/targets/omap/generic/openwrt-19.07.2-omap-ti_omap4-panda-ext4-sdcard.img.gz;2;0;2;1.42 MB;727.54 KB
/releases/17.01.4/targets/zynq/generic/lede-17.01.4-zynq-zc702-uramdisk.image.gz;2;0;2;415.50 KB;207.75 KB
/releases/19.07.3/targets/sunxi/cortexa7/openwrt-19.07.3-sunxi-cortexa7-sun8i-h3-orangepi-pc-plus-squashfs-sdcard.img.gz;2;0;2;4.90 MB;2.45 MB
/releases/19.07.0-rc2/targets/sunxi/cortexa7/openwrt-19.07.0-rc2-sunxi-cortexa7-sun8i-h3-orangepi-2-squashfs-sdcard.img.gz;2;0;2;5.07 MB;2.53 MB
/releases/18.06.7/targets/imx6/generic/openwrt-18.06.7-imx6-rootfs.tar.gz;2;0;2;2.08 MB;1.04 MB
/releases/18.06.0/targets/sunxi/cortexa7/openwrt-18.06.0-sunxi-cortexa7-sun8i-h3-orangepi-2-ext4-sdcard.img.gz;2;0;2;5.40 MB;2.70 MB
/releases/19.07.2/targets/x86/legacy/openwrt-19.07.2-x86-legacy-rootfs-ext4.img.gz;2;0;2;6.28 MB;3.14 MB
/releases/17.01.1/targets/sunxi/generic/lede-17.01.1-sunxi-sun4i-a10-cubieboard-ext4-sdcard.img.gz;2;0;2;319.50 KB;159.75 KB
/releases/18.06.2/targets/sunxi/cortexa53/openwrt-18.06.2-sunxi-cortexa53-sun50i-a64-pine64-plus-squashfs-sdcard.img.gz;2;0;2;5.75 MB;2.87 MB
/releases/18.06.5/targets/mvebu/cortexa53/openwrt-18.06.5-mvebu-cortexa53-globalscale-espressobin-squashfs-sdcard.img.gz;2;0;2;5.50 MB;2.75 MB
/releases/18.06.2/targets/at91/legacy/openwrt-18.06.2-at91-legacy-at91sam9g15ek-ext4-root.ubi.gz;2;0;2;2.51 MB;1.26 MB
/releases/18.06.6/targets/sunxi/cortexa53/openwrt-18.06.6-sunxi-cortexa53-sun50i-a64-pine64-plus-ext4-sdcard.img.gz;2;0;2;6.55 MB;3.28 MB
/releases/19.07.1/targets/sunxi/cortexa7/openwrt-19.07.1-sunxi-cortexa7-sun7i-a20-pcduino3-ext4-sdcard.img.gz;2;0;2;6.37 MB;3.19 MB
/releases/18.06.5/targets/armvirt/32/openwrt-18.06.5-armvirt-32-default-rootfs.tar.gz;2;0;2;1.99 MB;1020.83 KB
/releases/17.01.0/targets/sunxi/generic/lede-17.01.0-r3205-59508e3-sunxi-sun7i-a20-bananapro-squashfs-sdcard.img.gz;2;0;2;431.50 KB;215.75 KB
/releases/18.06.7/targets/omap/generic/openwrt-18.06.7-omap-omap3-beagle-ext4-sdcard.img.gz;2;0;2;6.01 MB;3.01 MB
/releases/18.06.1/targets/sunxi/cortexa8/openwrt-18.06.1-sunxi-cortexa8-sun4i-a10-marsboard-squashfs-sdcard.img.gz;2;0;2;4.55 MB;2.28 MB
/releases/faillogs-18.06/arc_archs/packages/icu/host-compile.txt;2;0;2;163.92 KB;81.96 KB
/releases/18.06.3/targets/at91/legacy/openwrt-18.06.3-at91-legacy-at91sam9m10g45ek-ext4-root.ubi.gz;2;0;2;2.51 MB;1.26 MB
/releases/19.07.3/targets/octeon/generic/openwrt-19.07.3-octeon-er-squashfs-sysupgrade.tar;2;0;2;17.68 MB;8.84 MB
/releases/17.01.1/targets/rb532/generic/lede-17.01.1-rb532-default-rootfs.tar.gz;2;0;2;223.50 KB;111.75 KB
/releases/18.06.1/targets/at91/legacy/openwrt-18.06.1-at91-legacy-tny_a9263-ext4-factory.bin.gz;2;0;2;5.58 MB;2.79 MB
/releases/17.01.1/targets/oxnas/generic/lede-17.01.1-oxnas-akitio-squashfs-sysupgrade.tar;2;0;2;335.50 KB;167.75 KB
/releases/19.07.1/targets/at91/sam9x/openwrt-19.07.1-at91-sam9x-tny_a9g20-ext4-factory.bin.gz;2;0;2;6.02 MB;3.01 MB
/releases/19.07.3/targets/mediatek/mt7623/openwrt-19.07.3-mediatek-mt7623-7623a-unielec-u7623-02-emmc-512m-squashfs-sysupgrade-emmc.bin.gz;2;0;2;5.22 MB;2.61 MB
/releases/18.06.6/targets/sunxi/cortexa8/openwrt-18.06.6-sunxi-cortexa8-sun4i-a10-marsboard-squashfs-sdcard.img.gz;2;0;2;4.57 MB;2.29 MB
/releases/18.06.7/targets/at91/sama5d2/openwrt-18.06.7-at91-sama5d2-at91-sama5d2_ptc_ek-ext4-sdcard.img.gz;2;0;2;1.89 MB;967.54 KB
/releases/19.07.0-rc1/targets/mvebu/cortexa53/openwrt-19.07.0-rc1-mvebu-cortexa53-globalscale_espressobin-v7-ext4-sdcard.img.gz;2;0;2;6.53 MB;3.26 MB
/releases/18.06.5/targets/brcm2708/bcm2710/openwrt-18.06.5-brcm2708-bcm2710-rpi-3-ext4-sysupgrade.img.gz;2;0;2;17.68 MB;8.84 MB
/releases/18.06.0/targets/sunxi/cortexa8/openwrt-18.06.0-sunxi-cortexa8-sun4i-a10-marsboard-squashfs-sdcard.img.gz;2;0;2;4.55 MB;2.28 MB
/releases/18.06.2/targets/sunxi/cortexa7/openwrt-18.06.2-sunxi-cortexa7-sun7i-a20-pcduino3-ext4-sdcard.img.gz;2;0;2;5.94 MB;2.97 MB
/releases/19.07.0-rc2/targets/armvirt/32/openwrt-19.07.0-rc2-armvirt-32-root.ext4.gz;2;0;2;2.43 MB;1.21 MB
/releases/17.01.0/targets/omap/generic/lede-17.01.0-r3205-59508e3-omap-default-rootfs.tar.gz;2;0;2;271.50 KB;135.75 KB
/releases/18.06.3/targets/omap/generic/openwrt-18.06.3-omap-omap3-beagle-ext4-sdcard.img.gz;2;0;2;6.02 MB;3.01 MB
/releases/18.06.3/targets/sunxi/cortexa8/openwrt-18.06.3-sunxi-cortexa8-sun4i-a10-marsboard-ext4-sdcard.img.gz;2;0;2;5.40 MB;2.70 MB
/releases/18.06.0-rc1/targets/ar71xx/nand/openwrt-18.06.0-rc1-ar71xx-nand-r6100-squashfs-sysupgrade.tar;2;0;2;8.01 MB;4.00 MB
/releases/17.01.0-rc1/targets/kirkwood/generic/lede-17.01.0-rc1-r3042-ec095b5-kirkwood-dockstar-squashfs-sysupgrade.tar;2;0;2;2.86 MB;1.43 MB
/releases/17.01.0/targets/kirkwood/generic/lede-17.01.0-r3205-59508e3-kirkwood-iconnect-squashfs-sysupgrade.tar;2;0;2;3.52 MB;1.76 MB
/releases/19.07.0-rc2/targets/sunxi/cortexa7/openwrt-19.07.0-rc2-sunxi-cortexa7-sun8i-h3-orangepi-one-squashfs-sdcard.img.gz;2;0;2;4.92 MB;2.46 MB
/releases/18.06.1/targets/at91/legacy/openwrt-18.06.1-at91-legacy-at91sam9m10g45ek-ext4-root.ubi.gz;2;0;2;2.50 MB;1.25 MB
/releases/18.06.5/targets/oxnas/ox820/openwrt-18.06.5-oxnas-ox820-akitio-mycloud-ubifs-sysupgrade.tar;2;0;2;8.31 MB;4.16 MB
/releases/18.06.2/targets/oxnas/ox820/openwrt-18.06.2-oxnas-ox820-akitio-mycloud-ubifs-sysupgrade.tar;2;0;2;1.56 MB;799.54 KB
/releases/18.06.2/targets/ramips/mt7621/openwrt-18.06.2-ramips-mt7621-ubnt-erx-squashfs-sysupgrade.tar;2;0;2;6.74 MB;3.37 MB
/releases/17.01.1/targets/oxnas/generic/lede-17.01.1-oxnas-pogoplug-v3-squashfs-sysupgrade.tar;2;0;2;607.50 KB;303.75 KB
/releases/19.07.1/targets/gemini/generic/openwrt-19.07.1-gemini-raidsonic_ib-4220-b-ext4-factory.bin.gz;2;0;2;8.31 MB;4.16 MB
/releases/17.01.4/targets/sunxi/generic/lede-17.01.4-sunxi-sun7i-a20-cubietruck-squashfs-sdcard.img.gz;2;0;2;207.50 KB;103.75 KB
/releases/18.06.0-rc2/targets/apm821xx/nand/openwrt-18.06.0-rc2-apm821xx-nand-meraki_mx60-squashfs-sysupgrade.tar;2;0;2;8.09 MB;4.04 MB
/releases/18.06.2/targets/imx6/generic/openwrt-18.06.2-imx6-ventana-squashfs-bootfs.tar.gz;2;0;2;2.56 MB;1.28 MB
/releases/19.07.2/targets/sunxi/cortexa7/openwrt-19.07.2-sunxi-cortexa7-sun8i-h3-orangepi-2-ext4-sdcard.img.gz;2;0;2;11.22 MB;5.61 MB
/releases/18.06.5/targets/sunxi/cortexa7/openwrt-18.06.5-sunxi-cortexa7-sun7i-a20-bananapi-squashfs-sdcard.img.gz;2;0;2;4.65 MB;2.32 MB
/releases/18.06.0/targets/omap/generic/openwrt-18.06.0-omap-rootfs.tar.gz;2;0;2;2.08 MB;1.04 MB
/releases/18.06.2/targets/mxs/generic/openwrt-18.06.2-mxs-root.ext4.gz;2;0;2;1.53 MB;783.54 KB
/snapshots/faillogs/arm_cortex-a9_neon/packages/perl-inline/host-compile.txt;2;0;2;4.26 KB;2.13 KB
/releases/18.06.3/targets/at91/legacy/openwrt-18.06.3-at91-legacy-wb45n-ext4-root.ubi.gz;2;0;2;3.72 MB;1.86 MB
/releases/18.06.4/targets/at91/sama5d2/openwrt-18.06.4-at91-sama5d2-at91-sama5d2_ptc_ek-ext4-sdcard.img.gz;2;0;2;5.73 MB;2.87 MB
/releases/17.01.2/targets/sunxi/generic/lede-17.01.2-sunxi-sun4i-a10-cubieboard-squashfs-sdcard.img.gz;2;0;2;335.50 KB;167.75 KB
/releases/18.06.3/targets/at91/sama5d3/openwrt-18.06.3-at91-sama5d3-at91-sama5d3_xplained-ext4-zImage.gz;2;0;2;3.19 MB;1.59 MB
/releases/18.06.9/targets/brcm2708/bcm2708/openwrt-18.06.9-brcm2708-bcm2708-rpi-squashfs-factory.img.gz;2;0;2;15.25 MB;7.63 MB
/releases/18.06.1/targets/brcm2708/bcm2709/openwrt-18.06.1-brcm2708-bcm2709-rpi-2-ext4-sysupgrade.img.gz;2;0;2;11.37 MB;5.68 MB
/releases/18.06.4/targets/sunxi/cortexa7/openwrt-18.06.4-sunxi-cortexa7-sun7i-a20-bananapro-squashfs-sdcard.img.gz;2;0;2;5.38 MB;2.69 MB
/releases/18.06.5/targets/at91/legacy/openwrt-18.06.5-at91-legacy-at91sam9g15ek-ext4-root.ubi.gz;2;0;2;2.43 MB;1.22 MB
/releases/18.06.7/targets/oxnas/ox820/openwrt-18.06.7-oxnas-ox820-mitrastar-stg212-squashfs-sysupgrade.tar;2;0;2;5.07 MB;2.54 MB
/releases/18.06.2/targets/sunxi/cortexa53/openwrt-18.06.2-sunxi-cortexa53-sun50i-h5-nanopi-neo-plus2-squashfs-sdcard.img.gz;2;0;2;5.76 MB;2.88 MB
/releases/18.06.2/targets/at91/legacy/openwrt-18.06.2-at91-legacy-at91sam9g35ek-ext4-root.ubi.gz;2;0;2;2.60 MB;1.30 MB
/releases/17.01.1/targets/sunxi/generic/lede-17.01.1-sunxi-sun4i-a10-olinuxino-lime-squashfs-sdcard.img.gz;2;0;2;351.50 KB;175.75 KB
/releases/18.06.4/targets/mvebu/cortexa72/openwrt-18.06.4-mvebu-cortexa72-armada-macchiatobin-squashfs-sdcard.img.gz;2;0;2;5.53 MB;2.77 MB
/releases/18.06.5/targets/brcm2708/bcm2708/openwrt-18.06.5-brcm2708-bcm2708-rpi-ext4-sysupgrade.img.gz;2;0;2;17.45 MB;8.72 MB
/releases/19.07.3/targets/mvebu/cortexa72/openwrt-19.07.3-mvebu-cortexa72-marvell_macchiatobin-squashfs-sdcard.img.gz;2;0;2;5.73 MB;2.87 MB
/releases/18.06.3/targets/at91/legacy/openwrt-18.06.3-at91-legacy-at91sam9g20ek-ext4-root.ubi.gz;2;0;2;2.51 MB;1.26 MB
/releases/18.06.3/targets/sunxi/cortexa53/openwrt-18.06.3-sunxi-cortexa53-sun50i-h5-orangepi-zero-plus-squashfs-sdcard.img.gz;2;0;2;5.77 MB;2.89 MB
/releases/18.06.2/targets/sunxi/cortexa8/openwrt-18.06.2-sunxi-cortexa8-sun4i-a10-olinuxino-lime-squashfs-sdcard.img.gz;2;0;2;4.57 MB;2.28 MB
/releases/19.07.0/targets/tegra/generic/openwrt-19.07.0-tegra-compulab_trimslice-ext4-sdcard.img.gz;2;0;2;12.87 MB;6.43 MB
/releases/18.06.1/targets/x86/geode/openwrt-18.06.1-x86-geode-rootfs-ext4.img.gz;2;0;2;4.67 MB;2.33 MB
/releases/18.06.1/targets/sunxi/cortexa7/openwrt-18.06.1-sunxi-cortexa7-sun7i-a20-olinuxino-micro-squashfs-sdcard.img.gz;2;0;2;4.61 MB;2.31 MB
/releases/18.06.7/targets/ar71xx/nand/openwrt-18.06.7-ar71xx-nand-wi2a-ac200i-squashfs-sysupgrade.tar;2;0;2;4.14 MB;2.07 MB
/releases/19.07.0/targets/x86/legacy/openwrt-19.07.0-x86-legacy-rootfs-ext4.img.gz;2;0;2;6.26 MB;3.13 MB
/releases/18.06.2/targets/sunxi/cortexa8/openwrt-18.06.2-sunxi-cortexa8-sun4i-a10-cubieboard-ext4-sdcard.img.gz;2;0;2;5.40 MB;2.70 MB
/releases/17.01.4/targets/mxs/generic/lede-17.01.4-mxs-root.ext4.gz;2;0;2;351.50 KB;175.75 KB
/releases/19.07.0/targets/oxnas/ox820/openwrt-19.07.0-oxnas-ox820-cloudengines_pogoplugpro-ubifs-sysupgrade.tar;2;0;2;9.31 MB;4.65 MB
/releases/17.01.3/targets/armvirt/generic/lede-17.01.3-armvirt-root.squashfs.gz;2;0;2;1.41 MB;719.75 KB
/releases/18.06.2/targets/at91/sama5d2/openwrt-18.06.2-at91-sama5d2-at91-sama5d2_xplained-ext4-zImage.gz;2;0;2;3.35 MB;1.68 MB
/snapshots/faillogs/arm_fa526/packages/frr/host-compile.txt;2;0;2;15.90 KB;7.95 KB
/releases/17.01.2/targets/x86/64/lede-17.01.2-x86-64-generic-rootfs.tar.gz;2;0;2;367.50 KB;183.75 KB
/releases/18.06.3/targets/oxnas/ox820/openwrt-18.06.3-oxnas-ox820-mitrastar-stg212-squashfs-sysupgrade.tar;2;0;2;4.96 MB;2.48 MB
/releases/18.06.0/targets/sunxi/cortexa8/openwrt-18.06.0-sunxi-cortexa8-sun4i-a10-olinuxino-lime-squashfs-sdcard.img.gz;2;0;2;4.55 MB;2.28 MB
/releases/18.06.7/targets/at91/legacy/openwrt-18.06.7-at91-legacy-at91sam9g15ek-ext4-root.ubi.gz;2;0;2;2.50 MB;1.25 MB
/releases/18.06.5/targets/sunxi/cortexa7/openwrt-18.06.5-sunxi-cortexa7-sun8i-h2-plus-orangepi-r1-squashfs-sdcard.img.gz;2;0;2;4.61 MB;2.31 MB
/releases/19.07.1/targets/brcm63xx/smp/openwrt-19.07.1-brcm63xx-smp-livebox-vmlinux.gz;2;0;2;2.41 MB;1.20 MB
/releases/18.06.4/targets/at91/legacy/openwrt-18.06.4-at91-legacy-at91sam9263ek-ext4-zImage.gz;2;0;2;3.24 MB;1.62 MB
/releases/19.07.3/targets/ar71xx/nand/openwrt-19.07.3-ar71xx-nand-wi2a-ac200i-squashfs-sysupgrade.tar;2;0;2;4.65 MB;2.33 MB
/releases/18.06.0-rc2/targets/brcm2708/bcm2708/openwrt-18.06.0-rc2-brcm2708-bcm2708-rpi-ext4-sdcard.img.gz;2;0;2;1.75 MB;895.54 KB
/releases/18.06.5/targets/omap/generic/openwrt-18.06.5-omap-omap4-panda-ext4-sdcard.img.gz;2;0;2;5.90 MB;2.95 MB
/releases/18.06.4/targets/imx6/generic/openwrt-18.06.4-imx6-ventana-squashfs-bootfs.tar.gz;2;0;2;2.56 MB;1.28 MB
/releases/17.01.4/targets/oxnas/generic/lede-17.01.4-oxnas-kd20-factory.tar.gz;2;0;2;319.50 KB;159.75 KB
/releases/19.07.2/targets/at91/sam9x/openwrt-19.07.2-at91-sam9x-at91sam9g20ek-ext4-zImage.gz;2;0;2;3.50 MB;1.75 MB
/releases/17.01.1/targets/apm821xx/nand/lede-17.01.1-apm821xx-nand-mr24-squashfs-sysupgrade.tar;2;0;2;3.69 MB;1.85 MB
/releases/19.07.1/targets/sunxi/cortexa7/openwrt-19.07.1-sunxi-cortexa7-sun6i-a31-m9-ext4-sdcard.img.gz;2;0;2;6.29 MB;3.15 MB
/releases/18.06.7/targets/at91/sama5d2/openwrt-18.06.7-at91-sama5d2-at91-sama5d2_xplained-ext4-sdcard.img.gz;2;0;2;1.92 MB;983.54 KB
/releases/17.01.5/targets/sunxi/generic/lede-17.01.5-sunxi-sun7i-a20-cubietruck-squashfs-sdcard.img.gz;2;0;2;4.77 MB;2.39 MB
/releases/19.07.3/targets/brcm2708/bcm2709/openwrt-19.07.3-brcm2708-bcm2709-rpi-2-ext4-sysupgrade.img.gz;2;0;2;2.86 MB;1.43 MB
/releases/18.06.4/targets/at91/legacy/openwrt-18.06.4-at91-legacy-usb_a9263-ext4-factory.bin.gz;2;0;2;5.63 MB;2.81 MB
/snapshots/faillogs/mips64_octeonplus/packages/frr/host-compile.txt;2;0;2;15.90 KB;7.95 KB
/releases/18.06.0/targets/sunxi/cortexa7/openwrt-18.06.0-sunxi-cortexa7-sun7i-a20-cubietruck-squashfs-sdcard.img.gz;2;0;2;5.25 MB;2.62 MB
/releases/19.07.1/targets/sunxi/cortexa8/openwrt-19.07.1-sunxi-cortexa8-sun4i-a10-olinuxino-lime-ext4-sdcard.img.gz;2;0;2;5.71 MB;2.86 MB
/releases/18.06.0/targets/mvebu/cortexa72/openwrt-18.06.0-mvebu-cortexa72-armada-macchiatobin-squashfs-sdcard.img.gz;2;0;2;5.65 MB;2.82 MB
/releases/18.06.0-rc2/targets/ar71xx/nand/openwrt-18.06.0-rc2-ar71xx-nand-r6100-squashfs-sysupgrade.tar;2;0;2;7.76 MB;3.88 MB
/releases/18.06.5/targets/sunxi/cortexa53/openwrt-18.06.5-sunxi-cortexa53-sun50i-h5-orangepi-zero-plus-ext4-sdcard.img.gz;2;0;2;6.66 MB;3.33 MB
/releases/18.06.6/targets/sunxi/cortexa7/openwrt-18.06.6-sunxi-cortexa7-sun7i-a20-bananapi-ext4-sdcard.img.gz;2;0;2;5.46 MB;2.73 MB
/releases/17.01.0/targets/ipq806x/generic/lede-17.01.0-r3205-59508e3-ipq806x-R7500-squashfs-sysupgrade.tar;2;0;2;5.09 MB;2.55 MB
/releases/17.01.1/targets/oxnas/generic/lede-17.01.1-oxnas-kd20-squashfs-sysupgrade.tar;2;0;2;319.50 KB;159.75 KB
/releases/17.01.4/targets/sunxi/generic/lede-17.01.4-sunxi-sun7i-a20-olinuxino-micro-ext4-sdcard.img.gz;2;0;2;351.50 KB;175.75 KB
/releases/18.06.7/targets/sunxi/cortexa8/openwrt-18.06.7-sunxi-cortexa8-sun4i-a10-marsboard-squashfs-sdcard.img.gz;2;0;2;5.70 MB;2.85 MB
/releases/18.06.7/targets/at91/legacy/openwrt-18.06.7-at91-legacy-usb_a9260-ext4-factory.bin.gz;2;0;2;3.92 MB;1.96 MB
/releases/18.06.2/targets/at91/legacy/openwrt-18.06.2-at91-legacy-at91sam9g20ek_2mmc-ext4-root.ubi.gz;2;0;2;2.70 MB;1.35 MB
/releases/17.01.0-rc1/targets/mediatek/generic/lede-17.01.0-rc1-r3042-ec095b5-mediatek-eMMC-sysupgrade.tar;2;0;2;3.44 MB;1.72 MB
/releases/18.06.4/targets/at91/legacy/openwrt-18.06.4-at91-legacy-ethernut5-ext4-root.ubi.gz;2;0;2;2.51 MB;1.26 MB
/releases/18.06.4/targets/oxnas/ox820/openwrt-18.06.4-oxnas-ox820-shuttle-kd20-squashfs-sysupgrade.tar;2;0;2;5.43 MB;2.72 MB
/releases/17.01.4/targets/zynq/generic/lede-17.01.4-zynq-zed-uramdisk.image.gz;2;0;2;399.50 KB;199.75 KB
/releases/18.06.3/targets/oxnas/ox820/openwrt-18.06.3-oxnas-ox820-shuttle-kd20-factory.tar.gz;2;0;2;7.13 MB;3.57 MB
/releases/18.06.7/targets/at91/sama5d4/openwrt-18.06.7-at91-sama5d4-rootfs.tar.gz;2;0;2;1.41 MB;719.54 KB
/releases/18.06.4/targets/at91/sama5d4/openwrt-18.06.4-at91-sama5d4-at91-sama5d4_xplained-ext4-root.ubi.gz;2;0;2;2.44 MB;1.22 MB
/releases/18.06.6/targets/sunxi/cortexa53/openwrt-18.06.6-sunxi-cortexa53-sun50i-h5-nanopi-neo-plus2-squashfs-sdcard.img.gz;2;0;2;5.78 MB;2.89 MB
/releases/19.07.2/targets/octeontx/generic/openwrt-19.07.2-octeontx-default-rootfs.tar.gz;2;0;2;3.35 MB;1.67 MB
/releases/17.01.1/targets/archs38/generic/lede-17.01.1-archs38-generic-Default-sdcard-vfat-ext4.img.gz;2;0;2;5.39 MB;2.69 MB
/releases/19.07.3/targets/ar71xx/nand/openwrt-19.07.3-ar71xx-nand-nbg6716-squashfs-sysupgrade.tar;2;0;2;5.02 MB;2.51 MB
/releases/17.01.0-rc2/targets/sunxi/generic/lede-17.01.0-rc2-r3131-42f3c1f-sunxi-sun7i-a20-pcduino3-ext4-sdcard.img.gz;2;0;2;2.78 MB;1.39 MB
/releases/17.01.5/targets/mxs/generic/lede-17.01.5-mxs-root.ext4.gz;2;0;2;4.71 MB;2.36 MB
/releases/19.07.0/targets/armvirt/32/openwrt-19.07.0-armvirt-32-default-rootfs.tar.gz;2;0;2;3.92 MB;1.96 MB
/releases/18.06.5/targets/x86/legacy/openwrt-18.06.5-x86-legacy-generic-rootfs.tar.gz;2;0;2;2.89 MB;1.44 MB
/releases/18.06.7/targets/mvebu/cortexa72/openwrt-18.06.7-mvebu-cortexa72-armada-macchiatobin-squashfs-sdcard.img.gz;2;0;2;5.54 MB;2.77 MB
/releases/18.06.6/targets/omap/generic/openwrt-18.06.6-omap-omap4-panda-ext4-sdcard.img.gz;2;0;2;5.90 MB;2.95 MB
/releases/19.07.2/targets/oxnas/ox820/openwrt-19.07.2-oxnas-ox820-cloudengines_pogoplug-series-3-squashfs-sysupgrade.tar;2;0;2;1.44 MB;735.54 KB
/releases/17.01.6/targets/x86/legacy/lede-17.01.6-x86-legacy-rootfs-ext4.img.gz;2;0;2;3.15 MB;1.58 MB
/releases/17.01.1/targets/imx6/generic/lede-17.01.1-imx6-ventana-squashfs-bootfs.tar.gz;2;0;2;335.50 KB;167.75 KB
/releases/19.07.0-rc2/targets/sunxi/cortexa7/openwrt-19.07.0-rc2-sunxi-cortexa7-sun7i-a20-cubieboard2-ext4-sdcard.img.gz;2;0;2;5.77 MB;2.89 MB
/releases/18.06.1/targets/oxnas/ox820/openwrt-18.06.1-oxnas-ox820-cloudengines-pogoplug-pro-squashfs-sysupgrade.tar;2;0;2;4.81 MB;2.40 MB
/releases/17.01.5/targets/sunxi/generic/lede-17.01.5-sunxi-sun7i-a20-olinuxino-lime-ext4-sdcard.img.gz;2;0;2;4.91 MB;2.46 MB
/releases/17.01.1/targets/x86/generic/lede-17.01.1-x86-generic-generic-rootfs.tar.gz;2;0;2;2.85 MB;1.42 MB
/releases/18.06.5/targets/armvirt/64/openwrt-18.06.5-armvirt-64-default-rootfs.tar.gz;2;0;2;3.94 MB;1.97 MB
/releases/17.01.1/targets/kirkwood/generic/lede-17.01.1-kirkwood-linksys-audi-squashfs-sysupgrade.tar;2;0;2;7.75 MB;3.88 MB
/releases/18.06.5/targets/sunxi/cortexa7/openwrt-18.06.5-sunxi-cortexa7-sun8i-h3-orangepi-pc-ext4-sdcard.img.gz;2;0;2;5.43 MB;2.71 MB
/releases/18.06.0-rc2/targets/mvebu/cortexa9/openwrt-18.06.0-rc2-mvebu-cortexa9-armada-388-clearfog-pro-squashfs-sdcard.img.gz;2;0;2;4.68 MB;2.34 MB
/releases/18.06.2/targets/brcm2708/bcm2709/openwrt-18.06.2-brcm2708-bcm2709-rpi-2-squashfs-factory.img.gz;2;0;2;15.51 MB;7.76 MB
/releases/18.06.7/targets/at91/legacy/openwrt-18.06.7-at91-legacy-lmu5000-ext4-factory.bin.gz;2;0;2;5.66 MB;2.83 MB
/releases/18.06.3/targets/omap/generic/openwrt-18.06.3-omap-omap4-panda-ubifs-sdcard.img.gz;2;0;2;6.07 MB;3.03 MB
/releases/18.06.7/targets/at91/legacy/openwrt-18.06.7-at91-legacy-usb_a9g20-ext4-factory.bin.gz;2;0;2;5.62 MB;2.81 MB
/releases/18.06.2/targets/sunxi/cortexa7/openwrt-18.06.2-sunxi-cortexa7-sun8i-h3-orangepi-2-ext4-sdcard.img.gz;2;0;2;5.42 MB;2.71 MB
/releases/18.06.7/targets/oxnas/ox820/openwrt-18.06.7-oxnas-ox820-akitio-mycloud-squashfs-sysupgrade.tar;2;0;2;5.20 MB;2.60 MB
/releases/17.01.4/targets/sunxi/generic/lede-17.01.4-sunxi-sun7i-a20-bananapro-ext4-sdcard.img.gz;2;0;2;431.50 KB;215.75 KB
/releases/18.06.0/targets/sunxi/cortexa7/openwrt-18.06.0-sunxi-cortexa7-sun8i-h3-nanopi-m1-plus-ext4-sdcard.img.gz;2;0;2;6.64 MB;3.32 MB
/releases/18.06.6/targets/omap/generic/openwrt-18.06.6-omap-omap4-panda-ubifs-sdcard.img.gz;2;0;2;6.06 MB;3.03 MB
/releases/19.07.2/targets/x86/geode/openwrt-19.07.2-x86-geode-rootfs-ext4.img.gz;2;0;2;4.93 MB;2.47 MB
/releases/17.01.7/targets/ipq806x/generic/lede-17.01.7-ipq806x-R7500-squashfs-sysupgrade.tar;2;0;2;1.92 MB;983.75 KB
/releases/19.07.2/targets/ar71xx/nand/openwrt-19.07.2-ar71xx-nand-wndr4300-squashfs-sysupgrade.tar;2;0;2;3.42 MB;1.71 MB
/releases/19.07.0-rc2/targets/sunxi/cortexa7/openwrt-19.07.0-rc2-sunxi-cortexa7-sun7i-a20-bananapro-ext4-sdcard.img.gz;2;0;2;6.56 MB;3.28 MB
/releases/19.07.3/targets/mvebu/cortexa72/openwrt-19.07.3-mvebu-cortexa72-marvell_macchiatobin-ext4-sdcard.img.gz;2;0;2;6.64 MB;3.32 MB
/releases/17.01.7/targets/sunxi/generic/lede-17.01.7-sunxi-sun7i-a20-bananapi-squashfs-sdcard.img.gz;2;0;2;4.16 MB;2.08 MB
/releases/18.06.7/targets/omap/generic/openwrt-18.06.7-omap-am335x-boneblack-ext4-sdcard.img.gz;2;0;2;5.95 MB;2.97 MB
/releases/17.01.0/targets/sunxi/generic/lede-17.01.0-r3205-59508e3-sunxi-sun6i-a31-m9-ext4-sdcard.img.gz;2;0;2;367.50 KB;183.75 KB
/releases/19.07.0-rc2/targets/sunxi/cortexa7/openwrt-19.07.0-rc2-sunxi-cortexa7-sun8i-h3-bananapi-m2-plus-squashfs-sdcard.img.gz;2;0;2;6.09 MB;3.04 MB
/releases/19.07.0-rc2/targets/sunxi/cortexa7/openwrt-19.07.0-rc2-sunxi-cortexa7-sun8i-h3-orangepi-pc-plus-squashfs-sdcard.img.gz;2;0;2;4.90 MB;2.45 MB
/releases/17.01.5/targets/apm821xx/nand/lede-17.01.5-apm821xx-nand-mr24-squashfs-sysupgrade.tar;2;0;2;6.99 MB;3.50 MB
/snapshots/faillogs/mips_4kec/packages/node/host-compile.txt;2;0;2;4.02 MB;2.01 MB
/releases/17.01.5/targets/x86/geode/lede-17.01.5-x86-geode-combined-ext4.img.gz;2;0;2;6.91 MB;3.46 MB
/releases/18.06.0/targets/apm821xx/nand/openwrt-18.06.0-apm821xx-nand-meraki_mx60-squashfs-sysupgrade.tar;2;0;2;10.10 MB;5.05 MB
/releases/18.06.0/targets/at91/sama5d2/openwrt-18.06.0-at91-sama5d2-at91-sama5d27_som1_ek-ext4-sdcard.img.gz;2;0;2;5.68 MB;2.84 MB
/releases/18.06.7/targets/oxnas/ox820/openwrt-18.06.7-oxnas-ox820-cloudengines-pogoplug-series-3-squashfs-sysupgrade.tar;2;0;2;4.85 MB;2.43 MB
/releases/18.06.5/targets/x86/geode/openwrt-18.06.5-x86-geode-rootfs-squashfs.img.gz;2;0;2;3.68 MB;1.84 MB
/releases/17.01.2/targets/x86/geode/lede-17.01.2-x86-geode-rootfs-ext4.img.gz;2;0;2;351.50 KB;175.75 KB
/releases/18.06.2/targets/at91/sama5d2/openwrt-18.06.2-at91-sama5d2-at91-sama5d27_som1_ek-ext4-sdcard.img.gz;2;0;2;5.72 MB;2.86 MB
/releases/19.07.1/targets/omap/generic/openwrt-19.07.1-omap-ti_am335x-evm-ext4-sdcard.img.gz;2;0;2;6.82 MB;3.41 MB
/releases/17.01.0-rc2/targets/sunxi/generic/lede-17.01.0-rc2-r3131-42f3c1f-sunxi-sun8i-h3-orangepi-plus-ext4-sdcard.img.gz;2;0;2;3.25 MB;1.62 MB
/releases/17.01.0/targets/sunxi/generic/lede-17.01.0-r3205-59508e3-sunxi-sun7i-a20-bananapi-ext4-sdcard.img.gz;2;0;2;383.50 KB;191.75 KB
/releases/19.07.0-rc2/targets/sunxi/cortexa8/openwrt-19.07.0-rc2-sunxi-cortexa8-sun5i-a13-olinuxino-ext4-sdcard.img.gz;2;0;2;6.17 MB;3.08 MB
/releases/19.07.0/targets/rb532/generic/openwrt-19.07.0-rb532-default-rootfs.tar.gz;2;0;2;3.65 MB;1.83 MB
/releases/18.06.7/targets/at91/legacy/openwrt-18.06.7-at91-legacy-at91sam9x25ek-ext4-root.ubi.gz;2;0;2;2.51 MB;1.26 MB
/releases/19.07.2/targets/octeon/generic/openwrt-19.07.2-octeon-erlite-squashfs-sysupgrade.tar;2;0;2;6.48 MB;3.24 MB
/releases/18.06.3/targets/at91/sama5d3/openwrt-18.06.3-at91-sama5d3-at91-sama5d3_xplained-ext4-sdcard.img.gz;2;0;2;5.80 MB;2.90 MB
/releases/17.01.0-rc2/targets/kirkwood/generic/lede-17.01.0-rc2-r3131-42f3c1f-kirkwood-ib62x0-squashfs-sysupgrade.tar;2;0;2;527.49 KB;263.75 KB
/releases/17.01-SNAPSHOT/targets/sunxi/generic/lede-17.01-snapshot-r4046-beaa2ec-sunxi-sun7i-a20-cubieboard2-squashfs-sdcard.img.gz;2;0;2;175.49 KB;87.75 KB
/releases/18.06.0/targets/x86/legacy/openwrt-18.06.0-x86-legacy-rootfs-squashfs.img.gz;2;0;2;2.46 MB;1.23 MB
/releases/18.06.0-rc1/targets/armvirt/32/openwrt-18.06.0-rc1-armvirt-32-root.squashfs.gz;2;0;2;2.87 MB;1.44 MB
/releases/18.06.2/targets/at91/legacy/openwrt-18.06.2-at91-legacy-wb45n-ext4-root.ubi.gz;2;0;2;3.70 MB;1.85 MB
/releases/18.06.4/targets/sunxi/cortexa53/openwrt-18.06.4-sunxi-cortexa53-sun50i-a64-pine64-plus-squashfs-sdcard.img.gz;2;0;2;335.08 KB;167.54 KB
/releases/19.07.3/targets/zynq/generic/openwrt-19.07.3-zynq-xlnx_zynq-zc702-squashfs-sdcard.img.gz;2;0;2;6.04 MB;3.02 MB
/releases/18.06.5/targets/armvirt/32/openwrt-18.06.5-armvirt-32-root.ext4.gz;2;0;2;2.23 MB;1.12 MB
/releases/18.06.0-rc2/targets/apm821xx/nand/openwrt-18.06.0-rc2-apm821xx-nand-netgear_wndr4700-squashfs-sysupgrade.tar;2;0;2;8.24 MB;4.12 MB
/releases/17.01.0-rc1/targets/oxnas/generic/lede-17.01.0-rc1-r3042-ec095b5-oxnas-pogoplug-v3-squashfs-sysupgrade.tar;2;0;2;3.22 MB;1.61 MB
/releases/17.01.2/targets/arc770/generic/lede-17.01.2-arc770-generic-root.ext4.gz;2;0;2;2.77 MB;1.39 MB
/releases/18.06.0/targets/mvebu/cortexa72/openwrt-18.06.0-mvebu-cortexa72-armada-macchiatobin-ext4-sdcard.img.gz;2;0;2;6.26 MB;3.13 MB
/releases/19.07.1/targets/at91/sam9x/openwrt-19.07.1-at91-sam9x-at91sam9g15ek-ext4-root.ubi.gz;2;0;2;2.71 MB;1.36 MB
/releases/18.06.6/targets/imx6/generic/openwrt-18.06.6-imx6-ventana-squashfs-bootfs.tar.gz;2;0;2;2.57 MB;1.28 MB
/releases/17.01.6/targets/ar71xx/nand/lede-17.01.6-ar71xx-nand-nbg6716-squashfs-sysupgrade.tar;1;0;1;79.75 KB;79.75 KB
/releases/19.07.0-rc1/targets/sunxi/cortexa7/openwrt-19.07.0-rc1-sunxi-cortexa7-sun7i-a20-cubieboard2-squashfs-sdcard.img.gz;1;0;1;4.79 MB;4.79 MB
/releases/18.06.3/targets/brcm2708/bcm2710/openwrt-18.06.3-brcm2708-bcm2710-rpi-3-ext4-sysupgrade.img.gz;1;0;1;8.83 MB;8.83 MB
/snapshots/faillogs/mipsel_24kc/packages/softethervpn/host-compile.txt;1;0;1;103.24 KB;103.24 KB
/releases/18.06.6/targets/gemini/generic/openwrt-18.06.6-gemini-dns313-bootpart.tar.gz;1;0;1;2.24 MB;2.24 MB
/releases/17.01.0-rc2/targets/brcm2708/bcm2709/lede-17.01.0-rc2-r3131-42f3c1f-brcm2708-bcm2709-rpi-2-ext4-sdcard.img.gz;1;0;1;159.75 KB;159.75 KB
/releases/18.06.2/targets/brcm2708/bcm2708/openwrt-18.06.2-brcm2708-bcm2708-rpi-ext4-factory.img.gz;1;0;1;8.70 MB;8.70 MB
/releases/18.06.3/targets/brcm2708/bcm2708/openwrt-18.06.3-brcm2708-bcm2708-rpi-squashfs-factory.img.gz;1;0;1;7.61 MB;7.61 MB
/releases/18.06.6/targets/octeon/generic/openwrt-18.06.6-octeon-erlite-squashfs-sysupgrade.tar;1;0;1;8.83 MB;8.83 MB
/releases/18.06.4/targets/sunxi/cortexa7/openwrt-18.06.4-sunxi-cortexa7-sun8i-h3-nanopi-m1-plus-ext4-sdcard.img.gz;1;0;1;191.54 KB;191.54 KB
/snapshots/targets/scheduled_for_removal/brcm47xx/generic/kernel-debug.tar.bz2;1;0;1;0;0
/releases/19.07.0-rc1/targets/x86/64/openwrt-19.07.0-rc1-x86-64-combined-squashfs.img.gz;1;0;1;6.68 MB;6.68 MB
/releases/18.06.7/targets/sunxi/cortexa8/openwrt-18.06.7-sunxi-cortexa8-sun5i-a13-olinuxino-ext4-sdcard.img.gz;1;0;1;1.72 MB;1.72 MB
/releases/19.07.0-rc1/targets/ar71xx/nand/openwrt-19.07.0-rc1-ar71xx-nand-mr18-squashfs-sysupgrade.tar;1;0;1;7.39 MB;7.39 MB
/releases/18.06.5/targets/archs38/generic/openwrt-18.06.5-archs38-generic-Default-sdcard-vfat-ext4.img.gz;1;0;1;5.93 MB;5.93 MB
/releases/18.06.6/targets/ar71xx/nand/openwrt-18.06.6-ar71xx-nand-c-60-squashfs-sysupgrade.tar;1;0;1;3.71 MB;3.71 MB
/releases/19.07.0-rc2/targets/mvebu/cortexa72/openwrt-19.07.0-rc2-mvebu-cortexa72-marvell_armada7040-db-squashfs-sdcard.img.gz;1;0;1;5.57 MB;5.57 MB
//snapshots/targets/mvebu/cortexa53/openwrt-mvebu-cortexa53-globalscale_espressobin-v7-squashfs-sdcard.img.gz;1;0;1;6.89 MB;6.89 MB
/releases/18.06.0-rc2/targets/x86/legacy/openwrt-18.06.0-rc2-x86-legacy-rootfs-ext4.img.gz;1;0;1;3.02 MB;3.02 MB
/releases/18.06.0-rc2/targets/at91/sama5d4/openwrt-18.06.0-rc2-at91-sama5d4-at91-sama5d4_xplained-ext4-zImage.gz;1;0;1;3.02 MB;3.02 MB
/releases/19.07.0-rc1/targets/x86/64/openwrt-19.07.0-rc1-x86-64-rootfs-ext4.img.gz;1;0;1;3.91 MB;3.91 MB
//snapshots/targets/sunxi/cortexa7/openwrt-sunxi-cortexa7-linksprite_pcduino3-ext4-sdcard.img.gz;1;0;1;6.86 MB;6.86 MB
/releases/19.07.1/targets/tegra/generic/openwrt-19.07.1-tegra-compulab_trimslice-squashfs-sdcard.img.gz;1;0;1;5.38 MB;5.38 MB
/releases/17.01.2/targets/brcm63xx/generic/lede-17.01.2-brcm63xx-generic-livebox-vmlinux.gz;1;0;1;159.75 KB;159.75 KB
/releases/18.06.5/targets/ar71xx/nand/openwrt-18.06.5-ar71xx-nand-wndr4300-squashfs-sysupgrade.tar;1;0;1;4.51 MB;4.51 MB
/releases/19.07-SNAPSHOT/targets/x86/64/openwrt-19.07-snapshot-r11228-78c4c04dd7-x86-64-combined-ext4.img.gz;1;0;1;7.79 MB;7.79 MB
//snapshots/targets/mvebu/cortexa53/openwrt-mvebu-cortexa53-marvell_armada-3720-db-squashfs-sdcard.img.gz;1;0;1;6.89 MB;6.89 MB
/releases/17.01.7/targets/omap/generic/lede-17.01.7-omap-default-rootfs.tar.gz;1;0;1;159.75 KB;159.75 KB
//snapshots/targets/sunxi/cortexa7/openwrt-sunxi-cortexa7-lemaker_bananapro-ext4-sdcard.img.gz;1;0;1;7.11 MB;7.11 MB
/releases/19.07.0-rc2/targets/ar71xx/nand/openwrt-19.07.0-rc2-ar71xx-nand-wi2a-ac200i-squashfs-sysupgrade.tar;1;0;1;4.37 MB;4.37 MB
/releases/18.06.3/targets/brcm2708/bcm2708/openwrt-18.06.3-brcm2708-bcm2708-rpi-ext4-factory.img.gz;1;0;1;8.71 MB;8.71 MB
/releases/17.01.7/targets/x86/geode/lede-17.01.7-x86-geode-rootfs-ext4.img.gz;1;0;1;143.75 KB;143.75 KB
/releases/17.01.0-rc2/targets/x86/legacy/lede-17.01.0-rc2-r3131-42f3c1f-x86-legacy-combined-ext4.img.gz;1;0;1;143.75 KB;143.75 KB
/releases/19.07.1/targets/sunxi/cortexa7/openwrt-19.07.1-sunxi-cortexa7-sun7i-a20-lamobo-r1-squashfs-sdcard.img.gz;1;0;1;5.43 MB;5.43 MB
/releases/18.06.7/targets/brcm2708/bcm2710/openwrt-18.06.7-brcm2708-bcm2710-rpi-3-squashfs-sysupgrade.img.gz;1;0;1;1.28 MB;1.28 MB
/releases/18.06.9/targets/brcm2708/bcm2709/openwrt-18.06.9-brcm2708-bcm2709-rpi-2-squashfs-factory.img.gz;1;0;1;7.78 MB;7.78 MB
/releases/19.07.2/targets/ar71xx/nand/openwrt-19.07.2-ar71xx-nand-wi2a-ac200i-squashfs-sysupgrade.tar;1;0;1;4.38 MB;4.38 MB
/releases/17.01.0-rc1/targets/sunxi/generic/lede-17.01.0-rc1-r3042-ec095b5-sunxi-sun7i-a20-olinuxino-micro-ext4-sdcard.img.gz;1;0;1;79.75 KB;79.75 KB
/releases/18.06.0-rc2/targets/sunxi/cortexa7/openwrt-18.06.0-rc2-sunxi-cortexa7-sun6i-a31-m9-squashfs-sdcard.img.gz;1;0;1;4.80 MB;4.80 MB
/snapshots/targets/scheduled_for_removal/brcm2708/bcm2709/openwrt-brcm2708-bcm2709-rpi-2-ext4-factory.img.gz;1;0;1;0;0
/releases/18.06.2/targets/brcm2708/bcm2708/openwrt-18.06.2-brcm2708-bcm2708-rpi-squashfs-sysupgrade.img.gz;1;0;1;7.60 MB;7.60 MB
/releases/19.07.0-rc2/targets/ar71xx/nand/openwrt-19.07.0-rc2-ar71xx-nand-hiveap-121-squashfs-sysupgrade.tar;1;0;1;4.07 MB;4.07 MB
/releases/18.06.6/targets/armvirt/32/openwrt-18.06.6-armvirt-32-root.ext4.gz;1;0;1;2.13 MB;2.13 MB
/releases/18.06.0-rc2/targets/omap/generic/openwrt-18.06.0-rc2-omap-am335x-evm-ext4-sdcard.img.gz;1;0;1;5.80 MB;5.80 MB
/releases/17.01.7/targets/oxnas/generic/lede-17.01.7-oxnas-pogoplug-pro-squashfs-sysupgrade.tar;1;0;1;159.75 KB;159.75 KB
/releases/18.06.0-rc2/targets/mvebu/cortexa72/openwrt-18.06.0-rc2-mvebu-cortexa72-armada-macchiatobin-ext4-sdcard.img.gz;1;0;1;6.13 MB;6.13 MB
/releases/17.01.0-rc2/targets/x86/generic/lede-17.01.0-rc2-r3131-42f3c1f-x86-generic-generic-rootfs.tar.gz;1;0;1;127.75 KB;127.75 KB
/releases/18.06.0-rc2/targets/x86/64/openwrt-18.06.0-rc2-x86-64-rootfs-squashfs.img.gz;1;0;1;2.37 MB;2.37 MB
/releases/17.01.6/targets/apm821xx/nand/lede-17.01.6-apm821xx-nand-mr24-squashfs-sysupgrade.tar;1;0;1;3.71 MB;3.71 MB
/releases/17.01.0-rc2/targets/x86/64/lede-17.01.0-rc2-r3131-42f3c1f-x86-64-generic-rootfs.tar.gz;1;0;1;143.75 KB;143.75 KB
/releases/18.06.0-rc2/targets/mvebu/cortexa72/openwrt-18.06.0-rc2-mvebu-cortexa72-armada-macchiatobin-squashfs-sdcard.img.gz;1;0;1;5.34 MB;5.34 MB
/releases/19.07.0-rc2/targets/zynq/generic/openwrt-19.07.0-rc2-zynq-xlnx_zynq-zc702-squashfs-sdcard.img.gz;1;0;1;5.87 MB;5.87 MB
/releases/18.06.9/targets/sunxi/cortexa7/openwrt-18.06.9-sunxi-cortexa7-sun8i-h2-plus-orangepi-r1-ext4-sdcard.img.gz;1;0;1;5.29 MB;5.29 MB
/releases/17.01.6/targets/brcm2708/bcm2708/lede-17.01.6-brcm2708-bcm2708-rpi-ext4-sdcard.img.gz;1;0;1;7.96 MB;7.96 MB
/releases/19.07.0-rc1/targets/at91/sam9x/openwrt-19.07.0-rc1-at91-sam9x-at91sam9g20ek_2mmc-ext4-root.ubi.gz;1;0;1;2.47 MB;2.47 MB
/releases/18.06.0-rc2/targets/x86/legacy/openwrt-18.06.0-rc2-x86-legacy-generic-rootfs.tar.gz;1;0;1;2.75 MB;2.75 MB
//releases/19.07.3/targets/sunxi/cortexa8/openwrt-19.07.3-sunxi-cortexa8-sun4i-a10-pcduino-ext4-sdcard.img.gz;1;0;1;6.08 MB;6.08 MB
/releases/19.07.1/targets/sunxi/cortexa7/openwrt-19.07.1-sunxi-cortexa7-sun7i-a20-olinuxino-lime2-emmc-ext4-sdcard.img.gz;1;0;1;5.74 MB;5.74 MB
/releases/18.06.4/targets/sunxi/cortexa7/openwrt-18.06.4-sunxi-cortexa7-sun7i-a20-olinuxino-lime2-ext4-sdcard.img.gz;1;0;1;159.54 KB;159.54 KB
/releases/18.06.0/targets/octeontx/generic/openwrt-18.06.0-octeontx-default-rootfs.tar.gz;1;0;1;1.97 MB;1.97 MB
//snapshots/targets/at91/sama5/openwrt-at91-sama5-microchip_sama5d3-xplained-ext4-root.ubi.gz;1;0;1;2.33 MB;2.33 MB
/releases/17.01.0-rc2/targets/mediatek/generic/lede-17.01.0-rc2-r3131-42f3c1f-mediatek-NAND-squashfs-sysupgrade.tar;1;0;1;271.75 KB;271.75 KB
/releases/17.01.6/targets/imx6/generic/lede-17.01.6-imx6-ventana-squashfs-bootfs.tar.gz;1;0;1;159.75 KB;159.75 KB
/releases/18.06.3/targets/gemini/generic/openwrt-18.06.3-gemini-sysupgrade-ib4220b.tar.gz;1;0;1;1.28 MB;1.28 MB
/releases/18.06.6/targets/x86/generic/openwrt-18.06.6-x86-generic-rootfs-ext4.img.gz;1;0;1;3.01 MB;3.01 MB
/releases/18.06.5/targets/brcm2708/bcm2709/openwrt-18.06.5-brcm2708-bcm2709-rpi-2-ext4-sysupgrade.img.gz;1;0;1;8.87 MB;8.87 MB
/releases/19.07.0-rc1/targets/at91/sam9x/openwrt-19.07.0-rc1-at91-sam9x-wb45n-ext4-root.ubi.gz;1;0;1;3.71 MB;3.71 MB
/releases/18.06.7/targets/armvirt/64/openwrt-18.06.7-armvirt-64-rootfs.cpio.gz;1;0;1;20 Bytes;20 Bytes
/releases/19.07.1/targets/sunxi/cortexa7/openwrt-19.07.1-sunxi-cortexa7-sun7i-a20-olinuxino-micro-squashfs-sdcard.img.gz;1;0;1;4.80 MB;4.80 MB
/releases/19.07.0-rc2/targets/at91/sam9x/openwrt-19.07.0-rc2-at91-sam9x-rootfs.tar.gz;1;0;1;2.11 MB;2.11 MB
/releases/19.07.0-rc1/targets/at91/sam9x/openwrt-19.07.0-rc1-at91-sam9x-usb_a9g20-ext4-factory.bin.gz;1;0;1;5.84 MB;5.84 MB
/releases/18.06.1/targets/gemini/generic/openwrt-18.06.1-gemini-nas4220b-hddapp.tgz;1;0;1;2.62 MB;2.62 MB
/releases/19.07.2/targets/sunxi/cortexa7/openwrt-19.07.2-sunxi-cortexa7-sun8i-h2-plus-orangepi-zero-squashfs-sdcard.img.gz;1;0;1;4.75 MB;4.75 MB
/releases/18.06.0/targets/armvirt/32/openwrt-18.06.0-armvirt-32-default-rootfs.tar.gz;1;0;1;1.85 MB;1.85 MB
/releases/19.07.1/targets/sunxi/cortexa7/openwrt-19.07.1-sunxi-cortexa7-sun8i-h3-bananapi-m2-plus-squashfs-sdcard.img.gz;1;0;1;5.86 MB;5.86 MB
/releases/17.01-SNAPSHOT/targets/arc770/generic/lede-17.01-snapshot-r4046-beaa2ec-arc770-generic-Default-sdcard-vfat-ext4.img.gz;1;0;1;575.75 KB;575.75 KB
/releases/19.07.0-rc2/targets/at91/sam9x/openwrt-19.07.0-rc2-at91-sam9x-tny_a9260-ext4-factory.bin.gz;1;0;1;5.85 MB;5.85 MB
/releases/faillogs-18.06/armeb_xscale/packages/node/host-compile.txt;1;0;1;2.41 MB;2.41 MB
/releases/17.01.1/targets/kirkwood/generic/lede-17.01.1-kirkwood-pogo_e02-squashfs-sysupgrade.tar;1;0;1;63.75 KB;63.75 KB
/releases/19.07.0-rc2/targets/ar71xx/nand/openwrt-19.07.0-rc2-ar71xx-nand-nbg6716-squashfs-sysupgrade.tar;1;0;1;4.76 MB;4.76 MB
/releases/18.06.7/targets/armvirt/64/openwrt-18.06.7-armvirt-64-root.squashfs.gz;1;0;1;1.57 MB;1.57 MB
/releases/19.07.0-rc2/targets/oxnas/ox820/openwrt-19.07.0-rc2-oxnas-ox820-shuttle_kd20-squashfs-sysupgrade.tar;1;0;1;5.53 MB;5.53 MB
/releases/17.01.0/targets/kirkwood/generic/lede-17.01.0-r3205-59508e3-kirkwood-goflexnet-squashfs-sysupgrade.tar;1;0;1;2.80 MB;2.80 MB
/snapshots/targets/scheduled_for_removal/adm5120/router_le/kernel-debug.tar.bz2;1;0;1;0;0
/releases/19.07.3/targets/octeontx/generic/openwrt-19.07.3-octeontx-default-rootfs.tar.gz;1;0;1;2.05 MB;2.05 MB
/releases/17.01.1/targets/kirkwood/generic/lede-17.01.1-kirkwood-goflexnet-squashfs-sysupgrade.tar;1;0;1;127.75 KB;127.75 KB
/releases/18.06.4/targets/octeon/generic/openwrt-18.06.4-octeon-er-squashfs-sysupgrade.tar;1;0;1;8.82 MB;8.82 MB
/releases/18.06.3/targets/arc770/generic/openwrt-18.06.3-arc770-generic-Default-sdcard-vfat-ext4.img.gz;1;0;1;4.87 MB;4.87 MB
/releases/19.07.1/targets/sunxi/cortexa7/openwrt-19.07.1-sunxi-cortexa7-sun8i-h3-nanopi-neo-ext4-sdcard.img.gz;1;0;1;5.59 MB;5.59 MB
/releases/18.06.3/targets/ar71xx/nand/openwrt-18.06.3-ar71xx-nand-wndr4300-squashfs-sysupgrade.tar;1;0;1;4.51 MB;4.51 MB
/releases/17.01.6/targets/sunxi/generic/lede-17.01.6-sunxi-sun7i-a20-lamobo-r1-ext4-sdcard.img.gz;1;0;1;191.75 KB;191.75 KB
/releases/18.06.4/targets/brcm2708/bcm2709/openwrt-18.06.4-brcm2708-bcm2709-rpi-2-squashfs-factory.img.gz;1;0;1;7.76 MB;7.76 MB
/releases/18.06.5/targets/gemini/generic/openwrt-18.06.5-gemini-nas4220b-rd.gz;1;0;1;6.00 MB;6.00 MB
//snapshots/targets/sunxi/cortexa7/openwrt-sunxi-cortexa7-olimex_a20-olinuxino-lime2-ext4-sdcard.img.gz;1;0;1;6.42 MB;6.42 MB
/releases/17.01.6/targets/sunxi/generic/lede-17.01.6-sunxi-sun7i-a20-bananapro-ext4-sdcard.img.gz;1;0;1;159.75 KB;159.75 KB
/releases/19.07.0-rc1/targets/sunxi/cortexa53/openwrt-19.07.0-rc1-sunxi-cortexa53-sun50i-h5-nanopi-neo-plus2-ext4-sdcard.img.gz;1;0;1;6.77 MB;6.77 MB
//releases/19.07.3/targets/brcm2708/bcm2710/openwrt-19.07.3-brcm2708-bcm2710-rpi-3-ext4-factory.img.gz;1;0;1;12.08 MB;12.08 MB
/releases/17.01.2/targets/ipq806x/generic/lede-17.01.2-ipq806x-AP148-legacy-ubifs-nand-sysupgrade.tar;1;0;1;159.75 KB;159.75 KB
/releases/18.06.0/targets/octeon/generic/openwrt-18.06.0-octeon-erlite-squashfs-sysupgrade.tar;1;0;1;8.75 MB;8.75 MB
/releases/18.06.6/targets/brcm2708/bcm2710/openwrt-18.06.6-brcm2708-bcm2710-rpi-3-squashfs-sysupgrade.img.gz;1;0;1;1.30 MB;1.30 MB
/releases/18.06.0-rc1/targets/mxs/generic/openwrt-18.06.0-rc1-mxs-root.ext4.gz;1;0;1;5.21 MB;5.21 MB
//snapshots/targets/rockchip/armv8/openwrt-rockchip-armv8-radxa_rock-pi-4-squashfs-sysupgrade.img.gz;1;0;1;7.87 MB;7.87 MB
/releases/19.07.0/targets/ar71xx/nand/openwrt-19.07.0-ar71xx-nand-mr18-squashfs-sysupgrade.tar;1;0;1;7.40 MB;7.40 MB
/releases/18.06.9/targets/brcm2708/bcm2709/openwrt-18.06.9-brcm2708-bcm2709-rpi-2-squashfs-sysupgrade.img.gz;1;0;1;7.78 MB;7.78 MB
/releases/19.07.2/targets/mvebu/cortexa53/openwrt-19.07.2-mvebu-cortexa53-globalscale_espressobin-squashfs-sdcard.img.gz;1;0;1;5.45 MB;5.45 MB
/releases/17.01.7/targets/sunxi/generic/lede-17.01.7-sunxi-sun7i-a20-pcduino3-ext4-sdcard.img.gz;1;0;1;159.75 KB;159.75 KB
/releases/18.06-SNAPSHOT/targets/omap/generic/openwrt-18.06-snapshot-r8073-5625f5bc36-omap-am335x-boneblack-ext4-sdcard.img.gz;1;0;1;5.80 MB;5.80 MB
/releases/19.07.0-rc2/targets/brcm2708/bcm2709/openwrt-19.07.0-rc2-brcm2708-bcm2709-rpi-2-ext4-factory.img.gz;1;0;1;11.97 MB;11.97 MB
/releases/18.06.7/targets/brcm2708/bcm2708/openwrt-18.06.7-brcm2708-bcm2708-rpi-squashfs-sysupgrade.img.gz;1;0;1;1.28 MB;1.28 MB
/releases/17.01.5/targets/armvirt/generic/lede-17.01.5-armvirt-rootfs.cpio.gz;1;0;1;1.82 MB;1.82 MB
/snapshots/targets/scheduled_for_removal/brcm2708/bcm2710/openwrt-brcm2708-bcm2710-rpi-3-squashfs-sysupgrade.img.gz;1;0;1;0;0
/releases/18.06.4/targets/x86/legacy/openwrt-18.06.4-x86-legacy-generic-rootfs.tar.gz;1;0;1;287.54 KB;287.54 KB
/releases/18.06.0-rc1/targets/x86/legacy/openwrt-18.06.0-rc1-x86-legacy-combined-squashfs.img.gz;1;0;1;5.97 MB;5.97 MB
/releases/19.07.0-rc1/targets/omap/generic/openwrt-19.07.0-rc1-omap-ti_am335x-evm-squashfs-sdcard.img.gz;1;0;1;5.78 MB;5.78 MB
/releases/19.07.1/targets/archs38/generic/openwrt-19.07.1-archs38-generic-root.ext4.gz;1;0;1;2.88 MB;2.88 MB
/releases/19.07.3/targets/brcm2708/bcm2709/openwrt-19.07.3-brcm2708-bcm2709-rpi-2-squashfs-factory.img.gz;1;0;1;3.92 MB;3.92 MB
/releases/19.07.0-rc2/targets/imx6/generic/openwrt-19.07.0-rc2-imx6-ventana-squashfs-bootfs.tar.gz;1;0;1;2.52 MB;2.52 MB
//releases/19.07.3/targets/brcm2708/bcm2710/openwrt-19.07.3-brcm2708-bcm2710-rpi-3-squashfs-sysupgrade.img.gz;1;0;1;10.95 MB;10.95 MB
/releases/19.07.2/targets/brcm63xx/generic/openwrt-19.07.2-brcm63xx-generic-livebox-vmlinux.gz;1;0;1;2.25 MB;2.25 MB
/releases/19.07.0/targets/pistachio/generic/openwrt-19.07.0-pistachio-marduk-squashfs-sysupgrade.tar;1;0;1;4.82 MB;4.82 MB
/releases/17.01.0-rc1/targets/x86/geode/lede-17.01.0-rc1-r3042-ec095b5-x86-geode-combined-ext4.img.gz;1;0;1;79.75 KB;79.75 KB
/releases/19.07.0-rc1/targets/at91/sam9x/openwrt-19.07.0-rc1-at91-sam9x-ethernut5-ext4-root.ubi.gz;1;0;1;2.47 MB;2.47 MB
/releases/18.06.0-rc2/targets/sunxi/cortexa8/openwrt-18.06.0-rc2-sunxi-cortexa8-sun5i-a13-olimex-som-squashfs-sdcard.img.gz;1;0;1;4.72 MB;4.72 MB
/releases/17.01.0/targets/brcm63xx/smp/lede-17.01.0-r3205-59508e3-brcm63xx-smp-livebox-vmlinux.gz;1;0;1;319.75 KB;319.75 KB
/releases/18.06.0-rc2/targets/brcm63xx/smp/openwrt-18.06.0-rc2-brcm63xx-smp-livebox-vmlinux.gz;1;0;1;2.06 MB;2.06 MB
/releases/18.06.0-rc1/targets/sunxi/cortexa7/openwrt-18.06.0-rc1-sunxi-cortexa7-sun8i-h3-orangepi-pc-ext4-sdcard.img.gz;1;0;1;5.25 MB;5.25 MB
/releases/18.06.6/targets/armvirt/64/openwrt-18.06.6-armvirt-64-default-rootfs.tar.gz;1;0;1;1.97 MB;1.97 MB
/releases/19.07.0-rc2/targets/archs38/generic/openwrt-19.07.0-rc2-archs38-generic-root.ext4.gz;1;0;1;2.87 MB;2.87 MB
/snapshots/targets/scheduled_for_removal/brcm2708/bcm2708/openwrt-brcm2708-bcm2708-rpi-squashfs-factory.img.gz;1;0;1;0;0
/releases/17.01.6/targets/oxnas/generic/lede-17.01.6-oxnas-akitio-ubifs-sysupgrade.tar;1;0;1;159.75 KB;159.75 KB
/releases/17.01.7/targets/zynq/generic/lede-17.01.7-zynq-zybo-uramdisk.image.gz;1;0;1;143.75 KB;143.75 KB
/snapshots/targets/scheduled_for_removal/brcm2708/bcm2708/kernel-debug.tar.bz2;1;0;1;0;0
/releases/19.07.1/targets/brcm2708/bcm2710/openwrt-19.07.1-brcm2708-bcm2710-rpi-3-ext4-sysupgrade.img.gz;1;0;1;12.08 MB;12.08 MB
/releases/18.06.4/targets/ar71xx/nand/openwrt-18.06.4-ar71xx-nand-mr18-squashfs-sysupgrade.tar;1;0;1;6.60 MB;6.60 MB
/releases/17.01.0-rc1/targets/xburst/qi_lb60/lede-17.01.0-rc1-r3042-ec095b5-xburst-qi_lb60-default-rootfs.tar.gz;1;0;1;159.75 KB;159.75 KB
/releases/19.07.0-rc2/targets/sunxi/cortexa53/openwrt-19.07.0-rc2-sunxi-cortexa53-sun50i-h5-orangepi-pc2-squashfs-sdcard.img.gz;1;0;1;6.00 MB;6.00 MB
/releases/18.06.0-rc2/targets/brcm63xx/generic/openwrt-18.06.0-rc2-brcm63xx-generic-livebox-vmlinux.gz;1;0;1;1.27 MB;1.27 MB
/releases/18.06.3/targets/ar71xx/nand/openwrt-18.06.3-ar71xx-nand-rambutan-squashfs-sysupgrade.tar;1;0;1;3.70 MB;3.70 MB
/releases/19.07.1/targets/arc770/generic/openwrt-19.07.1-arc770-generic-root.ext4.gz;1;0;1;2.95 MB;2.95 MB
/releases/18.06.6/targets/apm821xx/nand/openwrt-18.06.6-apm821xx-nand-meraki_mr24-squashfs-sysupgrade.tar;1;0;1;4.18 MB;4.18 MB
//snapshots/targets/sunxi/cortexa7/openwrt-sunxi-cortexa7-friendlyarm_nanopi-neo-squashfs-sdcard.img.gz;1;0;1;5.54 MB;5.54 MB
/releases/18.06.0-rc2/targets/at91/sama5d2/openwrt-18.06.0-rc2-at91-sama5d2-at91-sama5d2_xplained-ext4-root.ubi.gz;1;0;1;1.28 MB;1.28 MB
/releases/17.01-SNAPSHOT/targets/sunxi/generic/lede-17.01-snapshot-r4046-beaa2ec-sunxi-sun8i-h3-orangepi-plus-squashfs-sdcard.img.gz;1;0;1;95.75 KB;95.75 KB
/releases/17.01.0-rc1/targets/x86/generic/lede-17.01.0-rc1-r3042-ec095b5-x86-generic-combined-ext4.img.gz;1;0;1;127.75 KB;127.75 KB
/releases/19.07.2/targets/sunxi/cortexa7/openwrt-19.07.2-sunxi-cortexa7-sun6i-a31-m9-squashfs-sdcard.img.gz;1;0;1;5.16 MB;5.16 MB
/releases/18.06-SNAPSHOT/targets/omap/generic/openwrt-18.06-snapshot-r8077-7cbbab7246-omap-am335x-evm-ubifs-sdcard.img.gz;1;0;1;6.03 MB;6.03 MB
/releases/18.06.0-rc2/targets/gemini/generic/openwrt-18.06.0-rc2-gemini-sysupgrade-ib4220b.tar.gz;1;0;1;10.33 MB;10.33 MB
/releases/17.01.7/targets/ipq806x/generic/lede-17.01.7-ipq806x-AP148-squashfs-nand-sysupgrade.tar;1;0;1;127.75 KB;127.75 KB
/releases/19.07.0-rc1/targets/omap/generic/openwrt-19.07.0-rc1-omap-ti_omap3-beagle-ext4-sdcard.img.gz;1;0;1;6.66 MB;6.66 MB
/releases/19.07.0-rc1/targets/oxnas/ox820/openwrt-19.07.0-rc1-oxnas-ox820-shuttle_kd20-squashfs-sysupgrade.tar;1;0;1;5.53 MB;5.53 MB
/releases/18.06.4/targets/sunxi/cortexa7/openwrt-18.06.4-sunxi-cortexa7-sun7i-a20-cubieboard2-squashfs-sdcard.img.gz;1;0;1;159.54 KB;159.54 KB
/releases/faillogs-18.06/mips64_octeon/packages/node/host-compile.txt;1;0;1;2.78 MB;2.78 MB
/releases/19.07.0-rc1/targets/ar71xx/nand/openwrt-19.07.0-rc1-ar71xx-nand-rambutan-squashfs-sysupgrade.tar;1;0;1;4.05 MB;4.05 MB
/releases/17.01.6/targets/x86/legacy/lede-17.01.6-x86-legacy-generic-rootfs.tar.gz;1;0;1;79.75 KB;79.75 KB
/releases/18.06.0-rc2/targets/sunxi/cortexa7/openwrt-18.06.0-rc2-sunxi-cortexa7-sun7i-a20-cubietruck-ext4-sdcard.img.gz;1;0;1;6.08 MB;6.08 MB
/releases/faillogs-18.06/powerpc_464fp/packages/node/host-compile.txt;1;0;1;2.19 MB;2.19 MB
/releases/19.07.1/targets/armvirt/64/openwrt-19.07.1-armvirt-64-rootfs.cpio.gz;1;0;1;20 Bytes;20 Bytes
//snapshots/targets/mvebu/cortexa53/openwrt-mvebu-cortexa53-marvell_armada-3720-db-ext4-sdcard.img.gz;1;0;1;7.67 MB;7.67 MB
/releases/18.06.7/targets/sunxi/cortexa7/openwrt-18.06.7-sunxi-cortexa7-sun8i-h2-plus-orangepi-r1-squashfs-sdcard.img.gz;1;0;1;1.27 MB;1.27 MB
/releases/19.07.0-rc2/targets/brcm2708/bcm2709/openwrt-19.07.0-rc2-brcm2708-bcm2709-rpi-2-ext4-sysupgrade.img.gz;1;0;1;11.97 MB;11.97 MB
/releases/19.07-SNAPSHOT/targets/brcm2708/bcm2710/openwrt-19.07-snapshot-r11233-589c3cf4e0-brcm2708-bcm2710-rpi-3-ext4-sysupgrade.img.gz;1;0;1;12.09 MB;12.09 MB
/releases/19.07.0-rc2/targets/armvirt/32/openwrt-19.07.0-rc2-armvirt-32-root.squashfs.gz;1;0;1;1.53 MB;1.53 MB
/releases/17.01.0/targets/ipq806x/generic/lede-17.01.0-r3205-59508e3-ipq806x-EA8500-squashfs-sysupgrade.tar;1;0;1;2.86 MB;2.86 MB
/releases/19.07.1/targets/brcm2708/bcm2709/openwrt-19.07.1-brcm2708-bcm2709-rpi-2-squashfs-factory.img.gz;1;0;1;10.77 MB;10.77 MB
/releases/18.06.0-rc1/targets/apm821xx/sata/openwrt-18.06.0-rc1-apm821xx-sata-wd_mybooklive-duo-ext4-rootfs.img.gz;1;0;1;6.08 MB;6.08 MB
/releases/19.07.0-rc1/targets/armvirt/32/openwrt-19.07.0-rc1-armvirt-32-default-rootfs.tar.gz;1;0;1;1.95 MB;1.95 MB
//releases/19.07.3/targets/arc770/generic/openwrt-19.07.3-arc770-generic-root.ext4.gz;1;0;1;2.95 MB;2.95 MB
/releases/19.07-SNAPSHOT/targets/brcm2708/bcm2710/openwrt-19.07-snapshot-r11233-589c3cf4e0-brcm2708-bcm2710-rpi-3-squashfs-sysupgrade.img.gz;1;0;1;10.95 MB;10.95 MB
/releases/19.07.0-rc1/targets/ar71xx/nand/openwrt-19.07.0-rc1-ar71xx-nand-z1-squashfs-sysupgrade.tar;1;0;1;7.47 MB;7.47 MB
/releases/19.07.0-rc1/targets/at91/sam9x/openwrt-19.07.0-rc1-at91-sam9x-tny_a9g20-ext4-factory.bin.gz;1;0;1;5.84 MB;5.84 MB
/releases/18.06.4/targets/x86/legacy/openwrt-18.06.4-x86-legacy-rootfs-squashfs.img.gz;1;0;1;159.54 KB;159.54 KB
/releases/19.07.0-rc2/targets/mvebu/cortexa53/openwrt-19.07.0-rc2-mvebu-cortexa53-globalscale_espressobin-emmc-ext4-sdcard.img.gz;1;0;1;6.37 MB;6.37 MB
//snapshots/targets/mediatek/mt7622/openwrt-mediatek-mt7622-bpi_bananapi-r64-rootdisk-squashfs-sysupgrade-emmc.bin.gz;1;0;1;6.65 MB;6.65 MB
/releases/17.01.0-rc1/targets/imx6/generic/lede-17.01.0-rc1-r3042-ec095b5-imx6-rootfs.tar.gz;1;0;1;335.75 KB;335.75 KB
/releases/17.01.7/targets/zynq/generic/lede-17.01.7-zynq-zed-uramdisk.image.gz;1;0;1;79.75 KB;79.75 KB
/snapshots/targets/scheduled_for_removal/ar71xx/mikrotik/openwrt-ar71xx-mikrotik-vmlinux.lzma;1;0;1;0;0
/releases/18.06.0/targets/brcm63xx/generic/openwrt-18.06.0-brcm63xx-generic-livebox-vmlinux.gz;1;0;1;1.94 MB;1.94 MB
/releases/19.07.0-rc1/targets/layerscape/armv8_64b/openwrt-19.07.0-rc1-layerscape-armv8_64b-ls1088ardb-sdboot-ext4-sdcard.img.gz;1;0;1;8.80 MB;8.80 MB
/releases/18.06.3/targets/apm821xx/nand/openwrt-18.06.3-apm821xx-nand-meraki_mr24-squashfs-sysupgrade.tar;1;0;1;4.18 MB;4.18 MB
/releases/18.06.4/targets/sunxi/cortexa8/openwrt-18.06.4-sunxi-cortexa8-sun4i-a10-olinuxino-lime-squashfs-sdcard.img.gz;1;0;1;271.54 KB;271.54 KB
/releases/17.01.5/targets/brcm2708/bcm2709/lede-17.01.5-brcm2708-bcm2709-rpi-2-ext4-sdcard.img.gz;1;0;1;6.88 MB;6.88 MB
/releases/19.07.0/targets/ar71xx/nand/openwrt-19.07.0-ar71xx-nand-wi2a-ac200i-squashfs-sysupgrade.tar;1;0;1;4.38 MB;4.38 MB
/releases/19.07.0-rc2/targets/at91/sama5/openwrt-19.07.0-rc2-at91-sama5-at91-sama5d3_xplained-ext4-sdcard.img.gz;1;0;1;6.02 MB;6.02 MB
/releases/19.07.1/targets/sunxi/cortexa7/openwrt-19.07.1-sunxi-cortexa7-sun7i-a20-olinuxino-lime2-squashfs-sdcard.img.gz;1;0;1;4.87 MB;4.87 MB
//releases/19.07.3/targets/zynq/generic/openwrt-19.07.3-zynq-digilent_zynq-zybo-z7-squashfs-sdcard.img.gz;1;0;1;5.86 MB;5.86 MB
/releases/18.06.0-rc2/targets/armvirt/32/openwrt-18.06.0-rc2-armvirt-32-rootfs.cpio.gz;1;0;1;1.86 MB;1.86 MB
/releases/19.07.0-rc2/targets/at91/sama5/openwrt-19.07.0-rc2-at91-sama5-at91-sama5d4_xplained-ext4-root.ubi.gz;1;0;1;2.40 MB;2.40 MB
/releases/18.06-SNAPSHOT/targets/sunxi/cortexa53/openwrt-18.06-snapshot-r8073-5625f5bc36-sunxi-cortexa53-sun50i-a64-pine64-plus-squashfs-sdcard.img.gz;1;0;1;5.63 MB;5.63 MB
/releases/17.01.0-rc1/targets/sunxi/generic/lede-17.01.0-rc1-r3042-ec095b5-sunxi-sun5i-a13-olimex-som-ext4-sdcard.img.gz;1;0;1;63.75 KB;63.75 KB
//snapshots/targets/sunxi/cortexa8/openwrt-sunxi-cortexa8-olimex_a10-olinuxino-lime-squashfs-sdcard.img.gz;1;0;1;5.56 MB;5.56 MB
/releases/19.07.0-rc1/targets/omap/generic/openwrt-19.07.0-rc1-omap-rootfs.tar.gz;1;0;1;2.63 MB;2.63 MB
/releases/19.07.1/targets/mvebu/cortexa53/openwrt-19.07.1-mvebu-cortexa53-globalscale_espressobin-v7-ext4-sdcard.img.gz;1;0;1;6.39 MB;6.39 MB
/releases/17.01-SNAPSHOT/targets/sunxi/generic/lede-17.01-snapshot-r4046-beaa2ec-sunxi-sun7i-a20-pcduino3-squashfs-sdcard.img.gz;1;0;1;287.75 KB;287.75 KB
/releases/18.06.7/targets/sunxi/cortexa7/openwrt-18.06.7-sunxi-cortexa7-sun7i-a20-olinuxino-lime2-squashfs-sdcard.img.gz;1;0;1;1.28 MB;1.28 MB
/releases/17.01.0-rc2/targets/zynq/generic/lede-17.01.0-rc2-r3131-42f3c1f-zynq-zybo-uramdisk.image.gz;1;0;1;271.75 KB;271.75 KB
/releases/18.06.0-rc2/targets/sunxi/cortexa7/openwrt-18.06.0-rc2-sunxi-cortexa7-sun8i-h3-nanopi-neo-ext4-sdcard.img.gz;1;0;1;5.23 MB;5.23 MB
/releases/17.01.6/targets/sunxi/generic/lede-17.01.6-sunxi-sun7i-a20-cubieboard2-ext4-sdcard.img.gz;1;0;1;159.75 KB;159.75 KB
/releases/18.06.4/targets/sunxi/cortexa7/openwrt-18.06.4-sunxi-cortexa7-sun7i-a20-olinuxino-lime2-emmc-ext4-sdcard.img.gz;1;0;1;143.54 KB;143.54 KB
/releases/17.01.5/targets/brcm2708/bcm2708/lede-17.01.5-brcm2708-bcm2708-rpi-ext4-sdcard.img.gz;1;0;1;7.96 MB;7.96 MB
/releases/17.01.0-rc2/targets/brcm2708/bcm2708/lede-17.01.0-rc2-r3131-42f3c1f-brcm2708-bcm2708-rpi-ext4-sdcard.img.gz;1;0;1;191.75 KB;191.75 KB
/releases/18.06.0-rc1/targets/at91/sama5d2/openwrt-18.06.0-rc1-at91-sama5d2-at91-sama5d2_xplained-ext4-zImage.gz;1;0;1;3.03 MB;3.03 MB
/releases/18.06.6/targets/pistachio/generic/openwrt-18.06.6-pistachio-rootfs.tar.gz;1;0;1;1.93 MB;1.93 MB
//snapshots/targets/at91/sama5/openwrt-at91-sama5-microchip_sama5d4-xplained-ext4-root.ubi.gz;1;0;1;2.31 MB;2.31 MB
/releases/17.01.7/targets/ipq806x/generic/lede-17.01.7-ipq806x-R7500v2-squashfs-sysupgrade.tar;1;0;1;207.75 KB;207.75 KB
/releases/19.07.0-rc2/targets/sunxi/cortexa8/openwrt-19.07.0-rc2-sunxi-cortexa8-sun5i-a13-olimex-som-squashfs-sdcard.img.gz;1;0;1;5.07 MB;5.07 MB
/releases/19.07.0-rc2/targets/mvebu/cortexa53/openwrt-19.07.0-rc2-mvebu-cortexa53-globalscale_espressobin-v7-emmc-ext4-sdcard.img.gz;1;0;1;6.37 MB;6.37 MB
/releases/18.06.4/targets/sunxi/cortexa53/openwrt-18.06.4-sunxi-cortexa53-sun50i-h5-nanopi-neo-plus2-squashfs-sdcard.img.gz;1;0;1;143.54 KB;143.54 KB
/releases/18.06.7/targets/armvirt/32/openwrt-18.06.7-armvirt-32-root.ext4.gz;1;0;1;2.13 MB;2.13 MB
/snapshots/faillogs/mipsel_24kc/packages/mariadb/host-compile.txt;1;0;1;55.02 KB;55.02 KB
/releases/17.01.0/targets/rb532/generic/lede-17.01.0-r3205-59508e3-rb532-default-rootfs.tar.gz;1;0;1;143.75 KB;143.75 KB
/releases/19.07.2/targets/mvebu/cortexa53/openwrt-19.07.2-mvebu-cortexa53-globalscale_espressobin-v7-squashfs-sdcard.img.gz;1;0;1;4.62 MB;4.62 MB
/releases/17.01.6/targets/brcm63xx/generic/lede-17.01.6-brcm63xx-generic-livebox-vmlinux.gz;1;0;1;63.75 KB;63.75 KB
/releases/18.06-SNAPSHOT/targets/at91/legacy/openwrt-18.06-snapshot-r8080-9f2a40c72f-at91-legacy-at91sam9g20ek_2mmc-ext4-root.ubi.gz;1;0;1;2.36 MB;2.36 MB
/releases/18.06-SNAPSHOT/targets/sunxi/cortexa53/openwrt-18.06-snapshot-r8073-5625f5bc36-sunxi-cortexa53-sun50i-a64-sopine-baseboard-ext4-sdcard.img.gz;1;0;1;6.40 MB;6.40 MB
/releases/18.06.0-rc1/targets/at91/sama5d2/openwrt-18.06.0-rc1-at91-sama5d2-at91-sama5d2_ptc_ek-ext4-root.ubi.gz;1;0;1;2.33 MB;2.33 MB
/releases/17.01.6/targets/arc770/generic/lede-17.01.6-arc770-generic-root.ext4.gz;1;0;1;2.78 MB;2.78 MB
//snapshots/targets/at91/legacy/openwrt-at91-legacy-at91sam9x35ek-ext4-root.ubi.gz;1;0;1;1.98 MB;1.98 MB
/releases/17.01.5/targets/ipq806x/generic/lede-17.01.5-ipq806x-NBG6817-squashfs-sysupgrade.tar;1;0;1;7.32 MB;7.32 MB
/releases/19.07.0-rc1/targets/at91/sam9x/openwrt-19.07.0-rc1-at91-sam9x-at91sam9g20ek-ext4-root.ubi.gz;1;0;1;2.47 MB;2.47 MB
//snapshots/targets/layerscape/armv7/openwrt-layerscape-armv7-fsl_ls1021a-twr-sdboot-squashfs-sdcard.img.gz;1;0;1;7.27 MB;7.27 MB
/releases/18.06.4/targets/x86/geode/openwrt-18.06.4-x86-geode-rootfs-squashfs.img.gz;1;0;1;159.54 KB;159.54 KB
/releases/18.06.5/targets/brcm2708/bcm2709/openwrt-18.06.5-brcm2708-bcm2709-rpi-2-squashfs-sysupgrade.img.gz;1;0;1;7.77 MB;7.77 MB
//snapshots/targets/sunxi/cortexa7/openwrt-sunxi-cortexa7-friendlyarm_nanopi-r1-ext4-sdcard.img.gz;1;0;1;7.74 MB;7.74 MB
/releases/18.06-SNAPSHOT/targets/omap/generic/openwrt-18.06-snapshot-r8077-7cbbab7246-omap-am335x-boneblack-ext4-sdcard.img.gz;1;0;1;5.80 MB;5.80 MB
/releases/19.07.1/targets/sunxi/cortexa7/openwrt-19.07.1-sunxi-cortexa7-sun7i-a20-cubietruck-squashfs-sdcard.img.gz;1;0;1;5.45 MB;5.45 MB
/releases/19.07.0-rc2/targets/sunxi/cortexa8/openwrt-19.07.0-rc2-sunxi-cortexa8-sun4i-a10-olinuxino-lime-squashfs-sdcard.img.gz;1;0;1;4.72 MB;4.72 MB
/releases/19.07.0-rc1/targets/at91/sama5/openwrt-19.07.0-rc1-at91-sama5-at91-sama5d2_ptc_ek-ext4-zImage.gz;1;0;1;3.31 MB;3.31 MB
/releases/17.01.1/targets/ipq806x/generic/lede-17.01.1-ipq806x-R7500-squashfs-sysupgrade.tar;1;0;1;2.72 MB;2.72 MB
/releases/19.07.0/targets/ar71xx/nand/openwrt-19.07.0-ar71xx-nand-r6100-squashfs-sysupgrade.tar;1;0;1;5.01 MB;5.01 MB
/releases/19.07.1/targets/layerscape/armv8_64b/openwrt-19.07.1-layerscape-armv8_64b-ls1046ardb-sdboot-ext4-sdcard.img.gz;1;0;1;8.36 MB;8.36 MB
/releases/19.07.0-rc1/targets/sunxi/cortexa7/openwrt-19.07.0-rc1-sunxi-cortexa7-sun7i-a20-cubieboard2-ext4-sdcard.img.gz;1;0;1;5.63 MB;5.63 MB
/releases/19.07.0-rc1/targets/at91/sam9x/openwrt-19.07.0-rc1-at91-sam9x-rootfs.tar.gz;1;0;1;2.11 MB;2.11 MB
/releases/18.06.0-rc1/targets/sunxi/cortexa8/openwrt-18.06.0-rc1-sunxi-cortexa8-sun4i-a10-cubieboard-ext4-sdcard.img.gz;1;0;1;5.23 MB;5.23 MB
/releases/17.01.6/targets/sunxi/generic/lede-17.01.6-sunxi-sun4i-a10-cubieboard-ext4-sdcard.img.gz;1;0;1;159.75 KB;159.75 KB
/releases/18.06.9/targets/ar71xx/mikrotik/openwrt-18.06.9-ar71xx-mikrotik-vmlinux.lzma;1;0;1;319.54 KB;319.54 KB
/snapshots/targets/scheduled_for_removal/brcm2708/bcm2711/openwrt-brcm2708-bcm2711-rpi-4-squashfs-sysupgrade.img.gz;1;0;1;0;0
/releases/17.01.2/targets/mvebu/generic/lede-17.01.2-mvebu-armada-388-clearfog-sdcard.img.gz;1;0;1;159.75 KB;159.75 KB
/releases/19.07.2/targets/ar71xx/nand/openwrt-19.07.2-ar71xx-nand-c-60-squashfs-sysupgrade.tar;1;0;1;1.27 MB;1.27 MB
/releases/17.01.7/targets/sunxi/generic/lede-17.01.7-sunxi-sun7i-a20-bananapi-ext4-sdcard.img.gz;1;0;1;143.75 KB;143.75 KB
/releases/17.01-SNAPSHOT/targets/sunxi/generic/lede-17.01-snapshot-r4046-beaa2ec-sunxi-sun4i-a10-olinuxino-lime-squashfs-sdcard.img.gz;1;0;1;239.75 KB;239.75 KB
/releases/17.01.2/targets/kirkwood/generic/lede-17.01.2-kirkwood-goflexhome-squashfs-sysupgrade.tar;1;0;1;271.75 KB;271.75 KB
/releases/19.07.0-rc1/targets/sunxi/cortexa53/openwrt-19.07.0-rc1-sunxi-cortexa53-sun50i-a64-pine64-plus-ext4-sdcard.img.gz;1;0;1;6.77 MB;6.77 MB
/releases/18.06.6/targets/brcm2708/bcm2710/openwrt-18.06.6-brcm2708-bcm2710-rpi-3-ext4-sysupgrade.img.gz;1;0;1;3.56 MB;3.56 MB
/releases/18.06-SNAPSHOT/targets/at91/legacy/openwrt-18.06-snapshot-r8080-9f2a40c72f-at91-legacy-at91sam9263ek-ext4-root.ubi.gz;1;0;1;2.36 MB;2.36 MB
/releases/19.07.2/targets/rb532/generic/openwrt-19.07.2-rb532-default-rootfs.tar.gz;1;0;1;3.58 MB;3.58 MB
/releases/19.07.0-rc1/targets/sunxi/cortexa7/openwrt-19.07.0-rc1-sunxi-cortexa7-sun8i-h3-bananapi-m2-plus-ext4-sdcard.img.gz;1;0;1;6.94 MB;6.94 MB
/releases/18.06.3/targets/brcm2708/bcm2709/openwrt-18.06.3-brcm2708-bcm2709-rpi-2-squashfs-sysupgrade.img.gz;1;0;1;7.76 MB;7.76 MB
/releases/18.06.4/targets/sunxi/cortexa53/openwrt-18.06.4-sunxi-cortexa53-sun50i-a64-sopine-baseboard-ext4-sdcard.img.gz;1;0;1;143.54 KB;143.54 KB
//snapshots/targets/sunxi/cortexa8/openwrt-sunxi-cortexa8-olimex_a13-olimex-som-squashfs-sdcard.img.gz;1;0;1;5.97 MB;5.97 MB
/releases/18.06.0-rc1/targets/brcm2708/bcm2710/openwrt-18.06.0-rc1-brcm2708-bcm2710-rpi-3-squashfs-sdcard.img.gz;1;0;1;7.78 MB;7.78 MB
/releases/18.06.0-rc1/targets/sunxi/cortexa8/openwrt-18.06.0-rc1-sunxi-cortexa8-sun5i-a13-olimex-som-ext4-sdcard.img.gz;1;0;1;5.67 MB;5.67 MB
/releases/18.06.4/targets/sunxi/cortexa7/openwrt-18.06.4-sunxi-cortexa7-sun8i-h3-orangepi-2-ext4-sdcard.img.gz;1;0;1;159.54 KB;159.54 KB
//snapshots/targets/mediatek/mt7623/openwrt-mediatek-mt7623-unielec_u7623-emmc-scatter.txt;1;0;1;1.49 KB;1.49 KB
/releases/17.01.7/targets/sunxi/generic/lede-17.01.7-sunxi-sun7i-a20-bananapro-ext4-sdcard.img.gz;1;0;1;239.75 KB;239.75 KB
/releases/18.06.0/targets/armvirt/64/openwrt-18.06.0-armvirt-64-default-rootfs.tar.gz;1;0;1;1.96 MB;1.96 MB
/releases/18.06.3/targets/brcm63xx/generic/openwrt-18.06.3-brcm63xx-generic-livebox-vmlinux.gz;1;0;1;1.94 MB;1.94 MB
/releases/18.06.0-rc2/targets/imx6/generic/openwrt-18.06.0-rc2-imx6-ventana-squashfs-bootfs.tar.gz;1;0;1;2.36 MB;2.36 MB
/releases/17.01.4/targets/octeon/generic/lede-17.01.4-octeon-erlite-squashfs-sysupgrade.tar;1;0;1;2.53 MB;2.53 MB
/releases/18.06.0-rc2/targets/x86/legacy/openwrt-18.06.0-rc2-x86-legacy-rootfs-squashfs.img.gz;1;0;1;2.31 MB;2.31 MB
/releases/19.07.1/targets/mvebu/cortexa53/openwrt-19.07.1-mvebu-cortexa53-globalscale_espressobin-ext4-sdcard.img.gz;1;0;1;6.39 MB;6.39 MB
/releases/18.06.0-rc1/targets/imx6/generic/openwrt-18.06.0-rc1-imx6-rootfs.tar.gz;1;0;1;1.93 MB;1.93 MB
/releases/18.06.7/targets/apm821xx/nand/openwrt-18.06.7-apm821xx-nand-meraki_mr24-squashfs-sysupgrade.tar;1;0;1;4.18 MB;4.18 MB
/releases/18.06-SNAPSHOT/targets/sunxi/cortexa53/openwrt-18.06-snapshot-r8073-5625f5bc36-sunxi-cortexa53-sun50i-a64-pine64-plus-ext4-sdcard.img.gz;1;0;1;6.40 MB;6.40 MB
/releases/18.06.7/targets/apm821xx/sata/openwrt-18.06.7-apm821xx-sata-wd_mybooklive-ext4-rootfs.img.gz;1;0;1;5.63 MB;5.63 MB
/releases/19.07.0-rc1/targets/brcm63xx/smp/openwrt-19.07.0-rc1-brcm63xx-smp-livebox-vmlinux.gz;1;0;1;2.38 MB;2.38 MB
/releases/18.06.0/targets/arc770/generic/openwrt-18.06.0-arc770-generic-Default-sdcard-vfat-ext4.img.gz;1;0;1;4.84 MB;4.84 MB
/releases/19.07.0-rc1/targets/sunxi/cortexa7/openwrt-19.07.0-rc1-sunxi-cortexa7-sun8i-h3-orangepi-one-squashfs-sdcard.img.gz;1;0;1;4.74 MB;4.74 MB
/releases/19.07.1/targets/apm821xx/sata/openwrt-19.07.1-apm821xx-sata-wd_mybooklive-ext4-sysupgrade.img.gz;1;0;1;6.55 MB;6.55 MB
/releases/19.07.0-rc2/targets/ar71xx/nand/openwrt-19.07.0-rc2-ar71xx-nand-c-60-squashfs-sysupgrade.tar;1;0;1;4.05 MB;4.05 MB
/releases/18.06.7/targets/archs38/generic/openwrt-18.06.7-archs38-generic-Default-sdcard-vfat-ext4.img.gz;1;0;1;3.22 MB;3.22 MB
/releases/faillogs/arm_cortex-a9/packages/icu/host-compile.txt;1;0;1;0;0
/releases/18.06.4/targets/sunxi/cortexa53/openwrt-18.06.4-sunxi-cortexa53-sun50i-h5-orangepi-zero-plus-ext4-sdcard.img.gz;1;0;1;143.54 KB;143.54 KB
/releases/18.06.0-rc2/targets/sunxi/cortexa7/openwrt-18.06.0-rc2-sunxi-cortexa7-sun7i-a20-olinuxino-lime2-squashfs-sdcard.img.gz;1;0;1;4.55 MB;4.55 MB
/releases/18.06.7/targets/sunxi/cortexa7/openwrt-18.06.7-sunxi-cortexa7-sun8i-h3-nanopi-neo-squashfs-sdcard.img.gz;1;0;1;1.30 MB;1.30 MB
//snapshots/targets/at91/legacy/openwrt-at91-legacy-usb_a9260-ext4-factory.bin.gz;1;0;1;5.30 MB;5.30 MB
//snapshots/targets/sunxi/cortexa7/openwrt-sunxi-cortexa7-mele_m9-ext4-sdcard.img.gz;1;0;1;6.87 MB;6.87 MB
/releases/18.06.0-rc2/targets/sunxi/cortexa7/openwrt-18.06.0-rc2-sunxi-cortexa7-sun7i-a20-olinuxino-lime2-emmc-squashfs-sdcard.img.gz;1;0;1;4.55 MB;4.55 MB
/releases/19.07.0-rc1/targets/at91/sam9x/openwrt-19.07.0-rc1-at91-sam9x-tny_a9260-ext4-factory.bin.gz;1;0;1;5.84 MB;5.84 MB
/releases/17.01.4/targets/x86/64/lede-17.01.4-x86-64-generic-rootfs.tar.gz;1;0;1;159.75 KB;159.75 KB
/releases/19.07.0-rc1/targets/oxnas/ox820/openwrt-19.07.0-rc1-oxnas-ox820-cloudengines_pogoplug-series-3-ubifs-sysupgrade.tar;1;0;1;8.08 MB;8.08 MB
/releases/18.06.0-rc2/targets/sunxi/cortexa7/openwrt-18.06.0-rc2-sunxi-cortexa7-sun8i-h3-orangepi-pc-squashfs-sdcard.img.gz;1;0;1;4.43 MB;4.43 MB
/releases/19.07.0-rc1/targets/x86/generic/openwrt-19.07.0-rc1-x86-generic-rootfs-ext4.img.gz;1;0;1;3.96 MB;3.96 MB
/releases/19.07.1/targets/armvirt/64/openwrt-19.07.1-armvirt-64-root.ext4.gz;1;0;1;2.32 MB;2.32 MB
/releases/17.01.0-rc2/targets/mediatek/generic/lede-17.01.0-rc2-r3131-42f3c1f-mediatek-eMMC-sysupgrade.tar;1;0;1;127.75 KB;127.75 KB
/releases/18.06.0-rc1/targets/sunxi/cortexa8/openwrt-18.06.0-rc1-sunxi-cortexa8-sun4i-a10-marsboard-ext4-sdcard.img.gz;1;0;1;5.23 MB;5.23 MB
/releases/18.06.3/targets/ar71xx/nand/openwrt-18.06.3-ar71xx-nand-wndr3700v4-squashfs-sysupgrade.tar;1;0;1;4.51 MB;4.51 MB
//snapshots/targets/at91/sama5/openwrt-at91-sama5-microchip_sama5d27-som1-ek-ext4-root.ubi.gz;1;0;1;2.33 MB;2.33 MB
/releases/18.06.5/targets/pistachio/generic/openwrt-18.06.5-pistachio-rootfs.tar.gz;1;0;1;1.93 MB;1.93 MB
/releases/17.01.6/targets/sunxi/generic/lede-17.01.6-sunxi-sun5i-a13-olimex-som-ext4-sdcard.img.gz;1;0;1;159.75 KB;159.75 KB
/snapshots/targets/scheduled_for_removal/xburst/qi_lb60/openwrt-xburst-qi_lb60-default-rootfs.tar.gz;1;0;1;0;0
/releases/18.06.0-rc1/targets/x86/legacy/openwrt-18.06.0-rc1-x86-legacy-rootfs-squashfs.img.gz;1;0;1;2.30 MB;2.30 MB
//snapshots/targets/mvebu/cortexa53/openwrt-mvebu-cortexa53-globalscale_espressobin-v7-ext4-sdcard.img.gz;1;0;1;7.67 MB;7.67 MB
/releases/18.06.5/targets/ar71xx/nand/openwrt-18.06.5-ar71xx-nand-mr18-squashfs-sysupgrade.tar;1;0;1;6.62 MB;6.62 MB
/releases/18.06.7/targets/sunxi/cortexa7/openwrt-18.06.7-sunxi-cortexa7-sun8i-h3-orangepi-pc-ext4-sdcard.img.gz;1;0;1;1.27 MB;1.27 MB
/releases/19.07.0-rc1/targets/at91/sam9x/openwrt-19.07.0-rc1-at91-sam9x-at91sam9g35ek-ext4-root.ubi.gz;1;0;1;2.47 MB;2.47 MB
/releases/19.07.0-rc1/targets/ar71xx/nand/openwrt-19.07.0-rc1-ar71xx-nand-wi2a-ac200i-squashfs-sysupgrade.tar;1;0;1;4.37 MB;4.37 MB
//snapshots/targets/mvebu/cortexa53/openwrt-mvebu-cortexa53-globalscale_espressobin-v7-emmc-squashfs-sdcard.img.gz;1;0;1;6.89 MB;6.89 MB
/releases/19.07.0-rc1/targets/at91/sama5/openwrt-19.07.0-rc1-at91-sama5-at91-sama5d27_som1_ek-ext4-sdcard.img.gz;1;0;1;5.92 MB;5.92 MB
/releases/18.06.0-rc2/targets/sunxi/cortexa7/openwrt-18.06.0-rc2-sunxi-cortexa7-sun8i-h3-orangepi-pc-ext4-sdcard.img.gz;1;0;1;5.26 MB;5.26 MB
/releases/18.06.4/targets/arc770/generic/openwrt-18.06.4-arc770-generic-root.ext4.gz;1;0;1;2.68 MB;2.68 MB
/releases/18.06.7/targets/sunxi/cortexa7/openwrt-18.06.7-sunxi-cortexa7-sun6i-a31-m9-ext4-sdcard.img.gz;1;0;1;3.16 MB;3.16 MB
/releases/18.06.7/targets/brcm2708/bcm2708/openwrt-18.06.7-brcm2708-bcm2708-rpi-squashfs-factory.img.gz;1;0;1;1.28 MB;1.28 MB
/releases/19.07.0-rc1/targets/ar71xx/nand/openwrt-19.07.0-rc1-ar71xx-nand-nbg6716-squashfs-sysupgrade.tar;1;0;1;4.76 MB;4.76 MB
//snapshots/targets/bcm27xx/bcm2708/openwrt-bcm27xx-bcm2708-rpi-squashfs-factory.img.gz;1;0;1;12.31 MB;12.31 MB
/releases/18.06.4/targets/sunxi/cortexa7/openwrt-18.06.4-sunxi-cortexa7-sun8i-h2-plus-orangepi-r1-ext4-sdcard.img.gz;1;0;1;159.54 KB;159.54 KB
/releases/18.06.0-rc2/targets/omap/generic/openwrt-18.06.0-rc2-omap-omap3-beagle-ubifs-sdcard.img.gz;1;0;1;6.00 MB;6.00 MB
/releases/19.07.0-rc1/targets/at91/sam9x/openwrt-19.07.0-rc1-at91-sam9x-at91sam9x35ek-ext4-root.ubi.gz;1;0;1;2.47 MB;2.47 MB
/releases/18.06.1/targets/armvirt/64/openwrt-18.06.1-armvirt-64-root.ext4.gz;1;0;1;2.23 MB;2.23 MB
/releases/17.01.6/targets/sunxi/generic/lede-17.01.6-sunxi-sun7i-a20-bananapi-ext4-sdcard.img.gz;1;0;1;143.75 KB;143.75 KB
/releases/18.06.7/targets/ramips/mt7621/openwrt-18.06.7-ramips-mt7621-mir3g-squashfs-sysupgrade.tar;1;0;1;4.18 MB;4.18 MB
/releases/17.01.6/targets/oxnas/generic/lede-17.01.6-oxnas-stg212-squashfs-sysupgrade.tar;1;0;1;79.75 KB;79.75 KB
/releases/17.01.0-rc2/targets/gemini/raidsonic/lede-17.01.0-rc2-r3131-42f3c1f-gemini-raidsonic-sysupgrade-ib4220.tar.gz;1;0;1;79.75 KB;79.75 KB
//snapshots/targets/sunxi/cortexa7/openwrt-sunxi-cortexa7-friendlyarm_zeropi-ext4-sdcard.img.gz;1;0;1;6.26 MB;6.26 MB
/releases/18.06.4/targets/ar71xx/nand/openwrt-18.06.4-ar71xx-nand-z1-squashfs-sysupgrade.tar;1;0;1;6.68 MB;6.68 MB
/releases/18.06.7/targets/brcm2708/bcm2709/openwrt-18.06.7-brcm2708-bcm2709-rpi-2-squashfs-sysupgrade.img.gz;1;0;1;1.27 MB;1.27 MB
/releases/18.06.4/targets/sunxi/cortexa7/openwrt-18.06.4-sunxi-cortexa7-sun7i-a20-cubietruck-ext4-sdcard.img.gz;1;0;1;159.54 KB;159.54 KB
/releases/19.07.0-rc2/targets/armvirt/64/openwrt-19.07.0-rc2-armvirt-64-rootfs.cpio.gz;1;0;1;20 Bytes;20 Bytes
/releases/18.06.0-rc1/targets/sunxi/cortexa8/openwrt-18.06.0-rc1-sunxi-cortexa8-sun4i-a10-cubieboard-squashfs-sdcard.img.gz;1;0;1;4.39 MB;4.39 MB
/releases/19.07.2/targets/ar71xx/nand/openwrt-19.07.2-ar71xx-nand-hiveap-121-squashfs-sysupgrade.tar;1;0;1;1.28 MB;1.28 MB
/releases/19.07.0-rc1/targets/sunxi/cortexa53/openwrt-19.07.0-rc1-sunxi-cortexa53-sun50i-h5-nanopi-neo2-squashfs-sdcard.img.gz;1;0;1;5.98 MB;5.98 MB
/releases/19.07.1/targets/sunxi/cortexa53/openwrt-19.07.1-sunxi-cortexa53-sun50i-a64-sopine-baseboard-squashfs-sdcard.img.gz;1;0;1;5.99 MB;5.99 MB
/snapshots/targets/scheduled_for_removal/adm8668/generic/kernel-debug.tar.bz2;1;0;1;0;0
/releases/17.01.0-rc1/targets/sunxi/generic/lede-17.01.0-rc1-r3042-ec095b5-sunxi-sun6i-a31-m9-ext4-sdcard.img.gz;1;0;1;127.75 KB;127.75 KB
/releases/18.06.0-rc2/targets/sunxi/cortexa7/openwrt-18.06.0-rc2-sunxi-cortexa7-sun7i-a20-pcduino3-ext4-sdcard.img.gz;1;0;1;5.76 MB;5.76 MB
/releases/18.06.0-rc2/targets/sunxi/cortexa7/openwrt-18.06.0-rc2-sunxi-cortexa7-sun7i-a20-bananapi-squashfs-sdcard.img.gz;1;0;1;4.47 MB;4.47 MB
/releases/18.06.4/targets/sunxi/cortexa8/openwrt-18.06.4-sunxi-cortexa8-sun4i-a10-marsboard-squashfs-sdcard.img.gz;1;0;1;255.54 KB;255.54 KB
/releases/18.06.7/targets/brcm2708/bcm2710/openwrt-18.06.7-brcm2708-bcm2710-rpi-3-squashfs-factory.img.gz;1;0;1;1.33 MB;1.33 MB
/releases/18.06.7/targets/apm821xx/sata/openwrt-18.06.7-apm821xx-sata-wd_mybooklive-duo-ext4-rootfs.img.gz;1;0;1;6.13 MB;6.13 MB
//snapshots/targets/mvebu/cortexa72/openwrt-mvebu-cortexa72-marvell_macchiatobin-singleshot-ext4-sdcard.img.gz;1;0;1;7.73 MB;7.73 MB
/releases/19.07.2/targets/armvirt/32/openwrt-19.07.2-armvirt-32-root.squashfs.gz;1;0;1;1.54 MB;1.54 MB
/releases/18.06.0-rc1/targets/mvebu/cortexa72/openwrt-18.06.0-rc1-mvebu-cortexa72-armada-macchiatobin-ext4-sdcard.img.gz;1;0;1;6.12 MB;6.12 MB
/releases/19.07.0-rc1/targets/sunxi/cortexa53/openwrt-19.07.0-rc1-sunxi-cortexa53-sun50i-h5-orangepi-zero-plus-squashfs-sdcard.img.gz;1;0;1;5.98 MB;5.98 MB
//releases/19.07.3/targets/arc770/generic/openwrt-19.07.3-arc770-generic-Default-sdcard-vfat-ext4.img.gz;1;0;1;5.83 MB;5.83 MB
/releases/19.07.0-rc1/targets/mvebu/cortexa72/openwrt-19.07.0-rc1-mvebu-cortexa72-marvell_macchiatobin-squashfs-sdcard.img.gz;1;0;1;5.58 MB;5.58 MB
/releases/17.01.4/targets/ipq806x/generic/lede-17.01.4-ipq806x-AP148-ubifs-nand-sysupgrade.tar;1;0;1;2.34 MB;2.34 MB
/releases/17.01.0-rc1/targets/sunxi/generic/lede-17.01.0-rc1-r3042-ec095b5-sunxi-sun7i-a20-cubietruck-squashfs-sdcard.img.gz;1;0;1;271.75 KB;271.75 KB
/releases/19.07-SNAPSHOT/targets/x86/64/openwrt-19.07-snapshot-r11228-78c4c04dd7-x86-64-rootfs-squashfs.img.gz;1;0;1;2.84 MB;2.84 MB
/releases/faillogs-19.07/aarch64_cortex-a72/packages/perl-parse-recdescent/host-compile.txt;1;0;1;944 Bytes;944 Bytes
/releases/19.07.2/targets/sunxi/cortexa7/openwrt-19.07.2-sunxi-cortexa7-sun7i-a20-olinuxino-lime-squashfs-sdcard.img.gz;1;0;1;4.79 MB;4.79 MB
/releases/18.06.0/targets/archs38/generic/openwrt-18.06.0-archs38-generic-Default-sdcard-vfat-ext4.img.gz;1;0;1;5.88 MB;5.88 MB
/releases/19.07.0-rc2/targets/oxnas/ox820/openwrt-19.07.0-rc2-oxnas-ox820-shuttle_kd20-factory.tar.gz;1;0;1;7.32 MB;7.32 MB
/releases/17.01.7/targets/ar71xx/nand/lede-17.01.7-ar71xx-nand-wndr3700v4-squashfs-sysupgrade.tar;1;0;1;143.75 KB;143.75 KB
/releases/18.06.6/targets/brcm2708/bcm2708/openwrt-18.06.6-brcm2708-bcm2708-rpi-squashfs-sysupgrade.img.gz;1;0;1;4.16 MB;4.16 MB
//snapshots/targets/bcm27xx/bcm2710/openwrt-bcm27xx-bcm2710-rpi-3-ext4-factory.img.gz;1;0;1;14.49 MB;14.49 MB
/releases/19.07.0-rc2/targets/ar71xx/nand/openwrt-19.07.0-rc2-ar71xx-nand-z1-squashfs-sysupgrade.tar;1;0;1;7.47 MB;7.47 MB
/releases/18.06.0-rc1/targets/x86/geode/openwrt-18.06.0-rc1-x86-geode-combined-ext4.img.gz;1;0;1;7.04 MB;7.04 MB
/releases/19.07.0-rc1/targets/x86/geode/openwrt-19.07.0-rc1-x86-geode-rootfs-ext4.img.gz;1;0;1;4.76 MB;4.76 MB
/releases/18.06.0-rc2/targets/gemini/generic/openwrt-18.06.0-rc2-gemini-dns313-bootpart.tar.gz;1;0;1;2.23 MB;2.23 MB
/releases/19.07.0-rc1/targets/sunxi/cortexa7/openwrt-19.07.0-rc1-sunxi-cortexa7-sun7i-a20-olinuxino-lime2-squashfs-sdcard.img.gz;1;0;1;4.86 MB;4.86 MB
/releases/19.07.1/targets/sunxi/cortexa7/openwrt-19.07.1-sunxi-cortexa7-sun7i-a20-lamobo-r1-ext4-sdcard.img.gz;1;0;1;6.49 MB;6.49 MB
//snapshots/targets/sunxi/cortexa7/openwrt-sunxi-cortexa7-xunlong_orangepi-r1-squashfs-sdcard.img.gz;1;0;1;5.57 MB;5.57 MB
/releases/18.06.7/targets/sunxi/cortexa7/openwrt-18.06.7-sunxi-cortexa7-sun7i-a20-olinuxino-lime2-emmc-squashfs-sdcard.img.gz;1;0;1;1.27 MB;1.27 MB
/releases/18.06.3/targets/brcm2708/bcm2709/openwrt-18.06.3-brcm2708-bcm2709-rpi-2-ext4-factory.img.gz;1;0;1;8.86 MB;8.86 MB
//snapshots/targets/at91/sama5/openwrt-at91-sama5-microchip_sama5d2-ptc-ek-ext4-root.ubi.gz;1;0;1;2.33 MB;2.33 MB
//snapshots/targets/at91/legacy/openwrt-at91-legacy-at91sam9m10g45ek-ext4-root.ubi.gz;1;0;1;1.98 MB;1.98 MB
//snapshots/targets/malta/be64/kernel-debug.tar.bz2;1;0;1;10.03 MB;10.03 MB
/releases/17.01.6/targets/oxnas/generic/lede-17.01.6-oxnas-pogoplug-v3-ubifs-sysupgrade.tar;1;0;1;159.75 KB;159.75 KB
/releases/18.06.6/targets/armvirt/32/openwrt-18.06.6-armvirt-32-root.squashfs.gz;1;0;1;1.45 MB;1.45 MB
/releases/17.01.7/targets/oxnas/generic/lede-17.01.7-oxnas-kd20-squashfs-sysupgrade.tar;1;0;1;159.75 KB;159.75 KB
/releases/18.06.6/targets/ar71xx/nand/openwrt-18.06.6-ar71xx-nand-mr18-squashfs-sysupgrade.tar;1;0;1;6.62 MB;6.62 MB
/releases/18.06.4/targets/sunxi/cortexa7/openwrt-18.06.4-sunxi-cortexa7-sun8i-h3-nanopi-m1-plus-squashfs-sdcard.img.gz;1;0;1;175.54 KB;175.54 KB
/releases/18.06.0-rc1/targets/sunxi/cortexa7/openwrt-18.06.0-rc1-sunxi-cortexa7-sun7i-a20-bananapro-squashfs-sdcard.img.gz;1;0;1;5.07 MB;5.07 MB
/releases/19.07.0-rc2/targets/x86/geode/openwrt-19.07.0-rc2-x86-geode-rootfs-ext4.img.gz;1;0;1;4.76 MB;4.76 MB
/releases/18.06-SNAPSHOT/targets/x86/generic/openwrt-18.06-snapshot-r8080-9f2a40c72f-x86-generic-rootfs-ext4.img.gz;1;0;1;3.01 MB;3.01 MB
/releases/19.07.0-rc2/targets/tegra/generic/openwrt-19.07.0-rc2-tegra-compulab_trimslice-squashfs-sdcard.img.gz;1;0;1;5.37 MB;5.37 MB
/releases/18.06.0-rc2/targets/sunxi/cortexa7/openwrt-18.06.0-rc2-sunxi-cortexa7-sun7i-a20-bananapro-squashfs-sdcard.img.gz;1;0;1;5.08 MB;5.08 MB
/releases/17.01.0-rc1/targets/sunxi/generic/lede-17.01.0-rc1-r3042-ec095b5-sunxi-sun7i-a20-cubieboard2-ext4-sdcard.img.gz;1;0;1;191.75 KB;191.75 KB
/releases/17.01-SNAPSHOT/targets/brcm63xx/smp/lede-17.01-snapshot-r4046-beaa2ec-brcm63xx-smp-livebox-vmlinux.gz;1;0;1;239.75 KB;239.75 KB
//snapshots/targets/sunxi/cortexa7/openwrt-sunxi-cortexa7-olimex_a20-olinuxino-lime2-emmc-ext4-sdcard.img.gz;1;0;1;6.42 MB;6.42 MB
/releases/19.07-SNAPSHOT/targets/ar71xx/mikrotik/openwrt-19.07-snapshot-r11233-589c3cf4e0-ar71xx-mikrotik-vmlinux.lzma;1;0;1;1.62 MB;1.62 MB
/releases/18.06.0-rc2/targets/octeontx/generic/openwrt-18.06.0-rc2-octeontx-default-rootfs.tar.gz;1;0;1;1.97 MB;1.97 MB
/releases/17.01.6/targets/mxs/generic/lede-17.01.6-mxs-duckbill-sdcard.img.gz;1;0;1;143.75 KB;143.75 KB
/releases/17.01.0-rc1/targets/x86/legacy/lede-17.01.0-rc1-r3042-ec095b5-x86-legacy-generic-rootfs.tar.gz;1;0;1;63.75 KB;63.75 KB
/releases/19.07.0-rc1/targets/at91/sama5/openwrt-19.07.0-rc1-at91-sama5-at91-sama5d3_xplained-ext4-sdcard.img.gz;1;0;1;6.02 MB;6.02 MB
/releases/19.07.0-rc1/targets/layerscape/armv8_64b/openwrt-19.07.0-rc1-layerscape-armv8_64b-ls1012afrwy-ext4-firmware.bin.gz;1;0;1;304.52 KB;304.52 KB
/releases/19.07.0/targets/layerscape/armv8_64b/openwrt-19.07.0-layerscape-armv8_64b-ls1088ardb-sdboot-ext4-sdcard.img.gz;1;0;1;8.80 MB;8.80 MB
/releases/19.07.1/targets/mediatek/mt7623/openwrt-19.07.1-mediatek-mt7623-7623a-unielec-u7623-02-emmc-512m-squashfs-sysupgrade-emmc.bin.gz;1;0;1;5.03 MB;5.03 MB
/releases/19.07-SNAPSHOT/targets/brcm2708/bcm2710/openwrt-19.07-snapshot-r11235-2a8279c161-brcm2708-bcm2710-rpi-3-ext4-sysupgrade.img.gz;1;0;1;143.54 KB;143.54 KB
/releases/19.07.0-rc1/targets/sunxi/cortexa7/openwrt-19.07.0-rc1-sunxi-cortexa7-sun8i-h3-orangepi-pc-plus-ext4-sdcard.img.gz;1;0;1;5.60 MB;5.60 MB
/releases/18.06.6/targets/arc770/generic/openwrt-18.06.6-arc770-generic-root.ext4.gz;1;0;1;2.68 MB;2.68 MB
/snapshots/targets/scheduled_for_removal/brcm47xx/legacy/kernel-debug.tar.bz2;1;0;1;0;0
/releases/18.06.5/targets/brcm2708/bcm2710/openwrt-18.06.5-brcm2708-bcm2710-rpi-3-squashfs-factory.img.gz;1;0;1;7.81 MB;7.81 MB
/releases/19.07-SNAPSHOT/targets/sunxi/cortexa8/openwrt-19.07-snapshot-r11228-78c4c04dd7-sunxi-cortexa8-sun5i-a13-olimex-som-ext4-sdcard.img.gz;1;0;1;6.06 MB;6.06 MB
/releases/19.07.0-rc1/targets/at91/sama5/openwrt-19.07.0-rc1-at91-sama5-at91-sama5d4_xplained-ext4-root.ubi.gz;1;0;1;2.40 MB;2.40 MB
/snapshots/targets/scheduled_for_removal/brcm63xx/generic/kernel-debug.tar.bz2;1;0;1;0;0
/releases/18.06.0-rc1/targets/at91/sama5d3/openwrt-18.06.0-rc1-at91-sama5d3-at91-sama5d3_xplained-ext4-root.ubi.gz;1;0;1;2.33 MB;2.33 MB
/releases/17.01.0/targets/x86/geode/lede-17.01.0-r3205-59508e3-x86-geode-rootfs-ext4.img.gz;1;0;1;159.75 KB;159.75 KB
//snapshots/targets/sunxi/cortexa7/openwrt-sunxi-cortexa7-xunlong_orangepi-2-ext4-sdcard.img.gz;1;0;1;6.29 MB;6.29 MB
/releases/19.07.0-rc2/targets/layerscape/armv7/openwrt-19.07.0-rc2-layerscape-armv7-ls1021aiot-sdboot-ext4-sdcard.img.gz;1;0;1;6.26 MB;6.26 MB
/releases/17.01.0-rc2/targets/gemini/raidsonic/lede-17.01.0-rc2-r3131-42f3c1f-gemini-raidsonic-nas4220-hddapp.tgz;1;0;1;79.75 KB;79.75 KB
//snapshots/targets/at91/sama5/openwrt-at91-sama5-microchip_sama5d27-som1-ek-ext4-sdcard.img.gz;1;0;1;6.78 MB;6.78 MB
/releases/19.07.0-rc1/targets/at91/sama5/openwrt-19.07.0-rc1-at91-sama5-at91-sama5d2_ptc_ek-ext4-root.ubi.gz;1;0;1;2.45 MB;2.45 MB
/releases/18.06.4/targets/ramips/mt7621/openwrt-18.06.4-ramips-mt7621-ubnt-erx-sfp-squashfs-sysupgrade.tar;1;0;1;3.39 MB;3.39 MB
/releases/18.06.0-rc2/targets/sunxi/cortexa7/openwrt-18.06.0-rc2-sunxi-cortexa7-sun7i-a20-bananapro-ext4-sdcard.img.gz;1;0;1;6.05 MB;6.05 MB
/releases/18.06.2/targets/apm821xx/sata/openwrt-18.06.2-apm821xx-sata-wd_mybooklive-duo-ext4-rootfs.img.gz;1;0;1;6.11 MB;6.11 MB
//snapshots/targets/omap/generic/openwrt-omap-ti_omap4-panda-squashfs-sdcard.img.gz;1;0;1;6.21 MB;6.21 MB
/releases/18.06.4/targets/archs38/generic/openwrt-18.06.4-archs38-generic-Default-sdcard-vfat-ext4.img.gz;1;0;1;5.93 MB;5.93 MB
/releases/19.07.1/targets/sunxi/cortexa7/openwrt-19.07.1-sunxi-cortexa7-sun7i-a20-olinuxino-lime-squashfs-sdcard.img.gz;1;0;1;4.79 MB;4.79 MB
/releases/17.01.6/targets/sunxi/generic/lede-17.01.6-sunxi-sun8i-h3-orangepi-plus-squashfs-sdcard.img.gz;1;0;1;159.75 KB;159.75 KB
/releases/18.06.1/targets/arc770/generic/openwrt-18.06.1-arc770-generic-Default-sdcard-vfat-ext4.img.gz;1;0;1;4.85 MB;4.85 MB
/releases/19.07-SNAPSHOT/targets/x86/64/openwrt-19.07-snapshot-r11228-78c4c04dd7-x86-64-rootfs-ext4.img.gz;1;0;1;3.92 MB;3.92 MB
//snapshots/targets/sunxi/cortexa7/openwrt-sunxi-cortexa7-sinovoip_bananapi-m2-plus-squashfs-sdcard.img.gz;1;0;1;6.73 MB;6.73 MB
/releases/18.06-SNAPSHOT/targets/at91/legacy/openwrt-18.06-snapshot-r8080-9f2a40c72f-at91-legacy-lmu5000-ext4-factory.bin.gz;1;0;1;5.51 MB;5.51 MB
/releases/18.06.4/targets/sunxi/cortexa8/openwrt-18.06.4-sunxi-cortexa8-sun5i-a13-olinuxino-ext4-sdcard.img.gz;1;0;1;159.54 KB;159.54 KB
/releases/19.07.0-rc1/targets/sunxi/cortexa8/openwrt-19.07.0-rc1-sunxi-cortexa8-sun4i-a10-olinuxino-lime-squashfs-sdcard.img.gz;1;0;1;4.71 MB;4.71 MB
/releases/18.06.1/targets/pistachio/generic/openwrt-18.06.1-pistachio-rootfs.tar.gz;1;0;1;1.93 MB;1.93 MB
/releases/18.06.0-rc2/targets/oxnas/ox820/openwrt-18.06.0-rc2-oxnas-ox820-shuttle-kd20-factory.tar.gz;1;0;1;6.98 MB;6.98 MB
/releases/19.07.0-rc1/targets/at91/sama5/openwrt-19.07.0-rc1-at91-sama5-at91-sama5d3_xplained-ext4-root.ubi.gz;1;0;1;2.45 MB;2.45 MB
/releases/19.07.2/targets/gemini/generic/openwrt-19.07.2-gemini-dlink_dir-685-ext4-factory.bin.gz;1;0;1;9.02 MB;9.02 MB
/releases/19.07.1/targets/octeon/generic/openwrt-19.07.1-octeon-er-squashfs-sysupgrade.tar;1;0;1;8.83 MB;8.83 MB
/releases/17.01.6/targets/ar71xx/nand/lede-17.01.6-ar71xx-nand-wndr3700v4-squashfs-sysupgrade.tar;1;0;1;159.75 KB;159.75 KB
/releases/18.06.6/targets/ar71xx/nand/openwrt-18.06.6-ar71xx-nand-r6100-squashfs-sysupgrade.tar;1;0;1;4.76 MB;4.76 MB
/releases/18.06.7/targets/sunxi/cortexa7/openwrt-18.06.7-sunxi-cortexa7-sun7i-a20-bananapro-squashfs-sdcard.img.gz;1;0;1;1.27 MB;1.27 MB
/snapshots/targets/scheduled_for_removal/ath25/generic/openwrt-ath25-generic-kernel.lzma;1;0;1;0;0
/releases/18.06.6/targets/ar71xx/generic/openwrt-18.06.6-ar71xx-generic-vmlinux.lzma;1;0;1;1.38 MB;1.38 MB
/releases/19.07.0-rc1/targets/ar71xx/nand/openwrt-19.07.0-rc1-ar71xx-nand-r6100-squashfs-sysupgrade.tar;1;0;1;4.76 MB;4.76 MB
/releases/18.06.4/targets/armvirt/32/openwrt-18.06.4-armvirt-32-rootfs.cpio.gz;1;0;1;20 Bytes;20 Bytes
/releases/17.01.6/targets/sunxi/generic/lede-17.01.6-sunxi-sun7i-a20-bananapi-squashfs-sdcard.img.gz;1;0;1;143.75 KB;143.75 KB
/releases/18.06.0-rc1/targets/sunxi/cortexa8/openwrt-18.06.0-rc1-sunxi-cortexa8-sun4i-a10-olinuxino-lime-ext4-sdcard.img.gz;1;0;1;5.23 MB;5.23 MB
//snapshots/targets/at91/legacy/openwrt-at91-legacy-usb_a9g20-ext4-factory.bin.gz;1;0;1;5.30 MB;5.30 MB
/releases/17.01.7/targets/brcm2708/bcm2709/lede-17.01.7-brcm2708-bcm2709-rpi-2-ext4-sdcard.img.gz;1;0;1;6.89 MB;6.89 MB
//snapshots/targets/pistachio/generic/openwrt-pistachio-rootfs.tar.gz;1;0;1;2.14 MB;2.14 MB
/releases/17.01.0-rc2/targets/ipq806x/generic/lede-17.01.0-rc2-r3131-42f3c1f-ipq806x-AP148-legacy-squashfs-nand-sysupgrade.tar;1;0;1;191.75 KB;191.75 KB
/releases/18.06.6/targets/apm821xx/nand/openwrt-18.06.6-apm821xx-nand-meraki_mx60-squashfs-sysupgrade.tar;1;0;1;5.07 MB;5.07 MB
/releases/19.07.0-rc1/targets/sunxi/cortexa7/openwrt-19.07.0-rc1-sunxi-cortexa7-sun8i-h2-plus-orangepi-zero-ext4-sdcard.img.gz;1;0;1;5.58 MB;5.58 MB
//snapshots/targets/sunxi/cortexa7/openwrt-sunxi-cortexa7-xunlong_orangepi-r1-ext4-sdcard.img.gz;1;0;1;6.30 MB;6.30 MB
/releases/19.07.0-rc1/targets/omap/generic/openwrt-19.07.0-rc1-omap-ti_am335x-evm-ext4-sdcard.img.gz;1;0;1;6.65 MB;6.65 MB
/releases/19.07.2/targets/ar71xx/nand/openwrt-19.07.2-ar71xx-nand-rambutan-squashfs-sysupgrade.tar;1;0;1;1.77 MB;1.77 MB
/releases/18.06.0-rc2/targets/armvirt/32/openwrt-18.06.0-rc2-armvirt-32-default-rootfs.tar.gz;1;0;1;1.85 MB;1.85 MB
/releases/faillogs-18.06/mipsel_mips32/packages/perl-inline/host-compile.txt;1;0;1;391 Bytes;391 Bytes
/releases/19.07.0-rc1/targets/sunxi/cortexa7/openwrt-19.07.0-rc1-sunxi-cortexa7-sun7i-a20-bananapro-ext4-sdcard.img.gz;1;0;1;6.39 MB;6.39 MB
/releases/19.07.0-rc2/targets/mvebu/cortexa53/openwrt-19.07.0-rc2-mvebu-cortexa53-globalscale_espressobin-v7-emmc-squashfs-sdcard.img.gz;1;0;1;5.55 MB;5.55 MB
/releases/18.06.4/targets/sunxi/cortexa7/openwrt-18.06.4-sunxi-cortexa7-sun7i-a20-bananapro-ext4-sdcard.img.gz;1;0;1;159.54 KB;159.54 KB
/releases/18.06.0-rc2/targets/arc770/generic/openwrt-18.06.0-rc2-arc770-generic-Default-sdcard-vfat-ext4.img.gz;1;0;1;4.85 MB;4.85 MB
/releases/18.06.4/targets/sunxi/cortexa53/openwrt-18.06.4-sunxi-cortexa53-sun50i-a64-sopine-baseboard-squashfs-sdcard.img.gz;1;0;1;143.54 KB;143.54 KB
//snapshots/targets/mvebu/cortexa72/openwrt-mvebu-cortexa72-marvell_macchiatobin-doubleshot-squashfs-sdcard.img.gz;1;0;1;6.95 MB;6.95 MB
/releases/17.01.5/targets/armvirt/generic/lede-17.01.5-armvirt-root.ext4.gz;1;0;1;2.07 MB;2.07 MB
/releases/18.06.0-rc2/targets/omap/generic/openwrt-18.06.0-rc2-omap-am335x-boneblack-ubifs-sdcard.img.gz;1;0;1;5.91 MB;5.91 MB
/releases/17.01.0-rc2/targets/ipq806x/generic/lede-17.01.0-rc2-r3131-42f3c1f-ipq806x-NBG6817-squashfs-sysupgrade.tar;1;0;1;1.19 MB;1.19 MB
//snapshots/targets/sunxi/cortexa7/openwrt-sunxi-cortexa7-xunlong_orangepi-zero-ext4-sdcard.img.gz;1;0;1;6.27 MB;6.27 MB
/releases/17.01.6/targets/zynq/generic/lede-17.01.6-zynq-zybo-uramdisk.image.gz;1;0;1;159.75 KB;159.75 KB
/releases/17.01-SNAPSHOT/targets/gemini/raidsonic/lede-17.01-snapshot-r4046-beaa2ec-gemini-raidsonic-nas4220-rd.gz;1;0;1;175.75 KB;175.75 KB
/releases/18.06.3/targets/ar71xx/nand/openwrt-18.06.3-ar71xx-nand-z1-squashfs-sysupgrade.tar;1;0;1;6.68 MB;6.68 MB
//snapshots/targets/pistachio/generic/openwrt-pistachio-img_creator-ci40-squashfs-sysupgrade.tar;1;0;1;5.95 MB;5.95 MB
/releases/19.07.0-rc1/targets/zynq/generic/openwrt-19.07.0-rc1-zynq-digilent_zynq-zybo-z7-squashfs-sdcard.img.gz;1;0;1;5.84 MB;5.84 MB
/releases/19.07.0-rc2/targets/sunxi/cortexa53/openwrt-19.07.0-rc2-sunxi-cortexa53-sun50i-h5-nanopi-neo-plus2-squashfs-sdcard.img.gz;1;0;1;5.98 MB;5.98 MB
/releases/18.06.7/targets/brcm2708/bcm2709/openwrt-18.06.7-brcm2708-bcm2709-rpi-2-squashfs-factory.img.gz;1;0;1;1.28 MB;1.28 MB
/releases/19.07.0-rc1/targets/mvebu/cortexa72/openwrt-19.07.0-rc1-mvebu-cortexa72-marvell_armada8040-db-ext4-sdcard.img.gz;1;0;1;6.39 MB;6.39 MB
/releases/19.07.0-rc1/targets/sunxi/cortexa7/openwrt-19.07.0-rc1-sunxi-cortexa7-sun7i-a20-pcduino3-ext4-sdcard.img.gz;1;0;1;6.11 MB;6.11 MB
/releases/19.07.0-rc2/targets/ar71xx/nand/openwrt-19.07.0-rc2-ar71xx-nand-mr18-squashfs-sysupgrade.tar;1;0;1;7.39 MB;7.39 MB
/releases/19.07.0-rc2/targets/x86/geode/openwrt-19.07.0-rc2-x86-geode-rootfs-squashfs.img.gz;1;0;1;3.77 MB;3.77 MB
/releases/19.07.0-rc2/targets/at91/sama5/openwrt-19.07.0-rc2-at91-sama5-at91-sama5d27_som1_ek-ext4-root.ubi.gz;1;0;1;2.45 MB;2.45 MB
/releases/17.01.2/targets/kirkwood/generic/lede-17.01.2-kirkwood-dockstar-squashfs-sysupgrade.tar;1;0;1;143.75 KB;143.75 KB
/releases/17.01.2/targets/ipq806x/generic/lede-17.01.2-ipq806x-R7500-squashfs-sysupgrade.tar;1;0;1;319.75 KB;319.75 KB
/releases/19.07.0-rc1/targets/oxnas/ox820/openwrt-19.07.0-rc1-oxnas-ox820-akitio_mycloud-ubifs-sysupgrade.tar;1;0;1;8.45 MB;8.45 MB
/releases/19.07.0-rc2/targets/omap/generic/openwrt-19.07.0-rc2-omap-rootfs.tar.gz;1;0;1;2.63 MB;2.63 MB
/releases/18.06.6/targets/apm821xx/sata/openwrt-18.06.6-apm821xx-sata-wd_mybooklive-duo-ext4-rootfs.img.gz;1;0;1;6.13 MB;6.13 MB
/releases/18.06.7/targets/sunxi/cortexa8/openwrt-18.06.7-sunxi-cortexa8-sun4i-a10-pcduino-squashfs-sdcard.img.gz;1;0;1;1.28 MB;1.28 MB
/releases/18.06.0-rc2/targets/gemini/generic/openwrt-18.06.0-rc2-gemini-nas4220b-hddapp.tgz;1;0;1;2.98 MB;2.98 MB
/releases/17.01.6/targets/sunxi/generic/lede-17.01.6-sunxi-sun7i-a20-pcduino3-squashfs-sdcard.img.gz;1;0;1;79.75 KB;79.75 KB
/releases/19.07.0-rc2/targets/at91/sam9x/openwrt-19.07.0-rc2-at91-sam9x-at91sam9263ek-ext4-root.ubi.gz;1;0;1;2.47 MB;2.47 MB
/releases/18.06.1/targets/pistachio/generic/openwrt-18.06.1-pistachio-marduk-squashfs-sysupgrade.tar;1;0;1;4.71 MB;4.71 MB
/releases/19.07.0-rc1/targets/at91/sam9x/openwrt-19.07.0-rc1-at91-sam9x-at91sam9263ek-ext4-zImage.gz;1;0;1;3.34 MB;3.34 MB
/releases/19.07.0-rc1/targets/imx6/generic/openwrt-19.07.0-rc1-imx6-ventana-squashfs-bootfs.tar.gz;1;0;1;2.52 MB;2.52 MB
/releases/19.07.0/targets/layerscape/armv8_64b/openwrt-19.07.0-layerscape-armv8_64b-ls1043ardb-sdboot-ext4-sdcard.img.gz;1;0;1;8.36 MB;8.36 MB
/releases/18.06.5/targets/armvirt/64/openwrt-18.06.5-armvirt-64-rootfs.cpio.gz;1;0;1;20 Bytes;20 Bytes
/releases/18.06-SNAPSHOT/targets/omap/generic/openwrt-18.06-snapshot-r8077-7cbbab7246-omap-omap4-panda-ubifs-sdcard.img.gz;1;0;1;5.93 MB;5.93 MB
/releases/19.07.0/targets/octeon/generic/openwrt-19.07.0-octeon-erlite-squashfs-sysupgrade.tar;1;0;1;8.83 MB;8.83 MB
/releases/19.07.1/targets/mvebu/cortexa72/openwrt-19.07.1-mvebu-cortexa72-marvell_armada7040-db-squashfs-sdcard.img.gz;1;0;1;5.58 MB;5.58 MB
/releases/18.06.0-rc1/targets/sunxi/cortexa7/openwrt-18.06.0-rc1-sunxi-cortexa7-sun7i-a20-olinuxino-micro-squashfs-sdcard.img.gz;1;0;1;4.47 MB;4.47 MB
/releases/17.01.0-rc1/targets/x86/generic/lede-17.01.0-rc1-r3042-ec095b5-x86-generic-rootfs-ext4.img.gz;1;0;1;255.75 KB;255.75 KB
/releases/17.01.5/targets/ipq806x/generic/lede-17.01.5-ipq806x-R7800-squashfs-sysupgrade.tar;1;0;1;4.82 MB;4.82 MB
/releases/19.07.0-rc2/targets/at91/sama5/openwrt-19.07.0-rc2-at91-sama5-at91-sama5d27_som1_ek-ext4-zImage.gz;1;0;1;3.31 MB;3.31 MB
/releases/18.06.0-rc2/targets/at91/sama5d3/openwrt-18.06.0-rc2-at91-sama5d3-at91-sama5d3_xplained-ext4-root.ubi.gz;1;0;1;2.34 MB;2.34 MB
/snapshots/targets/scheduled_for_removal/ar71xx/nand/openwrt-ar71xx-nand-c-60-squashfs-sysupgrade.tar;1;0;1;0;0
/releases/17.01.6/targets/oxnas/generic/lede-17.01.6-oxnas-kd20-ubifs-sysupgrade.tar;1;0;1;287.75 KB;287.75 KB
/snapshots/targets/scheduled_for_removal/brcm2708/bcm2709/openwrt-brcm2708-bcm2709-rpi-2-squashfs-factory.img.gz;1;0;1;0;0
//snapshots/targets/sunxi/cortexa8/openwrt-sunxi-cortexa8-marsboard_a10-marsboard-ext4-sdcard.img.gz;1;0;1;6.29 MB;6.29 MB
/releases/19.07.1/targets/ar71xx/nand/openwrt-19.07.1-ar71xx-nand-mr18-squashfs-sysupgrade.tar;1;0;1;7.40 MB;7.40 MB
/releases/18.06.3/targets/octeon/generic/openwrt-18.06.3-octeon-er-squashfs-sysupgrade.tar;1;0;1;8.82 MB;8.82 MB
/releases/17.01.0-rc1/targets/sunxi/generic/lede-17.01.0-rc1-r3042-ec095b5-sunxi-sun7i-a20-bananapro-ext4-sdcard.img.gz;1;0;1;63.75 KB;63.75 KB
/releases/17.01.1/targets/ramips/mt7621/lede-17.01.1-ramips-mt7621-ubnt-erx-squashfs-sysupgrade.tar;1;0;1;255.75 KB;255.75 KB
/releases/18.06.0-rc1/targets/x86/generic/openwrt-18.06.0-rc1-x86-generic-generic-rootfs.tar.gz;1;0;1;2.73 MB;2.73 MB
/releases/17.01.2/targets/kirkwood/generic/lede-17.01.2-kirkwood-pogo_e02-squashfs-sysupgrade.tar;1;0;1;223.75 KB;223.75 KB
/releases/17.01.0-rc1/targets/rb532/generic/lede-17.01.0-rc1-r3042-ec095b5-rb532-default-rootfs.tar.gz;1;0;1;127.75 KB;127.75 KB
/releases/18.06.0-rc2/targets/at91/sama5d3/openwrt-18.06.0-rc2-at91-sama5d3-at91-sama5d3_xplained-ext4-zImage.gz;1;0;1;3.02 MB;3.02 MB
/releases/19.07-SNAPSHOT/targets/ar71xx/mikrotik/openwrt-19.07-snapshot-r11233-589c3cf4e0-ar71xx-mikrotik-vmlinux-initramfs.lzma;1;0;1;3.88 MB;3.88 MB
/releases/18.06.3/targets/apm821xx/sata/openwrt-18.06.3-apm821xx-sata-wd_mybooklive-duo-ext4-rootfs.img.gz;1;0;1;6.12 MB;6.12 MB
/releases/17.01-SNAPSHOT/targets/sunxi/generic/lede-17.01-snapshot-r4046-beaa2ec-sunxi-sun6i-a31-m9-ext4-sdcard.img.gz;1;0;1;95.75 KB;95.75 KB
/releases/19.07.0-rc1/targets/brcm2708/bcm2709/openwrt-19.07.0-rc1-brcm2708-bcm2709-rpi-2-squashfs-factory.img.gz;1;0;1;10.76 MB;10.76 MB
/releases/18.06.0-rc2/targets/armvirt/64/openwrt-18.06.0-rc2-armvirt-64-root.squashfs.gz;1;0;1;1.57 MB;1.57 MB
/releases/17.01.5/targets/octeon/generic/lede-17.01.5-octeon-erlite-squashfs-sysupgrade.tar;1;0;1;7.41 MB;7.41 MB
/releases/17.01.0-rc2/targets/x86/generic/lede-17.01.0-rc2-r3131-42f3c1f-x86-generic-combined-ext4.img.gz;1;0;1;175.75 KB;175.75 KB
/releases/18.06.7/targets/arc770/generic/openwrt-18.06.7-arc770-generic-Default-sdcard-vfat-ext4.img.gz;1;0;1;1.28 MB;1.28 MB
//snapshots/targets/mvebu/cortexa72/openwrt-mvebu-cortexa72-marvell_macchiatobin-singleshot-squashfs-sdcard.img.gz;1;0;1;6.95 MB;6.95 MB
/releases/17.01.0-rc1/targets/sunxi/generic/lede-17.01.0-rc1-r3042-ec095b5-sunxi-sun6i-a31-m9-squashfs-sdcard.img.gz;1;0;1;143.75 KB;143.75 KB
/releases/18.06.0/targets/ramips/mt7621/openwrt-18.06.0-ramips-mt7621-ubnt-erx-sfp-squashfs-sysupgrade.tar;1;0;1;3.36 MB;3.36 MB
/releases/17.01.7/targets/zynq/generic/lede-17.01.7-zynq-rootfs.tar.gz;1;0;1;159.75 KB;159.75 KB
/releases/19.07.0-rc2/targets/gemini/generic/openwrt-19.07.0-rc2-gemini-dlink_dir-685-ext4-factory.bin.gz;1;0;1;9.01 MB;9.01 MB
/releases/19.07.0-rc2/targets/brcm2708/bcm2710/openwrt-19.07.0-rc2-brcm2708-bcm2710-rpi-3-squashfs-sysupgrade.img.gz;1;0;1;10.93 MB;10.93 MB
/releases/19.07.3/targets/rb532/generic/openwrt-19.07.3-rb532-default-rootfs.tar.gz;1;0;1;3.58 MB;3.58 MB
/releases/19.07.0-rc2/targets/mxs/generic/openwrt-19.07.0-rc2-mxs-root.ext4.gz;1;0;1;5.37 MB;5.37 MB
/releases/18.06.7/targets/sunxi/cortexa8/openwrt-18.06.7-sunxi-cortexa8-sun5i-a13-olimex-som-squashfs-sdcard.img.gz;1;0;1;1.30 MB;1.30 MB
/releases/19.07.0-rc2/targets/sunxi/cortexa53/openwrt-19.07.0-rc2-sunxi-cortexa53-sun50i-h5-nanopi-neo-plus2-ext4-sdcard.img.gz;1;0;1;6.77 MB;6.77 MB
/releases/19.07.0-rc1/targets/brcm63xx/generic/openwrt-19.07.0-rc1-brcm63xx-generic-livebox-vmlinux.gz;1;0;1;2.25 MB;2.25 MB
/releases/19.07.0-rc2/targets/at91/sam9x/openwrt-19.07.0-rc2-at91-sam9x-usb_a9263-ext4-factory.bin.gz;1;0;1;5.85 MB;5.85 MB
/releases/17.01.7/targets/sunxi/generic/lede-17.01.7-sunxi-sun8i-h3-orangepi-plus-squashfs-sdcard.img.gz;1;0;1;159.75 KB;159.75 KB
/releases/19.07.0-rc2/targets/apm821xx/sata/openwrt-19.07.0-rc2-apm821xx-sata-wd_mybooklive-ext4-sysupgrade.img.gz;1;0;1;6.53 MB;6.53 MB
/releases/17.01.5/targets/arc770/generic/lede-17.01.5-arc770-generic-root.ext4.gz;1;0;1;2.78 MB;2.78 MB
/releases/19.07.0-rc1/targets/sunxi/cortexa53/openwrt-19.07.0-rc1-sunxi-cortexa53-sun50i-h5-nanopi-neo2-ext4-sdcard.img.gz;1;0;1;6.77 MB;6.77 MB
//snapshots/targets/bcm27xx/bcm2710/openwrt-bcm27xx-bcm2710-rpi-3-squashfs-sysupgrade.img.gz;1;0;1;13.14 MB;13.14 MB
/releases/18.06.2/targets/apm821xx/sata/openwrt-18.06.2-apm821xx-sata-wd_mybooklive-ext4-rootfs.img.gz;1;0;1;5.61 MB;5.61 MB
/releases/19.07.0-rc1/targets/zynq/generic/openwrt-19.07.0-rc1-zynq-digilent_zynq-zybo-squashfs-sdcard.img.gz;1;0;1;5.84 MB;5.84 MB
/releases/18.06.3/targets/pistachio/generic/openwrt-18.06.3-pistachio-marduk-squashfs-sysupgrade.tar;1;0;1;4.74 MB;4.74 MB
/releases/19.07.2/targets/pistachio/generic/openwrt-19.07.2-pistachio-marduk-squashfs-sysupgrade.tar;1;0;1;4.83 MB;4.83 MB
/releases/17.01-SNAPSHOT/targets/ath25/generic/lede-17.01-snapshot-r4046-beaa2ec-ath25-generic-kernel.lzma;1;0;1;319.75 KB;319.75 KB
/snapshots/targets/mvebu/cortexa53/openwrt-mvebu-cortexa53-globalscale_espressobin-ultra-squashfs-sdcard.img.gz;1;0;1;6.90 MB;6.90 MB
/releases/19.07-SNAPSHOT/targets/sunxi/cortexa8/openwrt-19.07-snapshot-r11228-78c4c04dd7-sunxi-cortexa8-sun5i-a13-olimex-som-squashfs-sdcard.img.gz;1;0;1;5.09 MB;5.09 MB
/releases/18.06.5/targets/armvirt/64/openwrt-18.06.5-armvirt-64-root.ext4.gz;1;0;1;2.24 MB;2.24 MB
//snapshots/targets/bcm27xx/bcm2711/openwrt-bcm27xx-bcm2711-rpi-4-squashfs-sysupgrade.img.gz;1;0;1;12.81 MB;12.81 MB
/releases/19.07.0-rc1/targets/mvebu/cortexa53/openwrt-19.07.0-rc1-mvebu-cortexa53-globalscale_espressobin-emmc-ext4-sdcard.img.gz;1;0;1;6.37 MB;6.37 MB
/releases/18.06.0-rc1/targets/at91/sama5d3/openwrt-18.06.0-rc1-at91-sama5d3-at91-sama5d3_xplained-ext4-sdcard.img.gz;1;0;1;5.61 MB;5.61 MB
//snapshots/targets/at91/legacy/openwrt-at91-legacy-at91sam9g20ek-ext4-root.ubi.gz;1;0;1;1.98 MB;1.98 MB
/releases/18.06.2/targets/pistachio/generic/openwrt-18.06.2-pistachio-marduk-squashfs-sysupgrade.tar;1;0;1;1.30 MB;1.30 MB
/releases/19.07.1/targets/octeon/generic/openwrt-19.07.1-octeon-erlite-squashfs-sysupgrade.tar;1;0;1;8.83 MB;8.83 MB
/releases/18.06.4/targets/sunxi/cortexa7/openwrt-18.06.4-sunxi-cortexa7-sun8i-h2-plus-orangepi-r1-squashfs-sdcard.img.gz;1;0;1;175.54 KB;175.54 KB
/releases/18.06.2/targets/gemini/generic/openwrt-18.06.2-gemini-sysupgrade-ib4220b.tar.gz;1;0;1;10.50 MB;10.50 MB
/releases/19.07.0-rc1/targets/x86/geode/openwrt-19.07.0-rc1-x86-geode-rootfs-squashfs.img.gz;1;0;1;3.76 MB;3.76 MB
/releases/18.06.0/targets/brcm63xx/smp/openwrt-18.06.0-brcm63xx-smp-livebox-vmlinux.gz;1;0;1;2.06 MB;2.06 MB
/releases/18.06.0-rc1/targets/mvebu/cortexa9/openwrt-18.06.0-rc1-mvebu-cortexa9-armada-388-clearfog-base-squashfs-sdcard.img.gz;1;0;1;4.49 MB;4.49 MB
/releases/17.01.0-rc1/targets/brcm2708/bcm2710/lede-17.01.0-rc1-r3042-ec095b5-brcm2708-bcm2710-rpi-3-ext4-sdcard.img.gz;1;0;1;63.75 KB;63.75 KB
/releases/19.07.0-rc2/targets/apm821xx/sata/openwrt-19.07.0-rc2-apm821xx-sata-wd_mybooklive-ext4-factory.img.gz;1;0;1;6.53 MB;6.53 MB
/releases/18.06.0-rc2/targets/at91/sama5d2/openwrt-18.06.0-rc2-at91-sama5d2-at91-sama5d27_som1_ek-ext4-root.ubi.gz;1;0;1;2.34 MB;2.34 MB
/releases/18.06.3/targets/ar71xx/nand/openwrt-18.06.3-ar71xx-nand-wi2a-ac200i-squashfs-sysupgrade.tar;1;0;1;3.99 MB;3.99 MB
/releases/18.06.0-rc2/targets/at91/sama5d4/openwrt-18.06.0-rc2-at91-sama5d4-at91-sama5d4_xplained-ext4-sdcard.img.gz;1;0;1;5.55 MB;5.55 MB
/releases/19.07-SNAPSHOT/targets/sunxi/cortexa8/openwrt-19.07-snapshot-r11228-78c4c04dd7-sunxi-cortexa8-sun4i-a10-cubieboard-ext4-sdcard.img.gz;1;0;1;5.58 MB;5.58 MB
//snapshots/targets/sunxi/cortexa7/openwrt-sunxi-cortexa7-cubietech_cubieboard2-squashfs-sdcard.img.gz;1;0;1;5.59 MB;5.59 MB
/releases/19.07.2/targets/gemini/generic/openwrt-19.07.2-gemini-raidsonic_ib-4220-b-ext4-factory.bin.gz;1;0;1;8.23 MB;8.23 MB
/releases/17.01.0-rc1/targets/armvirt/generic/lede-17.01.0-rc1-r3042-ec095b5-armvirt-root.ext4.gz;1;0;1;159.75 KB;159.75 KB
/releases/17.01.0-rc2/targets/omap/generic/lede-17.01.0-rc2-r3131-42f3c1f-omap-default-rootfs.tar.gz;1;0;1;175.75 KB;175.75 KB
/releases/17.01.7/targets/gemini/raidsonic/lede-17.01.7-gemini-raidsonic-sysupgrade-ib4220.tar.gz;1;0;1;9.02 MB;9.02 MB
/releases/18.06-SNAPSHOT/targets/mediatek/32/openwrt-18.06-snapshot-r7027-d6ee5e4-mediatek-32-bananapi,bpi-r2-sysupgrade.tar;1;0;1;175.54 KB;175.54 KB
//releases/19.07.3/targets/pistachio/generic/openwrt-19.07.3-pistachio-rootfs.tar.gz;1;0;1;2.00 MB;2.00 MB
/releases/18.06-SNAPSHOT/targets/mvebu/cortexa53/openwrt-18.06-snapshot-r8077-7cbbab7246-mvebu-cortexa53-globalscale-espressobin-squashfs-sdcard.img.gz;1;0;1;5.38 MB;5.38 MB
/releases/19.07-SNAPSHOT/targets/x86/64/openwrt-19.07-snapshot-r11228-78c4c04dd7-x86-64-combined-squashfs.img.gz;1;0;1;6.70 MB;6.70 MB
/releases/18.06.6/targets/brcm2708/bcm2710/openwrt-18.06.6-brcm2708-bcm2710-rpi-3-squashfs-factory.img.gz;1;0;1;1.27 MB;1.27 MB
//snapshots/targets/apm821xx/sata/openwrt-apm821xx-sata-wd_mybooklive-ext4-sysupgrade.img.gz;1;0;1;8.11 MB;8.11 MB
/snapshots/targets/scheduled_for_removal/ixp4xx/harddisk/kernel-debug.tar.bz2;1;0;1;0;0
/snapshots/targets/scheduled_for_removal/brcm2708/bcm2711/openwrt-brcm2708-bcm2711-rpi-4-ext4-factory.img.gz;1;0;1;0;0
/releases/19.07-SNAPSHOT/targets/brcm2708/bcm2709/openwrt-19.07-snapshot-r11228-78c4c04dd7-brcm2708-bcm2709-rpi-2-squashfs-sysupgrade.img.gz;1;0;1;10.78 MB;10.78 MB
/releases/19.07.0-rc1/targets/sunxi/cortexa7/openwrt-19.07.0-rc1-sunxi-cortexa7-sun8i-h3-nanopi-m1-plus-squashfs-sdcard.img.gz;1;0;1;5.82 MB;5.82 MB
//snapshots/targets/mvebu/cortexa72/openwrt-mvebu-cortexa72-marvell_armada7040-db-squashfs-sdcard.img.gz;1;0;1;6.94 MB;6.94 MB
/releases/18.06.7/targets/sunxi/cortexa8/openwrt-18.06.7-sunxi-cortexa8-sun4i-a10-marsboard-ext4-sdcard.img.gz;1;0;1;1.28 MB;1.28 MB
//snapshots/targets/bcm27xx/bcm2711/openwrt-bcm27xx-bcm2711-rpi-4-ext4-factory.img.gz;1;0;1;14.12 MB;14.12 MB
/releases/17.01.6/targets/sunxi/generic/lede-17.01.6-sunxi-sun7i-a20-olinuxino-micro-squashfs-sdcard.img.gz;1;0;1;159.75 KB;159.75 KB
/releases/18.06.0-rc2/targets/omap/generic/openwrt-18.06.0-rc2-omap-am335x-evm-ubifs-sdcard.img.gz;1;0;1;5.97 MB;5.97 MB
/releases/19.07.1/targets/mvebu/cortexa9/openwrt-19.07.1-mvebu-cortexa9-cznic_turris-omnia-sysupgrade.img.gz;1;0;1;5.49 MB;5.49 MB
/releases/17.01.0-rc1/targets/brcm2708/bcm2708/lede-17.01.0-rc1-r3042-ec095b5-brcm2708-bcm2708-rpi-ext4-sdcard.img.gz;1;0;1;239.75 KB;239.75 KB
/releases/18.06.3/targets/brcm2708/bcm2710/openwrt-18.06.3-brcm2708-bcm2710-rpi-3-squashfs-sysupgrade.img.gz;1;0;1;7.80 MB;7.80 MB
/releases/19.07.0-rc2/targets/brcm2708/bcm2709/openwrt-19.07.0-rc2-brcm2708-bcm2709-rpi-2-squashfs-sysupgrade.img.gz;1;0;1;10.76 MB;10.76 MB
/releases/17.01.7/targets/sunxi/generic/lede-17.01.7-sunxi-sun7i-a20-cubietruck-squashfs-sdcard.img.gz;1;0;1;143.75 KB;143.75 KB
/releases/17.01-SNAPSHOT/targets/archs38/generic/lede-17.01-snapshot-r4046-beaa2ec-archs38-generic-root.ext4.gz;1;0;1;175.75 KB;175.75 KB
/releases/faillogs-18.06/arc_archs/packages/perl/host-compile.txt;1;0;1;383.72 KB;383.72 KB
/releases/18.06.6/targets/brcm2708/bcm2708/openwrt-18.06.6-brcm2708-bcm2708-rpi-ext4-factory.img.gz;1;0;1;8.73 MB;8.73 MB
/releases/18.06.4/targets/octeon/generic/openwrt-18.06.4-octeon-erlite-squashfs-sysupgrade.tar;1;0;1;8.82 MB;8.82 MB
/releases/18.06.0-rc2/targets/x86/generic/openwrt-18.06.0-rc2-x86-generic-rootfs-ext4.img.gz;1;0;1;3.01 MB;3.01 MB
/releases/19.07.2/targets/armvirt/32/openwrt-19.07.2-armvirt-32-default-rootfs.tar.gz;1;0;1;1.96 MB;1.96 MB
/releases/18.06.4/targets/sunxi/cortexa7/openwrt-18.06.4-sunxi-cortexa7-sun8i-h3-orangepi-pc-ext4-sdcard.img.gz;1;0;1;159.54 KB;159.54 KB
/releases/17.01.6/targets/sunxi/generic/lede-17.01.6-sunxi-sun4i-a10-olinuxino-lime-squashfs-sdcard.img.gz;1;0;1;159.75 KB;159.75 KB
/releases/18.06.2/targets/apm821xx/nand/openwrt-18.06.2-apm821xx-nand-netgear_wndr4700-squashfs-sysupgrade.tar;1;0;1;5.21 MB;5.21 MB
/snapshots/faillogs/aarch64_cortex-a72/packages/perl-inline/host-compile.txt;1;0;1;391 Bytes;391 Bytes
/releases/19.07.0-rc2/targets/ath25/generic/openwrt-19.07.0-rc2-ath25-generic-kernel.gz;1;0;1;1.81 MB;1.81 MB
/releases/18.06.3/targets/ar71xx/nand/openwrt-18.06.3-ar71xx-nand-nbg6716-squashfs-sysupgrade.tar;1;0;1;4.76 MB;4.76 MB
/releases/18.06.0-rc2/targets/mxs/generic/openwrt-18.06.0-rc2-mxs-duckbill-sdcard.img.gz;1;0;1;10.99 MB;10.99 MB
//snapshots/targets/sunxi/cortexa7/openwrt-sunxi-cortexa7-xunlong_orangepi-pc-squashfs-sdcard.img.gz;1;0;1;5.56 MB;5.56 MB
/releases/19.07.0-rc2/targets/x86/generic/openwrt-19.07.0-rc2-x86-generic-rootfs-squashfs.img.gz;1;0;1;2.86 MB;2.86 MB
/releases/19.07.0-rc1/targets/octeon/generic/openwrt-19.07.0-rc1-octeon-erlite-squashfs-sysupgrade.tar;1;0;1;8.83 MB;8.83 MB
/releases/17.01.7/targets/sunxi/generic/lede-17.01.7-sunxi-sun5i-a13-olinuxino-squashfs-sdcard.img.gz;1;0;1;159.75 KB;159.75 KB
/releases/19.07.0-rc1/targets/oxnas/ox820/openwrt-19.07.0-rc1-oxnas-ox820-shuttle_kd20-factory.tar.gz;1;0;1;7.32 MB;7.32 MB
/releases/18.06.7/targets/brcm2708/bcm2709/openwrt-18.06.7-brcm2708-bcm2709-rpi-2-ext4-sysupgrade.img.gz;1;0;1;1.27 MB;1.27 MB
/releases/18.06.3/targets/brcm2708/bcm2710/openwrt-18.06.3-brcm2708-bcm2710-rpi-3-ext4-factory.img.gz;1;0;1;8.83 MB;8.83 MB
/releases/19.07.0-rc1/targets/sunxi/cortexa7/openwrt-19.07.0-rc1-sunxi-cortexa7-sun8i-h3-orangepi-2-squashfs-sdcard.img.gz;1;0;1;4.75 MB;4.75 MB
//snapshots/targets/sunxi/cortexa7/openwrt-sunxi-cortexa7-olimex_a20-olinuxino-lime-squashfs-sdcard.img.gz;1;0;1;5.58 MB;5.58 MB
/releases/18.06.0-rc2/targets/sunxi/cortexa8/openwrt-18.06.0-rc2-sunxi-cortexa8-sun5i-a13-olinuxino-ext4-sdcard.img.gz;1;0;1;5.70 MB;5.70 MB
//snapshots/targets/mvebu/cortexa53/openwrt-mvebu-cortexa53-globalscale_espressobin-squashfs-sdcard.img.gz;1;0;1;6.89 MB;6.89 MB
/releases/17.01.0-rc1/targets/at91/sama5d3/lede-17.01.0-rc1-r3042-ec095b5-at91-sama5d3-at91sama5d3xplained-rootfs.tar.gz;1;0;1;127.75 KB;127.75 KB
/releases/17.01.0-rc1/targets/sunxi/generic/lede-17.01.0-rc1-r3042-ec095b5-sunxi-sun8i-h3-orangepi-plus-squashfs-sdcard.img.gz;1;0;1;63.75 KB;63.75 KB
/releases/19.07.0-rc1/targets/omap/generic/openwrt-19.07.0-rc1-omap-ti_am335x-bone-black-ext4-sdcard.img.gz;1;0;1;6.58 MB;6.58 MB
/releases/18.06.4/targets/sunxi/cortexa7/openwrt-18.06.4-sunxi-cortexa7-sun6i-a31-m9-ext4-sdcard.img.gz;1;0;1;159.54 KB;159.54 KB
/snapshots/targets/scheduled_for_removal/ar71xx/nand/openwrt-ar71xx-nand-z1-squashfs-sysupgrade.tar;1;0;1;0;0
//snapshots/targets/octeontx/generic/openwrt-octeontx-default-rootfs.tar.gz;1;0;1;2.30 MB;2.30 MB
/releases/19.07.0-rc1/targets/sunxi/cortexa8/openwrt-19.07.0-rc1-sunxi-cortexa8-sun5i-a13-olimex-som-ext4-sdcard.img.gz;1;0;1;6.04 MB;6.04 MB
/releases/18.06.5/targets/gemini/generic/openwrt-18.06.5-gemini-dns313-bootpart.tar.gz;1;0;1;2.24 MB;2.24 MB
/snapshots/targets/scheduled_for_removal/au1000/au1550/kernel-debug.tar.bz2;1;0;1;0;0
/releases/19.07.1/targets/sunxi/cortexa7/openwrt-19.07.1-sunxi-cortexa7-sun7i-a20-bananapro-squashfs-sdcard.img.gz;1;0;1;5.41 MB;5.41 MB
//snapshots/targets/arc770/generic/openwrt-arc770-generic-Default-sdcard-vfat-ext4.img.gz;1;0;1;5.94 MB;5.94 MB
/releases/18.06.0-rc2/targets/x86/geode/openwrt-18.06.0-rc2-x86-geode-rootfs-ext4.img.gz;1;0;1;4.52 MB;4.52 MB
/releases/17.01.0-rc1/targets/sunxi/generic/lede-17.01.0-rc1-r3042-ec095b5-sunxi-sun5i-a13-olimex-som-squashfs-sdcard.img.gz;1;0;1;143.75 KB;143.75 KB
/snapshots/targets/scheduled_for_removal/ar71xx/nand/openwrt-ar71xx-nand-hiveap-121-squashfs-sysupgrade.tar;1;0;1;0;0
//snapshots/targets/at91/legacy/openwrt-at91-legacy-at91sam9g25ek-ext4-root.ubi.gz;1;0;1;1.98 MB;1.98 MB
/releases/18.06.3/targets/octeon/generic/openwrt-18.06.3-octeon-erlite-squashfs-sysupgrade.tar;1;0;1;8.82 MB;8.82 MB
/releases/19.07.1/targets/sunxi/cortexa8/openwrt-19.07.1-sunxi-cortexa8-sun5i-a13-olimex-som-ext4-sdcard.img.gz;1;0;1;6.05 MB;6.05 MB
//snapshots/targets/at91/sama5d4/openwrt-at91-sama5d4-at91-sama5d4_xplained-ext4-zImage.gz;1;0;1;3.25 MB;3.25 MB
//snapshots/targets/mvebu/cortexa9/openwrt-mvebu-cortexa9-cznic_turris-omnia-sysupgrade.img.gz;1;0;1;6.33 MB;6.33 MB
/releases/18.06.7/targets/ramips/mt7621/openwrt-18.06.7-ramips-mt7621-r6220-squashfs-sysupgrade.tar;1;0;1;4.17 MB;4.17 MB
//snapshots/targets/mvebu/cortexa53/openwrt-mvebu-cortexa53-globalscale_espressobin-emmc-ext4-sdcard.img.gz;1;0;1;7.66 MB;7.66 MB
/releases/19.07-SNAPSHOT/targets/brcm2708/bcm2710/openwrt-19.07-snapshot-r11233-589c3cf4e0-brcm2708-bcm2710-rpi-3-squashfs-factory.img.gz;1;0;1;10.95 MB;10.95 MB
/releases/17.01.0/targets/ipq806x/generic/lede-17.01.0-r3205-59508e3-ipq806x-R7500v2-squashfs-sysupgrade.tar;1;0;1;2.80 MB;2.80 MB
//snapshots/targets/at91/sama5d4/openwrt-at91-sama5d4-at91-sama5d4_xplained-ext4-sdcard.img.gz;1;0;1;5.41 MB;5.41 MB
/releases/19.07.1/targets/sunxi/cortexa53/openwrt-19.07.1-sunxi-cortexa53-sun50i-a64-pine64-plus-ext4-sdcard.img.gz;1;0;1;6.78 MB;6.78 MB
/releases/17.01.0-rc1/targets/sunxi/generic/lede-17.01.0-rc1-r3042-ec095b5-sunxi-sun7i-a20-lamobo-r1-ext4-sdcard.img.gz;1;0;1;79.75 KB;79.75 KB
/releases/19.07.0-rc2/targets/oxnas/ox820/openwrt-19.07.0-rc2-oxnas-ox820-cloudengines_pogoplug-series-3-ubifs-sysupgrade.tar;1;0;1;8.08 MB;8.08 MB
/releases/19.07-SNAPSHOT/targets/sunxi/cortexa8/openwrt-19.07-snapshot-r11228-78c4c04dd7-sunxi-cortexa8-sun4i-a10-marsboard-ext4-sdcard.img.gz;1;0;1;5.58 MB;5.58 MB
//snapshots/targets/omap/generic/openwrt-omap-ti_omap4-panda-ext4-sdcard.img.gz;1;0;1;6.97 MB;6.97 MB
/releases/17.01.5/targets/armvirt/generic/lede-17.01.5-armvirt-default-rootfs.tar.gz;1;0;1;1.80 MB;1.80 MB
/releases/17.01.7/targets/mxs/generic/lede-17.01.7-mxs-root.ext4.gz;1;0;1;159.75 KB;159.75 KB
/releases/17.01-SNAPSHOT/targets/sunxi/generic/lede-17.01-snapshot-r4046-beaa2ec-sunxi-sun4i-a10-olinuxino-lime-ext4-sdcard.img.gz;1;0;1;287.75 KB;287.75 KB
/releases/18.06.7/targets/sunxi/cortexa53/openwrt-18.06.7-sunxi-cortexa53-sun50i-a64-pine64-plus-ext4-sdcard.img.gz;1;0;1;1.30 MB;1.30 MB
/releases/18.06.0-rc2/targets/sunxi/cortexa53/openwrt-18.06.0-rc2-sunxi-cortexa53-sun50i-a64-pine64-plus-squashfs-sdcard.img.gz;1;0;1;5.59 MB;5.59 MB
/releases/19.07.0-rc2/targets/mvebu/cortexa53/openwrt-19.07.0-rc2-mvebu-cortexa53-marvell_armada-3720-db-squashfs-sdcard.img.gz;1;0;1;5.55 MB;5.55 MB
/releases/19.07.0-rc2/targets/mxs/generic/openwrt-19.07.0-rc2-mxs-duckbill-sdcard.img.gz;1;0;1;11.28 MB;11.28 MB
/releases/18.06.0/targets/brcm2708/bcm2708/openwrt-18.06.0-brcm2708-bcm2708-rpi-squashfs-sysupgrade.img.gz;1;0;1;7.58 MB;7.58 MB
/releases/17.01-SNAPSHOT/targets/kirkwood/generic/lede-17.01-snapshot-r4046-beaa2ec-kirkwood-goflexhome-squashfs-sysupgrade.tar;1;0;1;255.75 KB;255.75 KB
/releases/18.06.0-rc2/targets/sunxi/cortexa7/openwrt-18.06.0-rc2-sunxi-cortexa7-sun8i-h3-nanopi-m1-plus-squashfs-sdcard.img.gz;1;0;1;5.44 MB;5.44 MB
/releases/19.07.0-rc2/targets/armvirt/32/openwrt-19.07.0-rc2-armvirt-32-default-rootfs.tar.gz;1;0;1;1.95 MB;1.95 MB
/releases/18.06.0/targets/brcm2708/bcm2708/openwrt-18.06.0-brcm2708-bcm2708-rpi-squashfs-factory.img.gz;1;0;1;7.58 MB;7.58 MB
/releases/19.07.0-rc2/targets/pistachio/generic/openwrt-19.07.0-rc2-pistachio-marduk-squashfs-sysupgrade.tar;1;0;1;4.82 MB;4.82 MB
/releases/18.06.0-rc2/targets/sunxi/cortexa7/openwrt-18.06.0-rc2-sunxi-cortexa7-sun8i-h3-orangepi-2-squashfs-sdcard.img.gz;1;0;1;4.43 MB;4.43 MB
/releases/17.01-SNAPSHOT/targets/sunxi/generic/lede-17.01-snapshot-r4046-beaa2ec-sunxi-sun7i-a20-bananapi-squashfs-sdcard.img.gz;1;0;1;175.75 KB;175.75 KB
/releases/19.07.0-rc1/targets/sunxi/cortexa7/openwrt-19.07.0-rc1-sunxi-cortexa7-sun7i-a20-olinuxino-micro-squashfs-sdcard.img.gz;1;0;1;4.79 MB;4.79 MB
/releases/19.07.1/targets/sunxi/cortexa53/openwrt-19.07.1-sunxi-cortexa53-sun50i-h5-orangepi-pc2-ext4-sdcard.img.gz;1;0;1;6.80 MB;6.80 MB
/releases/18.06.1/targets/armvirt/32/openwrt-18.06.1-armvirt-32-default-rootfs.tar.gz;1;0;1;1.85 MB;1.85 MB
/releases/17.01.7/targets/ipq806x/generic/lede-17.01.7-ipq806x-AP148-legacy-ubifs-nand-sysupgrade.tar;1;0;1;175.75 KB;175.75 KB
/releases/17.01.0/targets/ipq806x/generic/lede-17.01.0-r3205-59508e3-ipq806x-NBG6817-squashfs-sysupgrade.tar;1;0;1;3.45 MB;3.45 MB
/releases/19.07.1/targets/layerscape/armv8_64b/openwrt-19.07.1-layerscape-armv8_64b-ls1012afrwy-ext4-sdcard.img.gz;1;0;1;8.05 MB;8.05 MB
/releases/18.06.0-rc1/targets/gemini/generic/openwrt-18.06.0-rc1-gemini-nas4220b-hddapp.tgz;1;0;1;3.20 MB;3.20 MB
//snapshots/targets/at91/legacy/openwrt-at91-legacy-rootfs.tar.gz;1;0;1;1.62 MB;1.62 MB
/releases/17.01.0-rc2/targets/octeon/generic/lede-17.01.0-rc2-r3131-42f3c1f-octeon-erlite-squashfs-sysupgrade.tar;1;0;1;319.75 KB;319.75 KB
/releases/19.07.0-rc2/targets/mvebu/cortexa72/openwrt-19.07.0-rc2-mvebu-cortexa72-marvell_armada8040-db-ext4-sdcard.img.gz;1;0;1;6.39 MB;6.39 MB
/releases/18.06.3/targets/brcm2708/bcm2709/openwrt-18.06.3-brcm2708-bcm2709-rpi-2-squashfs-factory.img.gz;1;0;1;7.76 MB;7.76 MB
/releases/18.06.0-rc1/targets/arc770/generic/openwrt-18.06.0-rc1-arc770-generic-root.ext4.gz;1;0;1;2.68 MB;2.68 MB
/releases/18.06.7/targets/sunxi/cortexa7/openwrt-18.06.7-sunxi-cortexa7-sun7i-a20-olinuxino-micro-ext4-sdcard.img.gz;1;0;1;1.27 MB;1.27 MB
//snapshots/targets/at91/sama5/openwrt-at91-sama5-microchip_sama5d2-xplained-ext4-sdcard.img.gz;1;0;1;6.78 MB;6.78 MB
//snapshots/targets/sunxi/cortexa7/openwrt-sunxi-cortexa7-friendlyarm_zeropi-squashfs-sdcard.img.gz;1;0;1;5.54 MB;5.54 MB
/releases/19.07.0-rc1/targets/sunxi/cortexa7/openwrt-19.07.0-rc1-sunxi-cortexa7-sun6i-a31-m9-squashfs-sdcard.img.gz;1;0;1;5.15 MB;5.15 MB
/releases/faillogs-19.07/arm_mpcore/packages/perl-parse-recdescent/host-compile.txt;1;0;1;1.50 KB;1.50 KB
/releases/19.07.0-rc2/targets/ar71xx/nand/openwrt-19.07.0-rc2-ar71xx-nand-r6100-squashfs-sysupgrade.tar;1;0;1;5.01 MB;5.01 MB
/releases/19.07.2/targets/sunxi/cortexa7/openwrt-19.07.2-sunxi-cortexa7-sun6i-a31-m9-ext4-sdcard.img.gz;1;0;1;6.14 MB;6.14 MB
/releases/18.06.7/targets/gemini/generic/openwrt-18.06.7-gemini-nas4220b-rd.gz;1;0;1;6.00 MB;6.00 MB
/releases/18.06.4/targets/sunxi/cortexa7/openwrt-18.06.4-sunxi-cortexa7-sun8i-h3-orangepi-plus-ext4-sdcard.img.gz;1;0;1;159.54 KB;159.54 KB
/releases/18.06.0-rc2/targets/sunxi/cortexa7/openwrt-18.06.0-rc2-sunxi-cortexa7-sun8i-h3-nanopi-neo-squashfs-sdcard.img.gz;1;0;1;4.41 MB;4.41 MB
/releases/19.07.0-rc1/targets/sunxi/cortexa7/openwrt-19.07.0-rc1-sunxi-cortexa7-sun8i-h3-nanopi-neo-squashfs-sdcard.img.gz;1;0;1;4.73 MB;4.73 MB
//snapshots/targets/apm821xx/sata/openwrt-apm821xx-sata-wd_mybooklive-squashfs-sysupgrade.img.gz;1;0;1;6.86 MB;6.86 MB
//snapshots/targets/at91/sama5d3/openwrt-at91-sama5d3-at91-sama5d3_xplained-ext4-zImage.gz;1;0;1;3.25 MB;3.25 MB
/releases/19.07.0/targets/ar71xx/nand/openwrt-19.07.0-ar71xx-nand-hiveap-121-squashfs-sysupgrade.tar;1;0;1;4.08 MB;4.08 MB
/releases/19.07-SNAPSHOT/targets/brcm2708/bcm2710/openwrt-19.07-snapshot-r11233-589c3cf4e0-brcm2708-bcm2710-rpi-3-ext4-factory.img.gz;1;0;1;12.09 MB;12.09 MB
//snapshots/targets/omap/generic/openwrt-omap-ti_omap3-beagle-squashfs-sdcard.img.gz;1;0;1;6.40 MB;6.40 MB
/releases/18.06.0-rc2/targets/sunxi/cortexa7/openwrt-18.06.0-rc2-sunxi-cortexa7-sun7i-a20-olinuxino-lime2-ext4-sdcard.img.gz;1;0;1;5.40 MB;5.40 MB
/releases/18.06.2/targets/gemini/generic/openwrt-18.06.2-gemini-dns313-bootpart.tar.gz;1;0;1;2.24 MB;2.24 MB
/releases/18.06.7/targets/ramips/mt7621/openwrt-18.06.7-ramips-mt7621-ubnt-erx-sfp-squashfs-sysupgrade.tar;1;0;1;3.39 MB;3.39 MB
/releases/18.06.7/targets/ar71xx/nand/openwrt-18.06.7-ar71xx-nand-r6100-squashfs-sysupgrade.tar;1;0;1;4.76 MB;4.76 MB
/releases/18.06.3/targets/brcm2708/bcm2710/openwrt-18.06.3-brcm2708-bcm2710-rpi-3-squashfs-factory.img.gz;1;0;1;7.80 MB;7.80 MB
/releases/19.07.0-rc1/targets/sunxi/cortexa7/openwrt-19.07.0-rc1-sunxi-cortexa7-sun7i-a20-bananapi-squashfs-sdcard.img.gz;1;0;1;4.78 MB;4.78 MB
/releases/19.07.0-rc2/targets/brcm63xx/smp/openwrt-19.07.0-rc2-brcm63xx-smp-livebox-vmlinux.gz;1;0;1;2.38 MB;2.38 MB
/releases/19.07.0-rc2/targets/arc770/generic/openwrt-19.07.0-rc2-arc770-generic-Default-sdcard-vfat-ext4.img.gz;1;0;1;5.81 MB;5.81 MB
/releases/18.06.0-rc2/targets/sunxi/cortexa8/openwrt-18.06.0-rc2-sunxi-cortexa8-sun4i-a10-olinuxino-lime-squashfs-sdcard.img.gz;1;0;1;4.40 MB;4.40 MB
/snapshots/targets/scheduled_for_removal/ar71xx/nand/openwrt-ar71xx-nand-nbg6716-squashfs-sysupgrade.tar;1;0;1;0;0
/releases/18.06.0-rc2/targets/armvirt/64/openwrt-18.06.0-rc2-armvirt-64-default-rootfs.tar.gz;1;0;1;1.97 MB;1.97 MB
//snapshots/targets/at91/sama5d4/openwrt-at91-sama5d4-at91-sama5d4_xplained-ext4-root.ubi.gz;1;0;1;1.92 MB;1.92 MB
/releases/18.06.0-rc2/targets/mvebu/cortexa53/openwrt-18.06.0-rc2-mvebu-cortexa53-globalscale-espressobin-squashfs-sdcard.img.gz;1;0;1;5.32 MB;5.32 MB
/releases/18.06.0-rc2/targets/imx6/generic/openwrt-18.06.0-rc2-imx6-rootfs.tar.gz;1;0;1;1.94 MB;1.94 MB
/releases/19.07.0-rc2/targets/brcm63xx/generic/openwrt-19.07.0-rc2-brcm63xx-generic-livebox-vmlinux.gz;1;0;1;2.25 MB;2.25 MB
/releases/19.07.1/targets/sunxi/cortexa8/openwrt-19.07.1-sunxi-cortexa8-sun4i-a10-marsboard-ext4-sdcard.img.gz;1;0;1;5.57 MB;5.57 MB
/releases/19.07.0-rc2/targets/at91/sam9x/openwrt-19.07.0-rc2-at91-sam9x-at91sam9m10g45ek-ext4-root.ubi.gz;1;0;1;2.47 MB;2.47 MB
/snapshots/targets//rockchip/armv8/openwrt-rockchip-armv8-pine64_rockpro64-squashfs-sysupgrade.img.gz;1;0;1;7.91 MB;7.91 MB
/releases/19.07.1/targets/mvebu/cortexa53/openwrt-19.07.1-mvebu-cortexa53-globalscale_espressobin-squashfs-sdcard.img.gz;1;0;1;5.56 MB;5.56 MB
/releases/18.06.7/targets/sunxi/cortexa7/openwrt-18.06.7-sunxi-cortexa7-sun7i-a20-pcduino3-squashfs-sdcard.img.gz;1;0;1;1.28 MB;1.28 MB
/releases/17.01.0-rc1/targets/sunxi/generic/lede-17.01.0-rc1-r3042-ec095b5-sunxi-sun7i-a20-cubieboard2-squashfs-sdcard.img.gz;1;0;1;191.75 KB;191.75 KB
/releases/17.01.7/targets/imx6/generic/lede-17.01.7-imx6-ventana-squashfs-bootfs.tar.gz;1;0;1;159.75 KB;159.75 KB
/releases/18.06.3/targets/ramips/mt7621/openwrt-18.06.3-ramips-mt7621-ubnt-erx-squashfs-sysupgrade.tar;1;0;1;3.37 MB;3.37 MB
/releases/17.01.6/targets/sunxi/generic/lede-17.01.6-sunxi-sun7i-a20-bananapro-squashfs-sdcard.img.gz;1;0;1;287.75 KB;287.75 KB
/releases/19.07.0-rc1/targets/armvirt/64/openwrt-19.07.0-rc1-armvirt-64-default-rootfs.tar.gz;1;0;1;2.04 MB;2.04 MB
/releases/19.07.0-rc1/targets/brcm2708/bcm2709/openwrt-19.07.0-rc1-brcm2708-bcm2709-rpi-2-squashfs-sysupgrade.img.gz;1;0;1;10.76 MB;10.76 MB
/releases/17.01-SNAPSHOT/targets/sunxi/generic/lede-17.01-snapshot-r4046-beaa2ec-sunxi-sun7i-a20-cubieboard2-ext4-sdcard.img.gz;1;0;1;271.75 KB;271.75 KB
/snapshots/targets/scheduled_for_removal/ar7/generic/kernel-debug.tar.bz2;1;0;1;0;0
/releases/17.01.0-rc1/targets/sunxi/generic/lede-17.01.0-rc1-r3042-ec095b5-sunxi-sun7i-a20-bananapro-squashfs-sdcard.img.gz;1;0;1;191.75 KB;191.75 KB
/releases/19.07.0-rc2/targets/layerscape/armv8_64b/openwrt-19.07.0-rc2-layerscape-armv8_64b-ls1046ardb-sdboot-ext4-sdcard.img.gz;1;0;1;8.35 MB;8.35 MB
/releases/18.06.9/targets/x86/64/openwrt-18.06.9-x86-64-rootfs-squashfs.img.gz;1;0;1;2.37 MB;2.37 MB
/releases/19.07.0-rc2/targets/sunxi/cortexa53/openwrt-19.07.0-rc2-sunxi-cortexa53-sun50i-a64-sopine-baseboard-squashfs-sdcard.img.gz;1;0;1;5.98 MB;5.98 MB
/releases/19.07.0-rc1/targets/sunxi/cortexa8/openwrt-19.07.0-rc1-sunxi-cortexa8-sun4i-a10-marsboard-squashfs-sdcard.img.gz;1;0;1;4.71 MB;4.71 MB
/releases/18.06.7/targets/octeontx/generic/openwrt-18.06.7-octeontx-default-rootfs.tar.gz;1;0;1;1.97 MB;1.97 MB
//snapshots/targets/sunxi/cortexa7/openwrt-sunxi-cortexa7-xunlong_orangepi-plus-squashfs-sdcard.img.gz;1;0;1;5.56 MB;5.56 MB
/releases/18.06.0-rc2/targets/omap/generic/openwrt-18.06.0-rc2-omap-rootfs.tar.gz;1;0;1;1.93 MB;1.93 MB
/releases/17.01.0-rc2/targets/ipq806x/generic/lede-17.01.0-rc2-r3131-42f3c1f-ipq806x-AP148-ubifs-nand-sysupgrade.tar;1;0;1;63.75 KB;63.75 KB
//snapshots/targets/layerscape/armv8_32b/openwrt-layerscape-armv8_32b-ls1012afrwy-ext4-sdcard.img.gz;1;0;1;6.57 MB;6.57 MB
/releases/faillogs-18.06/powerpc_8540/packages/node/host-compile.txt;1;0;1;2.64 MB;2.64 MB
/releases/18.06.5/targets/brcm2708/bcm2708/openwrt-18.06.5-brcm2708-bcm2708-rpi-squashfs-sysupgrade.img.gz;1;0;1;7.62 MB;7.62 MB
/releases/19.07.0-rc2/targets/oxnas/ox820/openwrt-19.07.0-rc2-oxnas-ox820-cloudengines_pogoplugpro-squashfs-sysupgrade.tar;1;0;1;5.52 MB;5.52 MB
//snapshots/targets/sunxi/cortexa7/openwrt-sunxi-cortexa7-lemaker_bananapro-squashfs-sdcard.img.gz;1;0;1;6.23 MB;6.23 MB
/releases/19.07.2/targets/mvebu/cortexa9/omnia-medkit-openwrt-19.07.2-mvebu-cortexa9-cznic_turris-omnia-initramfs.tar.gz;1;0;1;1.28 MB;1.28 MB
/releases/19.07.2/targets/layerscape/armv8_64b/openwrt-19.07.2-layerscape-armv8_64b-ls1012afrwy-ext4-sdcard.img.gz;1;0;1;3.08 MB;3.08 MB
/releases/18.06.0-rc1/targets/rb532/generic/openwrt-18.06.0-rc1-rb532-default-rootfs.tar.gz;1;0;1;3.39 MB;3.39 MB
/releases/18.06-SNAPSHOT/targets/sunxi/cortexa53/openwrt-18.06-snapshot-r8073-5625f5bc36-sunxi-cortexa53-sun50i-h5-nanopi-neo-plus2-squashfs-sdcard.img.gz;1;0;1;5.63 MB;5.63 MB
/releases/19.07.0-rc2/targets/sunxi/cortexa53/openwrt-19.07.0-rc2-sunxi-cortexa53-sun50i-h5-nanopi-neo2-ext4-sdcard.img.gz;1;0;1;6.77 MB;6.77 MB
/releases/17.01.7/targets/oxnas/generic/lede-17.01.7-oxnas-kd20-ubifs-sysupgrade.tar;1;0;1;159.75 KB;159.75 KB
/releases/19.07.0-rc1/targets/at91/sam9x/openwrt-19.07.0-rc1-at91-sam9x-at91sam9g20ek_2mmc-ext4-zImage.gz;1;0;1;3.34 MB;3.34 MB
//snapshots/targets/at91/sama5/openwrt-at91-sama5-microchip_sama5d4-xplained-ext4-sdcard.img.gz;1;0;1;6.79 MB;6.79 MB
/releases/17.01.6/targets/x86/geode/lede-17.01.6-x86-geode-rootfs-ext4.img.gz;1;0;1;223.75 KB;223.75 KB
/releases/19.07.1/targets/armvirt/64/openwrt-19.07.1-armvirt-64-root.squashfs.gz;1;0;1;1.65 MB;1.65 MB
/releases/17.01.0-rc2/targets/ipq806x/generic/lede-17.01.0-rc2-r3131-42f3c1f-ipq806x-AP148-legacy-ubifs-nand-sysupgrade.tar;1;0;1;239.75 KB;239.75 KB
/releases/19.07.0-rc1/targets/sunxi/cortexa8/openwrt-19.07.0-rc1-sunxi-cortexa8-sun4i-a10-olinuxino-lime-ext4-sdcard.img.gz;1;0;1;5.56 MB;5.56 MB
//snapshots/targets/at91/sama5d3/openwrt-at91-sama5d3-at91-sama5d3_xplained-ext4-root.ubi.gz;1;0;1;1.97 MB;1.97 MB
/releases/19.07.2/targets/sunxi/cortexa8/openwrt-19.07.2-sunxi-cortexa8-sun5i-a13-olinuxino-ext4-sdcard.img.gz;1;0;1;6.08 MB;6.08 MB
/releases/19.07.0-rc1/targets/sunxi/cortexa7/openwrt-19.07.0-rc1-sunxi-cortexa7-sun7i-a20-olinuxino-lime2-emmc-squashfs-sdcard.img.gz;1;0;1;4.86 MB;4.86 MB
/releases/19.07.0-rc1/targets/sunxi/cortexa53/openwrt-19.07.0-rc1-sunxi-cortexa53-sun50i-h5-orangepi-zero-plus-ext4-sdcard.img.gz;1;0;1;6.77 MB;6.77 MB
/releases/19.07.1/targets/sunxi/cortexa7/openwrt-19.07.1-sunxi-cortexa7-sun8i-h3-orangepi-one-squashfs-sdcard.img.gz;1;0;1;4.76 MB;4.76 MB
/releases/17.01.0-rc1/targets/sunxi/generic/lede-17.01.0-rc1-r3042-ec095b5-sunxi-sun7i-a20-lamobo-r1-squashfs-sdcard.img.gz;1;0;1;95.75 KB;95.75 KB
/releases/19.07.1/targets/mvebu/cortexa53/openwrt-19.07.1-mvebu-cortexa53-globalscale_espressobin-emmc-squashfs-sdcard.img.gz;1;0;1;5.56 MB;5.56 MB
/snapshots/targets/scheduled_for_removal/ar71xx/nand/openwrt-ar71xx-nand-mr18-squashfs-sysupgrade.tar;1;0;1;0;0
/releases/19.07.0-rc2/targets/zynq/generic/openwrt-19.07.0-rc2-zynq-digilent_zynq-zybo-z7-squashfs-sdcard.img.gz;1;0;1;5.84 MB;5.84 MB
/releases/17.01.6/targets/kirkwood/generic/lede-17.01.6-kirkwood-linksys-viper-squashfs-sysupgrade.tar;1;0;1;3.91 MB;3.91 MB
/releases/19.07.0-rc1/targets/sunxi/cortexa53/openwrt-19.07.0-rc1-sunxi-cortexa53-sun50i-h5-orangepi-pc2-squashfs-sdcard.img.gz;1;0;1;6.00 MB;6.00 MB
/releases/19.07.0/targets/ar71xx/nand/openwrt-19.07.0-ar71xx-nand-rambutan-squashfs-sysupgrade.tar;1;0;1;4.06 MB;4.06 MB
/releases/18.06.0-rc1/targets/sunxi/cortexa53/openwrt-18.06.0-rc1-sunxi-cortexa53-sun50i-h5-nanopi-neo-plus2-ext4-sdcard.img.gz;1;0;1;6.36 MB;6.36 MB
/releases/18.06.5/targets/brcm2708/bcm2708/openwrt-18.06.5-brcm2708-bcm2708-rpi-squashfs-factory.img.gz;1;0;1;7.62 MB;7.62 MB
/releases/19.07.0-rc1/targets/sunxi/cortexa7/openwrt-19.07.0-rc1-sunxi-cortexa7-sun8i-h2-plus-orangepi-zero-squashfs-sdcard.img.gz;1;0;1;4.74 MB;4.74 MB
/releases/19.07.0-rc1/targets/at91/sam9x/openwrt-19.07.0-rc1-at91-sam9x-lmu5000-ext4-factory.bin.gz;1;0;1;5.86 MB;5.86 MB
/releases/19.07.0-rc1/targets/at91/sama5/openwrt-19.07.0-rc1-at91-sama5-at91-sama5d2_xplained-ext4-sdcard.img.gz;1;0;1;5.92 MB;5.92 MB
/releases/19.07.0-rc2/targets/mvebu/cortexa9/openwrt-19.07.0-rc2-mvebu-cortexa9-cznic_turris-omnia-sysupgrade.img.gz;1;0;1;5.48 MB;5.48 MB
/releases/18.06.4/targets/sunxi/cortexa8/openwrt-18.06.4-sunxi-cortexa8-sun5i-a13-olimex-som-ext4-sdcard.img.gz;1;0;1;303.54 KB;303.54 KB
/releases/18.06.0/targets/brcm2708/bcm2709/openwrt-18.06.0-brcm2708-bcm2709-rpi-2-squashfs-sysupgrade.img.gz;1;0;1;7.74 MB;7.74 MB
/releases/18.06.7/targets/brcm2708/bcm2710/openwrt-18.06.7-brcm2708-bcm2710-rpi-3-ext4-factory.img.gz;1;7;8;18.37 MB;2.30 MB
/releases/19.07.0-rc1/targets/at91/sam9x/openwrt-19.07.0-rc1-at91-sam9x-usb_a9260-ext4-factory.bin.gz;1;0;1;5.84 MB;5.84 MB
//snapshots/targets/sunxi/cortexa7/openwrt-sunxi-cortexa7-friendlyarm_nanopi-r1-squashfs-sdcard.img.gz;1;0;1;6.72 MB;6.72 MB
/snapshots/targets/scheduled_for_removal/brcm2708/bcm2710/openwrt-brcm2708-bcm2710-rpi-3-squashfs-factory.img.gz;1;0;1;0;0
//snapshots/targets/sunxi/cortexa8/openwrt-sunxi-cortexa8-olimex_a13-olinuxino-ext4-sdcard.img.gz;1;0;1;6.87 MB;6.87 MB
/releases/19.07.0-rc1/targets/mxs/generic/openwrt-19.07.0-rc1-mxs-root.ext4.gz;1;0;1;5.37 MB;5.37 MB
/releases/17.01.1/targets/kirkwood/generic/lede-17.01.1-kirkwood-ib62x0-squashfs-sysupgrade.tar;1;0;1;191.75 KB;191.75 KB
/releases/18.06.0-rc2/targets/at91/sama5d2/openwrt-18.06.0-rc2-at91-sama5d2-at91-sama5d2_ptc_ek-ext4-root.ubi.gz;1;0;1;1.30 MB;1.30 MB
/releases/19.07.1/targets/ar71xx/nand/openwrt-19.07.1-ar71xx-nand-z1-squashfs-sysupgrade.tar;1;0;1;7.48 MB;7.48 MB
/releases/19.07.2/targets/sunxi/cortexa7/openwrt-19.07.2-sunxi-cortexa7-sun7i-a20-olinuxino-lime2-emmc-squashfs-sdcard.img.gz;1;0;1;4.87 MB;4.87 MB
/releases/18.06.0-rc1/targets/sunxi/cortexa7/openwrt-18.06.0-rc1-sunxi-cortexa7-sun8i-h3-nanopi-neo-ext4-sdcard.img.gz;1;0;1;5.23 MB;5.23 MB
/releases/19.07.0-rc2/targets/layerscape/armv8_64b/openwrt-19.07.0-rc2-layerscape-armv8_64b-ls1088ardb-sdboot-ext4-sdcard.img.gz;1;0;1;8.80 MB;8.80 MB
/releases/17.01.0-rc1/targets/sunxi/generic/lede-17.01.0-rc1-r3042-ec095b5-sunxi-sun7i-a20-olinuxino-micro-squashfs-sdcard.img.gz;1;0;1;159.75 KB;159.75 KB
/releases/18.06.0-rc2/targets/sunxi/cortexa8/openwrt-18.06.0-rc2-sunxi-cortexa8-sun5i-a13-olimex-som-ext4-sdcard.img.gz;1;0;1;5.67 MB;5.67 MB
/snapshots/targets/scheduled_for_removal/ar71xx/nand/openwrt-ar71xx-nand-rambutan-squashfs-sysupgrade.tar;1;0;1;0;0
/releases/19.07.1/targets/layerscape/armv8_64b/openwrt-19.07.1-layerscape-armv8_64b-ls1012afrwy-ext4-firmware.bin.gz;1;0;1;304.60 KB;304.60 KB
/releases/19.07.0-rc2/targets/x86/legacy/openwrt-19.07.0-rc2-x86-legacy-combined-ext4.img.gz;1;0;1;6.94 MB;6.94 MB
/releases/19.07.1/targets/mvebu/cortexa9/openwrt-19.07.1-mvebu-cortexa9-solidrun_clearfog-pro-a1-squashfs-sdcard.img.gz;1;0;1;4.73 MB;4.73 MB
/releases/18.06.0-rc2/targets/x86/generic/openwrt-18.06.0-rc2-x86-generic-generic-rootfs.tar.gz;1;0;1;2.74 MB;2.74 MB
/releases/18.06.0-rc2/targets/x86/geode/openwrt-18.06.0-rc2-x86-geode-rootfs-squashfs.img.gz;1;0;1;3.61 MB;3.61 MB
/releases/18.06.6/targets/ar71xx/tiny/openwrt-18.06.6-ar71xx-tiny-vmlinux.lzma;1;0;1;1007.54 KB;1007.54 KB
/releases/19.07.1/targets/sunxi/cortexa53/openwrt-19.07.1-sunxi-cortexa53-sun50i-h5-nanopi-neo2-squashfs-sdcard.img.gz;1;0;1;5.99 MB;5.99 MB
/releases/17.01.6/targets/ar71xx/nand/lede-17.01.6-ar71xx-nand-r6100-squashfs-sysupgrade.tar;1;0;1;143.75 KB;143.75 KB
/releases/18.06.0-rc2/targets/omap/generic/openwrt-18.06.0-rc2-omap-omap3-beagle-ext4-sdcard.img.gz;1;0;1;5.82 MB;5.82 MB
/releases/19.07.1/targets/sunxi/cortexa53/openwrt-19.07.1-sunxi-cortexa53-sun50i-a64-sopine-baseboard-ext4-sdcard.img.gz;1;0;1;6.78 MB;6.78 MB
/releases/18.06.5/targets/ar71xx/nand/openwrt-18.06.5-ar71xx-nand-z1-squashfs-sysupgrade.tar;1;0;1;6.70 MB;6.70 MB
/releases/19.07.0-rc2/targets/at91/sam9x/openwrt-19.07.0-rc2-at91-sam9x-at91sam9x25ek-ext4-root.ubi.gz;1;0;1;2.47 MB;2.47 MB
/releases/17.01.4/targets/x86/geode/lede-17.01.4-x86-geode-combined-ext4.img.gz;1;0;1;175.75 KB;175.75 KB
/releases/19.07.2/targets/ar71xx/nand/openwrt-19.07.2-ar71xx-nand-mr18-squashfs-sysupgrade.tar;1;0;1;1.30 MB;1.30 MB
/releases/19.07.0-rc1/targets/sunxi/cortexa7/openwrt-19.07.0-rc1-sunxi-cortexa7-sun8i-h2-plus-orangepi-r1-squashfs-sdcard.img.gz;1;0;1;4.76 MB;4.76 MB
/releases/19.07.0-rc2/targets/x86/legacy/openwrt-19.07.0-rc2-x86-legacy-generic-rootfs.tar.gz;1;0;1;2.86 MB;2.86 MB
/releases/18.06-SNAPSHOT/targets/at91/legacy/openwrt-18.06-snapshot-r8080-9f2a40c72f-at91-legacy-at91sam9g20ek-ext4-zImage.gz;1;0;1;3.11 MB;3.11 MB
/releases/19.07.0-rc1/targets/sunxi/cortexa7/openwrt-19.07.0-rc1-sunxi-cortexa7-sun8i-h3-orangepi-plus-ext4-sdcard.img.gz;1;0;1;5.59 MB;5.59 MB
/releases/18.06.0-rc1/targets/omap/generic/openwrt-18.06.0-rc1-omap-omap4-panda-ext4-sdcard.img.gz;1;0;1;5.68 MB;5.68 MB
/releases/17.01.0/targets/ipq806x/generic/lede-17.01.0-r3205-59508e3-ipq806x-AP148-legacy-ubifs-nand-sysupgrade.tar;1;0;1;3.06 MB;3.06 MB
/releases/19.07.0-rc2/targets/at91/sam9x/openwrt-19.07.0-rc2-at91-sam9x-tny_a9263-ext4-factory.bin.gz;1;0;1;5.85 MB;5.85 MB
/snapshots/targets/mvebu/cortexa53/openwrt-mvebu-cortexa53-globalscale_espressobin-ultra-ext4-sdcard.img.gz;1;0;1;7.67 MB;7.67 MB
/releases/17.01.6/targets/sunxi/generic/lede-17.01.6-sunxi-sun7i-a20-cubietruck-ext4-sdcard.img.gz;1;0;1;159.75 KB;159.75 KB
/releases/19.07.0-rc1/targets/at91/sam9x/openwrt-19.07.0-rc1-at91-sam9x-at91sam9g15ek-ext4-root.ubi.gz;1;0;1;2.47 MB;2.47 MB
/releases/17.01.0-rc2/targets/ipq806x/generic/lede-17.01.0-rc2-r3131-42f3c1f-ipq806x-EA8500-squashfs-sysupgrade.tar;1;0;1;255.75 KB;255.75 KB
//snapshots/targets/mediatek/mt7623/openwrt-mediatek-mt7623-bpi_bananapi-r2-squashfs-img.gz;1;0;1;5.74 MB;5.74 MB
/releases/18.06.0/targets/arc770/generic/openwrt-18.06.0-arc770-generic-root.ext4.gz;1;0;1;2.68 MB;2.68 MB
/releases/18.06.0-rc2/targets/x86/geode/openwrt-18.06.0-rc2-x86-geode-combined-ext4.img.gz;1;0;1;7.04 MB;7.04 MB
/releases/17.01.7/targets/sunxi/generic/lede-17.01.7-sunxi-sun8i-h3-orangepi-plus-ext4-sdcard.img.gz;1;0;1;143.75 KB;143.75 KB
//snapshots/targets/sunxi/cortexa7/openwrt-sunxi-cortexa7-xunlong_orangepi-pc-ext4-sdcard.img.gz;1;0;1;6.29 MB;6.29 MB
/releases/18.06.0-rc2/targets/sunxi/cortexa53/openwrt-18.06.0-rc2-sunxi-cortexa53-sun50i-h5-orangepi-zero-plus-squashfs-sdcard.img.gz;1;0;1;5.60 MB;5.60 MB
//snapshots/targets/at91/legacy/openwrt-at91-legacy-at91sam9263ek-ext4-zImage.gz;1;0;1;3.29 MB;3.29 MB
/releases/19.07.0-rc1/targets/armvirt/64/openwrt-19.07.0-rc1-armvirt-64-rootfs.cpio.gz;1;0;1;20 Bytes;20 Bytes
/releases/17.01.7/targets/oxnas/generic/lede-17.01.7-oxnas-pogoplug-v3-ubifs-sysupgrade.tar;1;0;1;159.75 KB;159.75 KB
/releases/19.07.0-rc1/targets/armvirt/32/openwrt-19.07.0-rc1-armvirt-32-root.squashfs.gz;1;0;1;1.53 MB;1.53 MB
/releases/19.07.2/targets/armvirt/32/openwrt-19.07.2-armvirt-32-root.ext4.gz;1;0;1;2.23 MB;2.23 MB
/releases/18.06.7/targets/sunxi/cortexa7/openwrt-18.06.7-sunxi-cortexa7-sun6i-a31-m9-squashfs-sdcard.img.gz;1;0;1;1.28 MB;1.28 MB
/releases/19.07.1/targets/sunxi/cortexa7/openwrt-19.07.1-sunxi-cortexa7-sun8i-h3-orangepi-2-ext4-sdcard.img.gz;1;0;1;5.61 MB;5.61 MB
/releases/18.06.0-rc1/targets/imx6/generic/openwrt-18.06.0-rc1-imx6-ventana-squashfs-bootfs.tar.gz;1;0;1;2.36 MB;2.36 MB
/releases/18.06.9/targets/oxnas/ox820/openwrt-18.06.9-oxnas-ox820-cloudengines-pogoplug-series-3-ubifs-sysupgrade.tar;1;0;1;7.81 MB;7.81 MB
/releases/18.06.2/targets/brcm2708/bcm2708/openwrt-18.06.2-brcm2708-bcm2708-rpi-ext4-sysupgrade.img.gz;1;0;1;8.70 MB;8.70 MB
/releases/19.07.0-rc1/targets/at91/sam9x/openwrt-19.07.0-rc1-at91-sam9x-at91sam9m10g45ek-ext4-root.ubi.gz;1;0;1;2.47 MB;2.47 MB
/releases/19.07.0-rc1/targets/layerscape/armv8_64b/openwrt-19.07.0-rc1-layerscape-armv8_64b-ls1043ardb-sdboot-ext4-sdcard.img.gz;1;0;1;8.35 MB;8.35 MB
/releases/18.06.6/targets/apm821xx/sata/openwrt-18.06.6-apm821xx-sata-wd_mybooklive-ext4-rootfs.img.gz;1;0;1;5.62 MB;5.62 MB
/releases/18.06.3/targets/ar71xx/tiny/openwrt-18.06.3-ar71xx-tiny-vmlinux.lzma;1;0;1;95.54 KB;95.54 KB
/releases/18.06.7/targets/octeon/generic/openwrt-18.06.7-octeon-er-squashfs-sysupgrade.tar;1;0;1;8.84 MB;8.84 MB
//snapshots/targets/sunxi/cortexa7/openwrt-sunxi-cortexa7-lemaker_bananapi-squashfs-sdcard.img.gz;1;0;1;5.58 MB;5.58 MB
/releases/18.06.2/targets/arc770/generic/openwrt-18.06.2-arc770-generic-root.ext4.gz;1;0;1;2.68 MB;2.68 MB
/releases/19.07.0-rc1/targets/at91/sama5/openwrt-19.07.0-rc1-at91-sama5-at91-sama5d3_xplained-ext4-zImage.gz;1;0;1;3.31 MB;3.31 MB
/releases/18.06.0-rc1/targets/omap/generic/openwrt-18.06.0-rc1-omap-omap3-beagle-ext4-sdcard.img.gz;1;0;1;5.81 MB;5.81 MB
/releases/19.07.0-rc1/targets/mvebu/cortexa72/openwrt-19.07.0-rc1-mvebu-cortexa72-marvell_armada8040-db-squashfs-sdcard.img.gz;1;0;1;5.57 MB;5.57 MB
/releases/19.07.2/targets/arc770/generic/openwrt-19.07.2-arc770-generic-Default-sdcard-vfat-ext4.img.gz;1;0;1;5.82 MB;5.82 MB
/releases/18.06.0-rc1/targets/brcm2708/bcm2710/openwrt-18.06.0-rc1-brcm2708-bcm2710-rpi-3-ext4-sdcard.img.gz;1;0;1;8.80 MB;8.80 MB
/releases/18.06.5/targets/ar71xx/generic/openwrt-18.06.5-ar71xx-generic-vmlinux.lzma;1;0;1;191.54 KB;191.54 KB
/releases/18.06.4/targets/sunxi/cortexa8/openwrt-18.06.4-sunxi-cortexa8-sun5i-a13-olinuxino-squashfs-sdcard.img.gz;1;0;1;143.54 KB;143.54 KB
/releases/18.06.0-rc2/targets/sunxi/cortexa7/openwrt-18.06.0-rc2-sunxi-cortexa7-sun7i-a20-olinuxino-micro-squashfs-sdcard.img.gz;1;0;1;4.48 MB;4.48 MB
/releases/18.06.2/targets/brcm63xx/smp/openwrt-18.06.2-brcm63xx-smp-livebox-vmlinux.gz;1;0;1;2.06 MB;2.06 MB
/releases/19.07.1/targets/apm821xx/sata/openwrt-19.07.1-apm821xx-sata-wd_mybooklive-squashfs-factory.img.gz;1;0;1;5.41 MB;5.41 MB
/snapshots/targets/scheduled_for_removal/ar7/ac49x/kernel-debug.tar.bz2;1;0;1;0;0
/releases/17.01.2/targets/ipq806x/generic/lede-17.01.2-ipq806x-AP148-ubifs-nand-sysupgrade.tar;1;0;1;223.75 KB;223.75 KB
/releases/19.07.0/targets/layerscape/armv8_64b/openwrt-19.07.0-layerscape-armv8_64b-ls1012afrwy-ext4-firmware.bin.gz;1;0;1;304.60 KB;304.60 KB
/releases/18.06.0-rc2/targets/sunxi/cortexa8/openwrt-18.06.0-rc2-sunxi-cortexa8-sun4i-a10-cubieboard-squashfs-sdcard.img.gz;1;0;1;4.40 MB;4.40 MB
/releases/17.01.0-rc2/targets/sunxi/generic/lede-17.01.0-rc2-r3131-42f3c1f-sunxi-sun6i-a31-m9-squashfs-sdcard.img.gz;1;0;1;223.75 KB;223.75 KB
/releases/19.07.0-rc2/targets/octeon/generic/openwrt-19.07.0-rc2-octeon-er-squashfs-sysupgrade.tar;1;0;1;8.83 MB;8.83 MB
/releases/19.07.0-rc1/targets/at91/sam9x/openwrt-19.07.0-rc1-at91-sam9x-at91sam9263ek-ext4-root.ubi.gz;1;0;1;2.47 MB;2.47 MB
/releases/19.07.0-rc2/targets/at91/sama5/openwrt-19.07.0-rc2-at91-sama5-at91-sama5d2_xplained-ext4-sdcard.img.gz;1;0;1;5.93 MB;5.93 MB
/releases/19.07.3/targets/tegra/generic/openwrt-19.07.3-tegra-compulab_trimslice-squashfs-sdcard.img.gz;1;0;1;5.38 MB;5.38 MB
/releases/18.06.0-rc1/targets/sunxi/cortexa53/openwrt-18.06.0-rc1-sunxi-cortexa53-sun50i-a64-pine64-plus-ext4-sdcard.img.gz;1;0;1;6.36 MB;6.36 MB
/releases/18.06.7/targets/brcm2708/bcm2709/openwrt-18.06.7-brcm2708-bcm2709-rpi-2-ext4-factory.img.gz;1;0;1;1.30 MB;1.30 MB
/releases/19.07.0-rc1/targets/armvirt/32/openwrt-19.07.0-rc1-armvirt-32-root.ext4.gz;1;0;1;2.22 MB;2.22 MB
/releases/18.06.0-rc2/targets/x86/geode/openwrt-18.06.0-rc2-x86-geode-combined-squashfs.img.gz;1;0;1;6.14 MB;6.14 MB
/releases/17.01.5/targets/ipq806x/generic/lede-17.01.5-ipq806x-R7500v2-squashfs-sysupgrade.tar;1;0;1;4.93 MB;4.93 MB
/releases/19.07.2/targets/sunxi/cortexa7/openwrt-19.07.2-sunxi-cortexa7-sun7i-a20-olinuxino-micro-ext4-sdcard.img.gz;1;0;1;5.65 MB;5.65 MB
/releases/17.01.2/targets/ipq806x/generic/lede-17.01.2-ipq806x-AP148-squashfs-nand-sysupgrade.tar;1;0;1;319.75 KB;319.75 KB
//snapshots/targets/at91/legacy/kernel-debug.tar.bz2;1;0;1;12.10 MB;12.10 MB
/releases/18.06.7/targets/pistachio/generic/openwrt-18.06.7-pistachio-rootfs.tar.gz;1;0;1;1.93 MB;1.93 MB
/releases/19.07.0-rc2/targets/x86/geode/openwrt-19.07.0-rc2-x86-geode-combined-ext4.img.gz;1;0;1;7.39 MB;7.39 MB
//snapshots/targets/sunxi/cortexa7/openwrt-sunxi-cortexa7-sinovoip_bananapi-m2-ultra-ext4-sdcard.img.gz;1;0;1;7.73 MB;7.73 MB
/releases/18.06.3/targets/ar71xx/nand/openwrt-18.06.3-ar71xx-nand-c-60-squashfs-sysupgrade.tar;1;0;1;3.70 MB;3.70 MB
//releases/19.07.3/targets/pistachio/generic/openwrt-19.07.3-pistachio-marduk-squashfs-sysupgrade.tar;1;0;1;4.83 MB;4.83 MB
/releases/18.06.7/targets/sunxi/cortexa7/openwrt-18.06.7-sunxi-cortexa7-sun7i-a20-cubieboard2-squashfs-sdcard.img.gz;1;0;1;1.28 MB;1.28 MB
/releases/19.07.1/targets/sunxi/cortexa7/openwrt-19.07.1-sunxi-cortexa7-sun7i-a20-olinuxino-lime2-ext4-sdcard.img.gz;1;0;1;5.74 MB;5.74 MB
/releases/19.07.0-rc1/targets/omap/generic/openwrt-19.07.0-rc1-omap-ti_omap4-panda-ext4-sdcard.img.gz;1;0;1;6.54 MB;6.54 MB
/releases/19.07.1/targets/gemini/generic/openwrt-19.07.1-gemini-dlink_dir-685-ext4-sysupgrade.bin.gz;1;0;1;9.02 MB;9.02 MB
/releases/18.06.0-rc1/targets/sunxi/cortexa7/openwrt-18.06.0-rc1-sunxi-cortexa7-sun8i-h3-nanopi-m1-plus-squashfs-sdcard.img.gz;1;0;1;5.43 MB;5.43 MB
/releases/17.01.0-rc2/targets/octeon/generic/lede-17.01.0-rc2-r3131-42f3c1f-octeon-er-squashfs-sysupgrade.tar;1;0;1;63.75 KB;63.75 KB
/releases/18.06.4/targets/sunxi/cortexa53/openwrt-18.06.4-sunxi-cortexa53-sun50i-h5-nanopi-neo-plus2-ext4-sdcard.img.gz;1;0;1;143.54 KB;143.54 KB
/releases/17.01.0-rc2/targets/ipq806x/generic/lede-17.01.0-rc2-r3131-42f3c1f-ipq806x-R7500v2-squashfs-sysupgrade.tar;1;0;1;175.75 KB;175.75 KB
/releases/18.06.0-rc1/targets/armvirt/64/openwrt-18.06.0-rc1-armvirt-64-root.ext4.gz;1;0;1;2.23 MB;2.23 MB
/snapshots/targets/scheduled_for_removal/mcs814x/generic/kernel-debug.tar.bz2;1;0;1;0;0
/releases/17.01.0-rc1/targets/x86/legacy/lede-17.01.0-rc1-r3042-ec095b5-x86-legacy-rootfs-ext4.img.gz;1;0;1;191.75 KB;191.75 KB
/releases/18.06.7/targets/ar71xx/nand/openwrt-18.06.7-ar71xx-nand-mr18-squashfs-sysupgrade.tar;1;0;1;6.62 MB;6.62 MB
/releases/18.06.6/targets/ar71xx/nand/openwrt-18.06.6-ar71xx-nand-z1-squashfs-sysupgrade.tar;1;0;1;6.70 MB;6.70 MB
/releases/18.06.4/targets/pistachio/generic/openwrt-18.06.4-pistachio-marduk-squashfs-sysupgrade.tar;1;0;1;4.74 MB;4.74 MB
//snapshots/targets/mvebu/cortexa9/openwrt-mvebu-cortexa9-solidrun_clearfog-base-a1-squashfs-sdcard.img.gz;1;0;1;5.47 MB;5.47 MB
/releases/18.06.0-rc2/targets/at91/sama5d3/openwrt-18.06.0-rc2-at91-sama5d3-rootfs.tar.gz;1;0;1;1.97 MB;1.97 MB
/releases/18.06.4/targets/sunxi/cortexa7/openwrt-18.06.4-sunxi-cortexa7-sun7i-a20-olinuxino-micro-ext4-sdcard.img.gz;1;0;1;159.54 KB;159.54 KB
/releases/18.06.0-rc2/targets/armvirt/64/openwrt-18.06.0-rc2-armvirt-64-rootfs.cpio.gz;1;0;1;1.97 MB;1.97 MB
//snapshots/targets/mvebu/cortexa9/openwrt-mvebu-cortexa9-solidrun_clearfog-pro-a1-squashfs-sdcard.img.gz;1;0;1;5.47 MB;5.47 MB
/releases/19.07.0-rc1/targets/sunxi/cortexa53/openwrt-19.07.0-rc1-sunxi-cortexa53-sun50i-h5-orangepi-pc2-ext4-sdcard.img.gz;1;0;1;6.79 MB;6.79 MB
//snapshots/targets/apm821xx/sata/openwrt-apm821xx-sata-wd_mybooklive-ext4-factory.img.gz;1;0;1;8.11 MB;8.11 MB
/releases/19.07.2/targets/ar71xx/nand/openwrt-19.07.2-ar71xx-nand-z1-squashfs-sysupgrade.tar;1;0;1;7.48 MB;7.48 MB
/releases/17.01.7/targets/oxnas/generic/lede-17.01.7-oxnas-stg212-ubifs-sysupgrade.tar;1;0;1;143.75 KB;143.75 KB
/releases/19.07.0-rc2/targets/sunxi/cortexa8/openwrt-19.07.0-rc2-sunxi-cortexa8-sun4i-a10-cubieboard-squashfs-sdcard.img.gz;1;0;1;4.72 MB;4.72 MB
/releases/19.07.2/targets/sunxi/cortexa7/openwrt-19.07.2-sunxi-cortexa7-sun7i-a20-cubietruck-ext4-sdcard.img.gz;1;0;1;6.43 MB;6.43 MB
/releases/17.01.5/targets/ipq806x/generic/lede-17.01.5-ipq806x-AP148-legacy-squashfs-nand-sysupgrade.tar;1;0;1;4.51 MB;4.51 MB
/snapshots/targets/scheduled_for_removal/brcm63xx/smp/kernel-debug.tar.bz2;1;0;1;0;0
/releases/19.07.0-rc1/targets/ar71xx/nand/openwrt-19.07.0-rc1-ar71xx-nand-wndr3700v4-squashfs-sysupgrade.tar;1;0;1;4.51 MB;4.51 MB
/releases/19.07.0-rc1/targets/sunxi/cortexa7/openwrt-19.07.0-rc1-sunxi-cortexa7-sun7i-a20-olinuxino-lime-squashfs-sdcard.img.gz;1;0;1;4.78 MB;4.78 MB
/releases/17.01.4/targets/x86/legacy/lede-17.01.4-x86-legacy-rootfs-ext4.img.gz;1;0;1;79.75 KB;79.75 KB
/releases/19.07.1/targets/ar71xx/nand/openwrt-19.07.1-ar71xx-nand-hiveap-121-squashfs-sysupgrade.tar;1;0;1;4.08 MB;4.08 MB
/releases/18.06.0-rc1/targets/gemini/generic/openwrt-18.06.0-rc1-gemini-dns313-bootpart.tar.gz;1;0;1;2.23 MB;2.23 MB
/snapshots/targets/scheduled_for_removal/ar71xx/nand/kernel-debug.tar.bz2;1;0;1;0;0
/releases/18.06.0-rc1/targets/omap/generic/openwrt-18.06.0-rc1-omap-am335x-evm-ext4-sdcard.img.gz;1;0;1;5.79 MB;5.79 MB
/releases/19.07.0-rc2/targets/at91/sam9x/openwrt-19.07.0-rc2-at91-sam9x-usb_a9g20-ext4-factory.bin.gz;1;0;1;5.85 MB;5.85 MB
/releases/19.07.2/targets/sunxi/cortexa7/openwrt-19.07.2-sunxi-cortexa7-sun7i-a20-bananapro-ext4-sdcard.img.gz;1;0;1;6.40 MB;6.40 MB
//snapshots/targets/at91/legacy/openwrt-at91-legacy-at91sam9g20ek-ext4-zImage.gz;1;0;1;3.29 MB;3.29 MB
/releases/19.07.0-rc1/targets/sunxi/cortexa8/openwrt-19.07.0-rc1-sunxi-cortexa8-sun4i-a10-pcduino-ext4-sdcard.img.gz;1;0;1;6.06 MB;6.06 MB
/releases/18.06.7/targets/ar71xx/tiny/openwrt-18.06.7-ar71xx-tiny-vmlinux.lzma;1;0;1;239.54 KB;239.54 KB
/releases/18.06.0-rc2/targets/at91/sama5d2/openwrt-18.06.0-rc2-at91-sama5d2-at91-sama5d27_som1_ek-ext4-sdcard.img.gz;1;0;1;2.73 MB;2.73 MB
/releases/18.06.4/targets/sunxi/cortexa7/openwrt-18.06.4-sunxi-cortexa7-sun7i-a20-lamobo-r1-ext4-sdcard.img.gz;1;0;1;159.54 KB;159.54 KB
/releases/19.07.0/targets/layerscape/armv8_64b/openwrt-19.07.0-layerscape-armv8_64b-ls1046ardb-sdboot-ext4-sdcard.img.gz;1;0;1;8.35 MB;8.35 MB
/releases/18.06.4/targets/sunxi/cortexa7/openwrt-18.06.4-sunxi-cortexa7-sun7i-a20-olinuxino-lime-ext4-sdcard.img.gz;1;0;1;271.54 KB;271.54 KB
//snapshots/targets/at91/sama5/openwrt-at91-sama5-microchip_sama5d2-ptc-ek-ext4-sdcard.img.gz;1;0;1;6.79 MB;6.79 MB
//snapshots/targets/malta/le64/kernel-debug.tar.bz2;1;0;1;10.26 MB;10.26 MB
//snapshots/targets/sunxi/cortexa8/openwrt-sunxi-cortexa8-olimex_a13-olinuxino-squashfs-sdcard.img.gz;1;0;1;6.00 MB;6.00 MB
/releases/18.06.0-rc1/targets/at91/sama5d4/openwrt-18.06.0-rc1-at91-sama5d4-at91-sama5d4_xplained-ext4-root.ubi.gz;1;0;1;2.28 MB;2.28 MB
/releases/18.06.4/targets/sunxi/cortexa7/openwrt-18.06.4-sunxi-cortexa7-sun7i-a20-lamobo-r1-squashfs-sdcard.img.gz;1;0;1;287.54 KB;287.54 KB
/releases/19.07.0-rc1/targets/x86/legacy/openwrt-19.07.0-rc1-x86-legacy-generic-rootfs.tar.gz;1;0;1;2.86 MB;2.86 MB
//snapshots/targets/at91/legacy/openwrt-at91-legacy-ethernut5-ext4-root.ubi.gz;1;0;1;1.98 MB;1.98 MB
/releases/18.06.4/targets/armvirt/64/openwrt-18.06.4-armvirt-64-rootfs.cpio.gz;1;0;1;20 Bytes;20 Bytes
/releases/17.01-SNAPSHOT/targets/oxnas/generic/lede-17.01-snapshot-r4046-beaa2ec-oxnas-kd20-factory.tar.gz;1;0;1;95.75 KB;95.75 KB
/releases/19.07.0-rc1/targets/brcm2708/bcm2710/openwrt-19.07.0-rc1-brcm2708-bcm2710-rpi-3-ext4-sysupgrade.img.gz;1;0;1;12.05 MB;12.05 MB
/releases/19.07.1/targets/mvebu/cortexa53/openwrt-19.07.1-mvebu-cortexa53-globalscale_espressobin-v7-emmc-squashfs-sdcard.img.gz;1;0;1;5.56 MB;5.56 MB
/releases/19.07.0-rc2/targets/omap/generic/openwrt-19.07.0-rc2-omap-ti_omap3-beagle-squashfs-sdcard.img.gz;1;0;1;5.78 MB;5.78 MB
/releases/19.07.0-rc1/targets/zynq/generic/openwrt-19.07.0-rc1-zynq-avnet_zynq-zed-squashfs-sdcard.img.gz;1;0;1;5.84 MB;5.84 MB
//snapshots/targets/mvebu/cortexa53/openwrt-mvebu-cortexa53-globalscale_espressobin-v7-emmc-ext4-sdcard.img.gz;1;0;1;7.66 MB;7.66 MB
//snapshots/targets/omap/generic/openwrt-omap-ti_am335x-evm-ext4-sdcard.img.gz;1;0;1;7.13 MB;7.13 MB
/releases/18.06.0-rc2/targets/sunxi/cortexa7/openwrt-18.06.0-rc2-sunxi-cortexa7-sun7i-a20-cubieboard2-squashfs-sdcard.img.gz;1;0;1;4.48 MB;4.48 MB
//snapshots/targets/at91/legacy/openwrt-at91-legacy-at91sam9g20ek_2mmc-ext4-zImage.gz;1;0;1;3.29 MB;3.29 MB
/releases/19.07.0-rc2/targets/mediatek/mt7623/openwrt-19.07.0-rc2-mediatek-mt7623-7623a-unielec-u7623-02-emmc-512m-squashfs-sysupgrade-emmc.bin.gz;1;0;1;5.02 MB;5.02 MB
/releases/18.06.0-rc1/targets/x86/geode/openwrt-18.06.0-rc1-x86-geode-rootfs-squashfs.img.gz;1;0;1;3.60 MB;3.60 MB
/releases/18.06.0-rc1/targets/x86/64/openwrt-18.06.0-rc1-x86-64-combined-ext4.img.gz;1;0;1;6.30 MB;6.30 MB
/releases/19.07.0/targets/octeon/generic/openwrt-19.07.0-octeon-er-squashfs-sysupgrade.tar;1;0;1;8.83 MB;8.83 MB
/releases/17.01.7/targets/x86/legacy/lede-17.01.7-x86-legacy-rootfs-ext4.img.gz;1;0;1;159.75 KB;159.75 KB
/releases/18.06.4/targets/sunxi/cortexa7/openwrt-18.06.4-sunxi-cortexa7-sun7i-a20-olinuxino-lime2-squashfs-sdcard.img.gz;1;0;1;159.54 KB;159.54 KB
/releases/19.07.0-rc2/targets/x86/generic/openwrt-19.07.0-rc2-x86-generic-generic-rootfs.tar.gz;1;0;1;3.70 MB;3.70 MB
/releases/18.06.7/targets/sunxi/cortexa7/openwrt-18.06.7-sunxi-cortexa7-sun8i-h3-orangepi-plus-squashfs-sdcard.img.gz;1;0;1;1.27 MB;1.27 MB
/releases/17.01.2/targets/mxs/generic/lede-17.01.2-mxs-root.ext4.gz;1;0;1;239.75 KB;239.75 KB
/releases/17.01.7/targets/sunxi/generic/lede-17.01.7-sunxi-sun7i-a20-cubietruck-ext4-sdcard.img.gz;1;0;1;143.75 KB;143.75 KB
/releases/19.07.0-rc2/targets/at91/sam9x/openwrt-19.07.0-rc2-at91-sam9x-usb_a9260-ext4-factory.bin.gz;1;0;1;5.85 MB;5.85 MB
/releases/18.06.0/targets/gemini/generic/openwrt-18.06.0-gemini-dns313-bootpart.tar.gz;1;0;1;2.23 MB;2.23 MB
/releases/18.06.0-rc1/targets/brcm2708/bcm2709/openwrt-18.06.0-rc1-brcm2708-bcm2709-rpi-2-ext4-sdcard.img.gz;1;0;1;8.83 MB;8.83 MB
/releases/17.01-SNAPSHOT/targets/ar71xx/nand/lede-17.01-snapshot-r4046-beaa2ec-ar71xx-nand-vmlinux.lzma;1;0;1;175.75 KB;175.75 KB
//snapshots/targets/at91/sama5/openwrt-at91-sama5-microchip_sama5d2-xplained-ext4-root.ubi.gz;1;0;1;2.33 MB;2.33 MB
/releases/17.01.7/targets/ar71xx/nand/lede-17.01.7-ar71xx-nand-mr18-squashfs-sysupgrade.tar;1;0;1;143.75 KB;143.75 KB
/snapshots/targets/scheduled_for_removal/brcm2708/bcm2710/openwrt-brcm2708-bcm2710-rpi-3-ext4-factory.img.gz;1;0;1;0;0
//snapshots/targets/at91/legacy/openwrt-at91-legacy-at91sam9g15ek-ext4-root.ubi.gz;1;0;1;1.98 MB;1.98 MB
/releases/19.07.1/targets/sunxi/cortexa53/openwrt-19.07.1-sunxi-cortexa53-sun50i-a64-pine64-plus-squashfs-sdcard.img.gz;1;0;1;5.99 MB;5.99 MB
/releases/19.07.1/targets/layerscape/armv7/openwrt-19.07.1-layerscape-armv7-ls1021atwr-sdboot-ext4-sdcard.img.gz;1;0;1;6.35 MB;6.35 MB
/releases/18.06.0-rc1/targets/at91/sama5d3/openwrt-18.06.0-rc1-at91-sama5d3-at91-sama5d3_xplained-ext4-zImage.gz;1;0;1;3.02 MB;3.02 MB
/releases/18.06.7/targets/sunxi/cortexa7/openwrt-18.06.7-sunxi-cortexa7-sun7i-a20-bananapi-ext4-sdcard.img.gz;1;0;1;1.28 MB;1.28 MB
/releases/18.06.7/targets/apm821xx/nand/openwrt-18.06.7-apm821xx-nand-netgear_wndr4700-squashfs-sysupgrade.tar;1;0;1;5.22 MB;5.22 MB
/releases/19.07.0-rc2/targets/zynq/generic/openwrt-19.07.0-rc2-zynq-digilent_zynq-zybo-squashfs-sdcard.img.gz;1;0;1;5.84 MB;5.84 MB
/releases/17.01.0-rc1/targets/zynq/generic/lede-17.01.0-rc1-r3042-ec095b5-zynq-zybo-uramdisk.image.gz;1;0;1;159.75 KB;159.75 KB
/releases/19.07.1/targets/sunxi/cortexa7/openwrt-19.07.1-sunxi-cortexa7-sun7i-a20-olinuxino-lime-ext4-sdcard.img.gz;1;0;1;5.64 MB;5.64 MB
/releases/18.06.0-rc1/targets/at91/sama5d2/openwrt-18.06.0-rc1-at91-sama5d2-at91-sama5d2_xplained-ext4-sdcard.img.gz;1;0;1;5.53 MB;5.53 MB
/releases/17.01.6/targets/sunxi/generic/lede-17.01.6-sunxi-sun7i-a20-olinuxino-lime-ext4-sdcard.img.gz;1;0;1;159.75 KB;159.75 KB
//snapshots/targets/at91/legacy/openwrt-at91-legacy-tny_a9260-ext4-factory.bin.gz;1;0;1;5.30 MB;5.30 MB
/releases/19.07.1/targets/mvebu/cortexa53/openwrt-19.07.1-mvebu-cortexa53-marvell_armada-3720-db-ext4-sdcard.img.gz;1;0;1;6.39 MB;6.39 MB
/releases/19.07.2/targets/mvebu/cortexa53/openwrt-19.07.2-mvebu-cortexa53-globalscale_espressobin-v7-emmc-squashfs-sdcard.img.gz;1;0;1;1.73 MB;1.73 MB
/releases/18.06.0-rc1/targets/mvebu/cortexa53/openwrt-18.06.0-rc1-mvebu-cortexa53-globalscale-espressobin-ext4-sdcard.img.gz;1;0;1;6.10 MB;6.10 MB
/releases/18.06.7/targets/sunxi/cortexa7/openwrt-18.06.7-sunxi-cortexa7-sun8i-h3-nanopi-m1-plus-ext4-sdcard.img.gz;1;0;1;1.28 MB;1.28 MB
/releases/17.01.0-rc1/targets/oxnas/generic/lede-17.01.0-rc1-r3042-ec095b5-oxnas-kd20-factory.tar.gz;1;0;1;191.75 KB;191.75 KB
/releases/19.07.1/targets/brcm2708/bcm2710/openwrt-19.07.1-brcm2708-bcm2710-rpi-3-ext4-factory.img.gz;1;0;1;12.08 MB;12.08 MB
/releases/19.07.0-rc1/targets/mediatek/mt7623/openwrt-19.07.0-rc1-mediatek-mt7623-7623a-unielec-u7623-02-emmc-512m-squashfs-sysupgrade-emmc.bin.gz;1;0;1;5.01 MB;5.01 MB
/releases/18.06.0-rc1/targets/sunxi/cortexa7/openwrt-18.06.0-rc1-sunxi-cortexa7-sun7i-a20-lamobo-r1-ext4-sdcard.img.gz;1;0;1;6.07 MB;6.07 MB
/releases/18.06-SNAPSHOT/targets/omap/generic/openwrt-18.06-snapshot-r8077-7cbbab7246-omap-am335x-evm-ext4-sdcard.img.gz;1;0;1;5.86 MB;5.86 MB
/releases/19.07.0-rc1/targets/layerscape/armv8_64b/openwrt-19.07.0-rc1-layerscape-armv8_64b-ls1012afrwy-ext4-sdcard.img.gz;1;0;1;8.04 MB;8.04 MB
/releases/19.07.0-rc2/targets/at91/sam9x/openwrt-19.07.0-rc2-at91-sam9x-at91sam9g20ek-ext4-zImage.gz;1;0;1;3.35 MB;3.35 MB
/releases/19.07.0-rc1/targets/sunxi/cortexa7/openwrt-19.07.0-rc1-sunxi-cortexa7-sun7i-a20-olinuxino-micro-ext4-sdcard.img.gz;1;0;1;5.63 MB;5.63 MB
/releases/19.07.0-rc1/targets/sunxi/cortexa7/openwrt-19.07.0-rc1-sunxi-cortexa7-sun8i-h3-orangepi-plus-squashfs-sdcard.img.gz;1;0;1;4.75 MB;4.75 MB
/releases/19.07.0-rc1/targets/sunxi/cortexa7/openwrt-19.07.0-rc1-sunxi-cortexa7-sun8i-h3-nanopi-neo-ext4-sdcard.img.gz;1;0;1;5.57 MB;5.57 MB
/releases/19.07.1/targets/gemini/generic/openwrt-19.07.1-gemini-dlink_dns-313-ext4-factory.bin.gz;1;0;1;8.51 MB;8.51 MB
/snapshots/targets/scheduled_for_removal/brcm2708/bcm2708/openwrt-brcm2708-bcm2708-rpi-squashfs-sysupgrade.img.gz;1;0;1;0;0
/releases/17.01.6/targets/imx6/generic/lede-17.01.6-imx6-rootfs.tar.gz;1;0;1;143.75 KB;143.75 KB
/releases/18.06.3/targets/apm821xx/nand/openwrt-18.06.3-apm821xx-nand-meraki_mx60-squashfs-sysupgrade.tar;1;0;1;5.06 MB;5.06 MB
/releases/18.06.7/targets/sunxi/cortexa7/openwrt-18.06.7-sunxi-cortexa7-sun7i-a20-olinuxino-lime2-ext4-sdcard.img.gz;1;0;1;1.27 MB;1.27 MB
/releases/17.01.2/targets/kirkwood/generic/lede-17.01.2-kirkwood-ib62x0-squashfs-sysupgrade.tar;1;0;1;143.75 KB;143.75 KB
/releases/19.07.1/targets/ar71xx/nand/openwrt-19.07.1-ar71xx-nand-c-60-squashfs-sysupgrade.tar;1;0;1;4.06 MB;4.06 MB
/releases/19.07.0-rc1/targets/mvebu/cortexa72/openwrt-19.07.0-rc1-mvebu-cortexa72-marvell_armada7040-db-ext4-sdcard.img.gz;1;0;1;6.39 MB;6.39 MB
/releases/19.07.2/targets/sunxi/cortexa7/openwrt-19.07.2-sunxi-cortexa7-sun8i-h3-nanopi-m1-plus-squashfs-sdcard.img.gz;1;0;1;5.84 MB;5.84 MB
/releases/17.01.0-rc1/targets/sunxi/generic/lede-17.01.0-rc1-r3042-ec095b5-sunxi-sun4i-a10-olinuxino-lime-ext4-sdcard.img.gz;1;0;1;447.75 KB;447.75 KB
/releases/19.07.2/targets/mvebu/cortexa72/openwrt-19.07.2-mvebu-cortexa72-marvell_macchiatobin-squashfs-sdcard.img.gz;1;0;1;1.27 MB;1.27 MB
/releases/faillogs-18.06/arc_arc700/packages/icu/host-compile.txt;1;0;1;81.96 KB;81.96 KB
/releases/18.06.0-rc1/targets/armvirt/32/openwrt-18.06.0-rc1-armvirt-32-rootfs.cpio.gz;1;0;1;1.85 MB;1.85 MB
/releases/18.06.2/targets/armvirt/64/openwrt-18.06.2-armvirt-64-root.ext4.gz;1;0;1;2.23 MB;2.23 MB
/releases/17.01.0-rc2/targets/x86/geode/lede-17.01.0-rc2-r3131-42f3c1f-x86-geode-combined-ext4.img.gz;1;0;1;79.75 KB;79.75 KB
//snapshots/targets/omap/generic/openwrt-omap-ti_am335x-bone-black-ext4-sdcard.img.gz;1;0;1;7.12 MB;7.12 MB
/releases/18.06.0-rc1/targets/sunxi/cortexa7/openwrt-18.06.0-rc1-sunxi-cortexa7-sun7i-a20-olinuxino-lime-squashfs-sdcard.img.gz;1;0;1;4.47 MB;4.47 MB
/releases/18.06.3/targets/apm821xx/nand/openwrt-18.06.3-apm821xx-nand-netgear_wndr4700-squashfs-sysupgrade.tar;1;0;1;5.21 MB;5.21 MB
/releases/19.07.0-rc1/targets/x86/legacy/openwrt-19.07.0-rc1-x86-legacy-combined-squashfs.img.gz;1;0;1;6.22 MB;6.22 MB
/releases/19.07.2/targets/mvebu/cortexa53/openwrt-19.07.2-mvebu-cortexa53-globalscale_espressobin-emmc-squashfs-sdcard.img.gz;1;0;1;2.17 MB;2.17 MB
/releases/18.06.0-rc2/targets/gemini/generic/openwrt-18.06.0-rc2-gemini-nas4220b-rd.gz;1;0;1;6.00 MB;6.00 MB
/releases/18.06.5/targets/octeontx/generic/openwrt-18.06.5-octeontx-default-rootfs.tar.gz;1;0;1;1.97 MB;1.97 MB
/releases/19.07.0-rc1/targets/brcm2708/bcm2708/openwrt-19.07.0-rc1-brcm2708-bcm2708-rpi-ext4-sysupgrade.img.gz;1;0;1;11.48 MB;11.48 MB
/releases/17.01.0-rc1/targets/armvirt/generic/lede-17.01.0-rc1-r3042-ec095b5-armvirt-rootfs.cpio.gz;1;0;1;911.75 KB;911.75 KB
/releases/18.06.4/targets/x86/legacy/openwrt-18.06.4-x86-legacy-combined-squashfs.img.gz;1;0;1;159.54 KB;159.54 KB
/releases/18.06.0-rc1/targets/x86/64/openwrt-18.06.0-rc1-x86-64-rootfs-squashfs.img.gz;1;0;1;2.37 MB;2.37 MB
/releases/19.07.2/targets/sunxi/cortexa8/openwrt-19.07.2-sunxi-cortexa8-sun4i-a10-marsboard-ext4-sdcard.img.gz;1;0;1;5.57 MB;5.57 MB
/releases/18.06.0-rc1/targets/sunxi/cortexa53/openwrt-18.06.0-rc1-sunxi-cortexa53-sun50i-a64-sopine-baseboard-ext4-sdcard.img.gz;1;0;1;6.36 MB;6.36 MB
/snapshots%2Ftargets%2Fbcm27xx%2Fbcm2711%2Fopenwrt-bcm27xx-bcm2711-rpi-4-ext4-sysupgrade.img.gz;1;1;2;14.14 MB;7.07 MB
/releases/18.06.1/targets/brcm63xx/generic/openwrt-18.06.1-brcm63xx-generic-livebox-vmlinux.gz;1;0;1;1.94 MB;1.94 MB
/releases/19.07.0-rc2/targets/at91/sam9x/openwrt-19.07.0-rc2-at91-sam9x-at91sam9g25ek-ext4-root.ubi.gz;1;0;1;2.47 MB;2.47 MB
//snapshots/targets/at91/legacy/openwrt-at91-legacy-at91sam9263ek-ext4-root.ubi.gz;1;0;1;1.98 MB;1.98 MB
/releases/18.06.0-rc2/targets/omap/generic/openwrt-18.06.0-rc2-omap-omap4-panda-ext4-sdcard.img.gz;1;0;1;5.69 MB;5.69 MB
/releases/19.07.0-rc1/targets/armvirt/32/openwrt-19.07.0-rc1-armvirt-32-rootfs.cpio.gz;1;0;1;20 Bytes;20 Bytes
/releases/19.07.0-rc2/targets/arc770/generic/openwrt-19.07.0-rc2-arc770-generic-root.ext4.gz;1;0;1;2.94 MB;2.94 MB
/releases/17.01.6/targets/ar71xx/nand/lede-17.01.6-ar71xx-nand-c-60-squashfs-sysupgrade.tar;1;0;1;159.75 KB;159.75 KB
/snapshots/targets/scheduled_for_removal/ar71xx/nand/openwrt-ar71xx-nand-r6100-squashfs-sysupgrade.tar;1;0;1;0;0
/releases/18.06.3/targets/ar71xx/nand/openwrt-18.06.3-ar71xx-nand-mr18-squashfs-sysupgrade.tar;1;0;1;6.60 MB;6.60 MB
/releases/19.07.0-rc1/targets/pistachio/generic/openwrt-19.07.0-rc1-pistachio-marduk-squashfs-sysupgrade.tar;1;0;1;4.81 MB;4.81 MB
/releases/17.01.0-rc1/targets/sunxi/generic/lede-17.01.0-rc1-r3042-ec095b5-sunxi-sun7i-a20-bananapi-ext4-sdcard.img.gz;1;0;1;255.75 KB;255.75 KB
/releases/18.06.4/targets/x86/geode/openwrt-18.06.4-x86-geode-combined-ext4.img.gz;1;0;1;79.54 KB;79.54 KB
/releases/19.07.0-rc2/targets/armvirt/64/openwrt-19.07.0-rc2-armvirt-64-default-rootfs.tar.gz;1;0;1;2.04 MB;2.04 MB
/releases/19.07.0-rc1/targets/layerscape/armv7/openwrt-19.07.0-rc1-layerscape-armv7-ls1021atwr-sdboot-ext4-sdcard.img.gz;1;0;1;6.34 MB;6.34 MB
/releases/18.06.0-rc1/targets/x86/64/openwrt-18.06.0-rc1-x86-64-generic-rootfs.tar.gz;1;0;1;2.81 MB;2.81 MB
/releases/17.01.0-rc1/targets/sunxi/generic/lede-17.01.0-rc1-r3042-ec095b5-sunxi-sun7i-a20-olinuxino-lime-squashfs-sdcard.img.gz;1;0;1;79.75 KB;79.75 KB
/releases/18.06.0-rc2/targets/omap/generic/openwrt-18.06.0-rc2-omap-omap4-panda-ubifs-sdcard.img.gz;1;0;1;5.87 MB;5.87 MB
/releases/18.06.3/targets/octeontx/generic/openwrt-18.06.3-octeontx-default-rootfs.tar.gz;1;0;1;1.97 MB;1.97 MB
//releases/19.07.3/targets/rb532/generic/openwrt-19.07.3-rb532-default-rootfs.tar.gz;1;0;1;3.58 MB;3.58 MB
//snapshots/targets/at91/sama5d3/openwrt-at91-sama5d3-rootfs.tar.gz;1;0;1;1.61 MB;1.61 MB
/releases/18.06.7/targets/sunxi/cortexa7/openwrt-18.06.7-sunxi-cortexa7-sun7i-a20-olinuxino-lime2-emmc-ext4-sdcard.img.gz;1;0;1;1.28 MB;1.28 MB
/releases/19.07.0-rc2/targets/gemini/generic/openwrt-19.07.0-rc2-gemini-raidsonic_ib-4220-b-ext4-factory.bin.gz;1;0;1;8.22 MB;8.22 MB
/releases/19.07.0-rc1/targets/gemini/generic/openwrt-19.07.0-rc1-gemini-itian_sq201-ext4-factory.bin.gz;1;0;1;8.71 MB;8.71 MB
/releases/19.07.0-rc1/targets/brcm2708/bcm2710/openwrt-19.07.0-rc1-brcm2708-bcm2710-rpi-3-squashfs-sysupgrade.img.gz;1;0;1;10.92 MB;10.92 MB
/releases/18.06.0-rc2/targets/pistachio/generic/openwrt-18.06.0-rc2-pistachio-rootfs.tar.gz;1;0;1;1.93 MB;1.93 MB
/releases/17.01.6/targets/oxnas/generic/lede-17.01.6-oxnas-stg212-ubifs-sysupgrade.tar;1;0;1;159.75 KB;159.75 KB
/releases/18.06.3/targets/brcm63xx/smp/openwrt-18.06.3-brcm63xx-smp-livebox-vmlinux.gz;1;0;1;1.27 MB;1.27 MB
/releases/18.06.0-rc1/targets/x86/generic/openwrt-18.06.0-rc1-x86-generic-rootfs-ext4.img.gz;1;0;1;3.00 MB;3.00 MB
/snapshots/targets/scheduled_for_removal/ar71xx/nand/openwrt-ar71xx-nand-vmlinux.lzma;1;0;1;0;0
/releases/17.01.2/targets/ipq806x/generic/lede-17.01.2-ipq806x-R7800-squashfs-sysupgrade.tar;1;0;1;159.75 KB;159.75 KB
/releases/19.07.1/targets/armvirt/32/openwrt-19.07.1-armvirt-32-root.squashfs.gz;1;0;1;1.54 MB;1.54 MB
/releases/19.07-SNAPSHOT/targets/sunxi/cortexa8/openwrt-19.07-snapshot-r11228-78c4c04dd7-sunxi-cortexa8-sun4i-a10-olinuxino-lime-ext4-sdcard.img.gz;1;0;1;5.58 MB;5.58 MB
/releases/18.06.0-rc1/targets/sunxi/cortexa7/openwrt-18.06.0-rc1-sunxi-cortexa7-sun8i-h3-nanopi-m1-plus-ext4-sdcard.img.gz;1;0;1;6.49 MB;6.49 MB
/releases/19.07.0-rc2/targets/x86/legacy/openwrt-19.07.0-rc2-x86-legacy-rootfs-squashfs.img.gz;1;0;1;2.40 MB;2.40 MB
//snapshots/targets/sunxi/cortexa8/openwrt-sunxi-cortexa8-olimex_a13-olimex-som-ext4-sdcard.img.gz;1;0;1;6.83 MB;6.83 MB
/releases/19.07.0-rc1/targets/archs38/generic/openwrt-19.07.0-rc1-archs38-generic-Default-sdcard-vfat-ext4.img.gz;1;0;1;5.76 MB;5.76 MB
/snapshots/targets/scheduled_for_removal/ar71xx/mikrotik/kernel-debug.tar.bz2;1;0;1;0;0
/releases/18.06.7/targets/sunxi/cortexa7/openwrt-18.06.7-sunxi-cortexa7-sun8i-h3-nanopi-neo-ext4-sdcard.img.gz;1;0;1;1.28 MB;1.28 MB
/releases/19.07-SNAPSHOT/targets/ar71xx/tiny/openwrt-19.07-snapshot-r11228-78c4c04dd7-ar71xx-tiny-vmlinux.lzma;1;0;1;1.38 MB;1.38 MB
/releases/18.06.0-rc2/targets/sunxi/cortexa7/openwrt-18.06.0-rc2-sunxi-cortexa7-sun7i-a20-olinuxino-lime2-emmc-ext4-sdcard.img.gz;1;0;1;5.40 MB;5.40 MB
/releases/19.07.0-rc1/targets/brcm2708/bcm2710/openwrt-19.07.0-rc1-brcm2708-bcm2710-rpi-3-ext4-factory.img.gz;1;0;1;12.05 MB;12.05 MB
/releases/19.07.1/targets/pistachio/generic/openwrt-19.07.1-pistachio-marduk-squashfs-sysupgrade.tar;1;0;1;4.83 MB;4.83 MB
/releases/19.07.1/targets/mvebu/cortexa53/openwrt-19.07.1-mvebu-cortexa53-globalscale_espressobin-v7-emmc-ext4-sdcard.img.gz;1;0;1;6.39 MB;6.39 MB
/releases/17.01.6/targets/x86/geode/lede-17.01.6-x86-geode-combined-ext4.img.gz;1;0;1;79.75 KB;79.75 KB
/snapshots/targets/scheduled_for_removal/brcm2708/bcm2708/openwrt-brcm2708-bcm2708-rpi-ext4-factory.img.gz;1;0;1;0;0
/releases/18.06.7/targets/sunxi/cortexa7/openwrt-18.06.7-sunxi-cortexa7-sun8i-h3-orangepi-2-squashfs-sdcard.img.gz;1;0;1;1.28 MB;1.28 MB
/releases/faillogs-19.07/i386_pentium/packages/perl-parse-recdescent/host-compile.txt;1;0;1;958 Bytes;958 Bytes
/releases/19.07.0-rc1/targets/x86/legacy/openwrt-19.07.0-rc1-x86-legacy-combined-ext4.img.gz;1;0;1;6.94 MB;6.94 MB
/releases/17.01.1/targets/kirkwood/generic/lede-17.01.1-kirkwood-goflexhome-squashfs-sysupgrade.tar;1;0;1;175.75 KB;175.75 KB
/releases/19.07.1/targets/sunxi/cortexa7/openwrt-19.07.1-sunxi-cortexa7-sun7i-a20-pcduino3-squashfs-sdcard.img.gz;1;0;1;5.15 MB;5.15 MB
/releases/18.06.0-rc2/targets/x86/generic/openwrt-18.06.0-rc2-x86-generic-rootfs-squashfs.img.gz;1;0;1;2.29 MB;2.29 MB
/releases/19.07.0-rc2/targets/at91/sam9x/openwrt-19.07.0-rc2-at91-sam9x-ethernut5-ext4-root.ubi.gz;1;0;1;2.47 MB;2.47 MB
/releases/18.06.4/targets/sunxi/cortexa7/openwrt-18.06.4-sunxi-cortexa7-sun6i-a31-m9-squashfs-sdcard.img.gz;1;0;1;159.54 KB;159.54 KB
//snapshots/targets/sunxi/cortexa8/openwrt-sunxi-cortexa8-linksprite_a10-pcduino-squashfs-sdcard.img.gz;1;0;1;5.98 MB;5.98 MB
/releases/17.01.0-rc1/targets/x86/legacy/lede-17.01.0-rc1-r3042-ec095b5-x86-legacy-combined-ext4.img.gz;1;0;1;63.75 KB;63.75 KB
/releases/18.06.5/targets/ar71xx/nand/openwrt-18.06.5-ar71xx-nand-rambutan-squashfs-sysupgrade.tar;1;0;1;3.71 MB;3.71 MB
/releases/19.07.0-rc2/targets/rb532/generic/openwrt-19.07.0-rc2-rb532-default-rootfs.tar.gz;1;0;1;3.57 MB;3.57 MB
/releases/19.07.0-rc1/targets/oxnas/ox820/openwrt-19.07.0-rc1-oxnas-ox820-mitrastar_stg-212-ubifs-sysupgrade.tar;1;0;1;9.06 MB;9.06 MB
//snapshots/targets/rockchip/armv8/openwrt-rockchip-armv8-friendlyarm_nanopi-r2s-ext4-sysupgrade.img.gz;1;0;1;8.62 MB;8.62 MB
/releases/19.07.1/targets/mvebu/cortexa72/openwrt-19.07.1-mvebu-cortexa72-marvell_macchiatobin-ext4-sdcard.img.gz;1;0;1;6.41 MB;6.41 MB
/releases/19.07.0-rc2/targets/oxnas/ox820/openwrt-19.07.0-rc2-oxnas-ox820-cloudengines_pogoplug-series-3-squashfs-sysupgrade.tar;1;0;1;4.90 MB;4.90 MB
/releases/19.07.0-rc2/targets/mvebu/cortexa9/omnia-medkit-openwrt-19.07.0-rc2-mvebu-cortexa9-cznic_turris-omnia-initramfs.tar.gz;1;0;1;3.82 MB;3.82 MB
/releases/19.07.0-rc1/targets/sunxi/cortexa7/openwrt-19.07.0-rc1-sunxi-cortexa7-sun7i-a20-bananapro-squashfs-sdcard.img.gz;1;0;1;5.41 MB;5.41 MB
/releases/18.06.1/targets/octeon/generic/openwrt-18.06.1-octeon-er-squashfs-sysupgrade.tar;1;0;1;3.50 MB;3.50 MB
/releases/18.06.5/targets/octeon/generic/openwrt-18.06.5-octeon-er-squashfs-sysupgrade.tar;1;0;1;8.83 MB;8.83 MB
/releases/19.07.2/targets/layerscape/armv7/openwrt-19.07.2-layerscape-armv7-ls1021atwr-sdboot-ext4-sdcard.img.gz;1;0;1;5.08 MB;5.08 MB
/releases/17.01.0-rc2/targets/zynq/generic/lede-17.01.0-rc2-r3131-42f3c1f-zynq-zc702-uramdisk.image.gz;1;0;1;191.75 KB;191.75 KB
/releases/18.06.0-rc1/targets/x86/legacy/openwrt-18.06.0-rc1-x86-legacy-generic-rootfs.tar.gz;1;0;1;2.74 MB;2.74 MB
/releases/19.07.2/targets/sunxi/cortexa7/openwrt-19.07.2-sunxi-cortexa7-sun8i-h3-orangepi-one-ext4-sdcard.img.gz;1;0;1;5.60 MB;5.60 MB
/releases/19.07.1/targets/ar71xx/nand/openwrt-19.07.1-ar71xx-nand-r6100-squashfs-sysupgrade.tar;1;0;1;5.01 MB;5.01 MB
/releases/18.06.5/targets/ar71xx/nand/openwrt-18.06.5-ar71xx-nand-wi2a-ac200i-squashfs-sysupgrade.tar;1;0;1;4.00 MB;4.00 MB
/releases/18.06.0-rc1/targets/sunxi/cortexa7/openwrt-18.06.0-rc1-sunxi-cortexa7-sun7i-a20-cubietruck-squashfs-sdcard.img.gz;1;0;1;5.10 MB;5.10 MB
/releases/18.06.0-rc2/targets/sunxi/cortexa53/openwrt-18.06.0-rc2-sunxi-cortexa53-sun50i-a64-sopine-baseboard-squashfs-sdcard.img.gz;1;0;1;5.59 MB;5.59 MB
/releases/18.06.7/targets/brcm63xx/generic/openwrt-18.06.7-brcm63xx-generic-livebox-vmlinux.gz;1;0;1;1.94 MB;1.94 MB
/releases/18.06.0-rc1/targets/sunxi/cortexa8/openwrt-18.06.0-rc1-sunxi-cortexa8-sun4i-a10-pcduino-squashfs-sdcard.img.gz;1;0;1;4.73 MB;4.73 MB
/releases/18.06.3/targets/gemini/generic/openwrt-18.06.3-gemini-dns313-bootpart.tar.gz;1;0;1;1.30 MB;1.30 MB
/releases/18.06.7/targets/gemini/generic/openwrt-18.06.7-gemini-dns313-bootpart.tar.gz;1;0;1;2.24 MB;2.24 MB
/releases/18.06.7/targets/pistachio/generic/openwrt-18.06.7-pistachio-marduk-squashfs-sysupgrade.tar;1;0;1;4.75 MB;4.75 MB
/releases/18.06.5/targets/brcm63xx/smp/openwrt-18.06.5-brcm63xx-smp-livebox-vmlinux.gz;1;0;1;2.12 MB;2.12 MB
/releases/19.07.0-rc2/targets/at91/sam9x/openwrt-19.07.0-rc2-at91-sam9x-at91sam9x35ek-ext4-root.ubi.gz;1;0;1;2.47 MB;2.47 MB
/releases/18.06.7/targets/ar71xx/nand/openwrt-18.06.7-ar71xx-nand-z1-squashfs-sysupgrade.tar;1;0;1;6.70 MB;6.70 MB
/releases/19.07.0-rc2/targets/armvirt/64/openwrt-19.07.0-rc2-armvirt-64-root.ext4.gz;1;0;1;2.31 MB;2.31 MB
/releases/18.06.7/targets/sunxi/cortexa7/openwrt-18.06.7-sunxi-cortexa7-sun7i-a20-olinuxino-micro-squashfs-sdcard.img.gz;1;0;1;1.28 MB;1.28 MB
/releases/19.07.0-rc1/targets/at91/sam9x/openwrt-19.07.0-rc1-at91-sam9x-usb_a9263-ext4-factory.bin.gz;1;0;1;5.84 MB;5.84 MB
/releases/18.06.7/targets/sunxi/cortexa8/openwrt-18.06.7-sunxi-cortexa8-sun5i-a13-olimex-som-ext4-sdcard.img.gz;1;0;1;1.30 MB;1.30 MB
/snapshots/targets/scheduled_for_removal/adm5120/rb1xx/kernel-debug.tar.bz2;1;0;1;0;0
/releases/19.07.0-rc1/targets/at91/sam9x/openwrt-19.07.0-rc1-at91-sam9x-at91sam9g25ek-ext4-root.ubi.gz;1;0;1;2.47 MB;2.47 MB
/releases/19.07.2/targets/sunxi/cortexa7/openwrt-19.07.2-sunxi-cortexa7-sun7i-a20-lamobo-r1-squashfs-sdcard.img.gz;1;0;1;5.43 MB;5.43 MB
/releases/18.06.7/targets/sunxi/cortexa8/openwrt-18.06.7-sunxi-cortexa8-sun4i-a10-cubieboard-ext4-sdcard.img.gz;1;0;1;1.28 MB;1.28 MB
/releases/19.07-SNAPSHOT/targets/x86/generic/openwrt-19.07-snapshot-r11235-2a8279c161-x86-generic-combined-squashfs.img.gz;1;0;1;255.54 KB;255.54 KB
/releases/17.01.6/targets/oxnas/generic/lede-17.01.6-oxnas-kd20-squashfs-sysupgrade.tar;1;0;1;159.75 KB;159.75 KB
/releases/19.07.1/targets/mvebu/cortexa53/openwrt-19.07.1-mvebu-cortexa53-marvell_armada-3720-db-squashfs-sdcard.img.gz;1;0;1;5.56 MB;5.56 MB
/releases/18.06.6/targets/brcm2708/bcm2708/openwrt-18.06.6-brcm2708-bcm2708-rpi-squashfs-factory.img.gz;1;0;1;7.62 MB;7.62 MB
//snapshots/targets/mediatek/mt7623/openwrt-mediatek-mt7623-bpi_bananapi-r2-scatter.txt;1;0;1;1.47 KB;1.47 KB
/releases/18.06.4/targets/ramips/mt7621/openwrt-18.06.4-ramips-mt7621-r6220-squashfs-sysupgrade.tar;1;0;1;4.16 MB;4.16 MB
/releases/17.01.0-rc1/targets/imx6/generic/lede-17.01.0-rc1-r3042-ec095b5-imx6-ventana-squashfs-bootfs.tar.gz;1;0;1;127.75 KB;127.75 KB
/releases/18.06.0-rc2/targets/sunxi/cortexa7/openwrt-18.06.0-rc2-sunxi-cortexa7-sun7i-a20-cubieboard2-ext4-sdcard.img.gz;1;0;1;5.31 MB;5.31 MB
//releases/19.07.3/targets/sunxi/cortexa53/openwrt-19.07.3-sunxi-cortexa53-sun50i-h5-nanopi-neo-plus2-ext4-sdcard.img.gz;1;0;1;6.79 MB;6.79 MB
/releases/18.06.0-rc2/targets/sunxi/cortexa7/openwrt-18.06.0-rc2-sunxi-cortexa7-sun8i-h2-plus-orangepi-r1-squashfs-sdcard.img.gz;1;0;1;4.44 MB;4.44 MB
/releases/17.01.0-rc2/targets/imx6/generic/lede-17.01.0-rc2-r3131-42f3c1f-imx6-rootfs.tar.gz;1;0;1;271.75 KB;271.75 KB
/releases/17.01.5/targets/ipq806x/generic/lede-17.01.5-ipq806x-EA8500-squashfs-sysupgrade.tar;1;0;1;4.52 MB;4.52 MB
/releases/17.01.0/targets/ipq806x/generic/lede-17.01.0-r3205-59508e3-ipq806x-AP148-legacy-squashfs-nand-sysupgrade.tar;1;0;1;2.91 MB;2.91 MB
/snapshots/faillogs/mipsel_24kc/packages/nfs-kernel-server/host-compile.txt;1;0;1;33.08 KB;33.08 KB
/releases/18.06.7/targets/octeon/generic/openwrt-18.06.7-octeon-erlite-squashfs-sysupgrade.tar;1;0;1;8.84 MB;8.84 MB
/releases/17.01.0-rc1/targets/sunxi/generic/lede-17.01.0-rc1-r3042-ec095b5-sunxi-sun7i-a20-pcduino3-ext4-sdcard.img.gz;1;0;1;159.75 KB;159.75 KB
/releases/19.07.2/targets/mvebu/cortexa9/openwrt-19.07.2-mvebu-cortexa9-solidrun_clearfog-base-a1-squashfs-sdcard.img.gz;1;0;1;1.27 MB;1.27 MB
/releases/18.06.9/targets/sunxi/cortexa7/openwrt-18.06.9-sunxi-cortexa7-sun8i-h2-plus-orangepi-r1-squashfs-sdcard.img.gz;1;0;1;4.46 MB;4.46 MB
/releases/18.06.7/targets/sunxi/cortexa7/openwrt-18.06.7-sunxi-cortexa7-sun8i-h3-orangepi-2-ext4-sdcard.img.gz;1;0;1;1.28 MB;1.28 MB
/releases/19.07.0-rc2/targets/sunxi/cortexa53/openwrt-19.07.0-rc2-sunxi-cortexa53-sun50i-h5-orangepi-zero-plus-ext4-sdcard.img.gz;1;0;1;6.77 MB;6.77 MB
//snapshots/targets/at91/legacy/openwrt-at91-legacy-usb_a9263-ext4-factory.bin.gz;1;0;1;5.30 MB;5.30 MB
/releases/19.07.0-rc1/targets/at91/sam9x/openwrt-19.07.0-rc1-at91-sam9x-at91sam9g20ek-ext4-zImage.gz;1;0;1;3.34 MB;3.34 MB
/releases/18.06.4/targets/apm821xx/nand/openwrt-18.06.4-apm821xx-nand-meraki_mr24-squashfs-sysupgrade.tar;1;0;1;4.18 MB;4.18 MB
/releases/18.06.4/targets/sunxi/cortexa8/openwrt-18.06.4-sunxi-cortexa8-sun4i-a10-marsboard-ext4-sdcard.img.gz;1;0;1;79.54 KB;79.54 KB
/releases/19.07.1/targets/apm821xx/sata/openwrt-19.07.1-apm821xx-sata-wd_mybooklive-squashfs-sysupgrade.img.gz;1;0;1;5.41 MB;5.41 MB
/releases/19.07.0-rc1/targets/octeon/generic/openwrt-19.07.0-rc1-octeon-er-squashfs-sysupgrade.tar;1;0;1;8.83 MB;8.83 MB
/releases/19.07.0-rc2/targets/mvebu/cortexa9/openwrt-19.07.0-rc2-mvebu-cortexa9-solidrun_clearfog-base-a1-squashfs-sdcard.img.gz;1;0;1;4.71 MB;4.71 MB
/releases/19.07.1/targets/armvirt/32/openwrt-19.07.1-armvirt-32-default-rootfs.tar.gz;1;0;1;1.96 MB;1.96 MB
/releases/19.07.1/targets/sunxi/cortexa53/openwrt-19.07.1-sunxi-cortexa53-sun50i-h5-nanopi-neo-plus2-ext4-sdcard.img.gz;1;0;1;6.78 MB;6.78 MB
/releases/19.07.0-rc1/targets/mvebu/cortexa72/openwrt-19.07.0-rc1-mvebu-cortexa72-marvell_macchiatobin-ext4-sdcard.img.gz;1;0;1;6.40 MB;6.40 MB
/releases/19.07.0-rc1/targets/sunxi/cortexa7/openwrt-19.07.0-rc1-sunxi-cortexa7-sun7i-a20-olinuxino-lime2-emmc-ext4-sdcard.img.gz;1;0;1;5.73 MB;5.73 MB
/releases/19.07.0-rc1/targets/armvirt/64/openwrt-19.07.0-rc1-armvirt-64-root.squashfs.gz;1;0;1;1.64 MB;1.64 MB
/releases/18.06.6/targets/armvirt/32/openwrt-18.06.6-armvirt-32-rootfs.cpio.gz;1;0;1;20 Bytes;20 Bytes
/releases/17.01.7/targets/sunxi/generic/lede-17.01.7-sunxi-sun7i-a20-olinuxino-lime-ext4-sdcard.img.gz;1;0;1;159.75 KB;159.75 KB
/releases/18.06.0-rc1/targets/sunxi/cortexa7/openwrt-18.06.0-rc1-sunxi-cortexa7-sun8i-h3-orangepi-plus-ext4-sdcard.img.gz;1;0;1;5.25 MB;5.25 MB
/releases/19.07.0-rc1/targets/sunxi/cortexa7/openwrt-19.07.0-rc1-sunxi-cortexa7-sun8i-h3-orangepi-pc-squashfs-sdcard.img.gz;1;0;1;4.76 MB;4.76 MB
/releases/19.07.0-rc2/targets/layerscape/armv8_64b/openwrt-19.07.0-rc2-layerscape-armv8_64b-ls1012afrwy-ext4-sdcard.img.gz;1;0;1;8.03 MB;8.03 MB
/releases/19.07.0-rc2/targets/sunxi/cortexa8/openwrt-19.07.0-rc2-sunxi-cortexa8-sun4i-a10-pcduino-ext4-sdcard.img.gz;1;0;1;6.06 MB;6.06 MB
/releases/18.06.7/targets/apm821xx/nand/openwrt-18.06.7-apm821xx-nand-meraki_mx60-squashfs-sysupgrade.tar;1;0;1;5.07 MB;5.07 MB
//snapshots/targets/sunxi/cortexa7/openwrt-sunxi-cortexa7-olimex_a20-olinuxino-micro-ext4-sdcard.img.gz;1;0;1;6.32 MB;6.32 MB
/releases/19.07.0-rc2/targets/armvirt/64/openwrt-19.07.0-rc2-armvirt-64-root.squashfs.gz;1;0;1;1.64 MB;1.64 MB
/releases/18.06.0-rc2/targets/sunxi/cortexa7/openwrt-18.06.0-rc2-sunxi-cortexa7-sun6i-a31-m9-ext4-sdcard.img.gz;1;0;1;5.75 MB;5.75 MB
/releases/18.06.4/targets/x86/legacy/openwrt-18.06.4-x86-legacy-rootfs-ext4.img.gz;1;0;1;207.54 KB;207.54 KB
/releases/19.07.0-rc2/targets/oxnas/ox820/openwrt-19.07.0-rc2-oxnas-ox820-mitrastar_stg-212-squashfs-sysupgrade.tar;1;0;1;5.46 MB;5.46 MB
/snapshots/faillogs/mipsel_24kc/packages/perl-parse-recdescent/host-compile.txt;1;0;1;429 Bytes;429 Bytes
//snapshots/targets/sunxi/cortexa8/openwrt-sunxi-cortexa8-marsboard_a10-marsboard-squashfs-sdcard.img.gz;1;0;1;5.56 MB;5.56 MB
/releases/19.07.0-rc1/targets/layerscape/armv8_64b/openwrt-19.07.0-rc1-layerscape-armv8_64b-ls1046ardb-sdboot-ext4-sdcard.img.gz;1;0;1;8.35 MB;8.35 MB
/releases/19.07.0-rc1/targets/sunxi/cortexa7/openwrt-19.07.0-rc1-sunxi-cortexa7-sun7i-a20-lamobo-r1-squashfs-sdcard.img.gz;1;0;1;5.41 MB;5.41 MB
/releases/18.06.7/targets/sunxi/cortexa7/openwrt-18.06.7-sunxi-cortexa7-sun7i-a20-olinuxino-lime-ext4-sdcard.img.gz;1;0;1;1.28 MB;1.28 MB
/releases/17.01.0/targets/brcm2708/bcm2708/lede-17.01.0-r3205-59508e3-brcm2708-bcm2708-rpi-ext4-sdcard.img.gz;1;0;1;6.63 MB;6.63 MB
/releases/17.01-SNAPSHOT/targets/ar71xx/mikrotik/lede-17.01-snapshot-r4046-beaa2ec-ar71xx-mikrotik-vmlinux.lzma;1;0;1;319.75 KB;319.75 KB
/releases/18.06.5/targets/brcm2708/bcm2709/openwrt-18.06.5-brcm2708-bcm2709-rpi-2-squashfs-factory.img.gz;1;0;1;7.77 MB;7.77 MB
/releases/18.06.6/targets/apm821xx/nand/openwrt-18.06.6-apm821xx-nand-netgear_wndr4700-squashfs-sysupgrade.tar;1;0;1;5.22 MB;5.22 MB
/releases/19.07.1/targets/ar71xx/nand/openwrt-19.07.1-ar71xx-nand-nbg6716-squashfs-sysupgrade.tar;1;0;1;4.76 MB;4.76 MB
/releases/17.01-SNAPSHOT/targets/gemini/raidsonic/lede-17.01-snapshot-r4046-beaa2ec-gemini-raidsonic-sysupgrade-ib4220.tar.gz;1;0;1;143.75 KB;143.75 KB
/releases/19.07.0-rc1/targets/octeontx/generic/openwrt-19.07.0-rc1-octeontx-default-rootfs.tar.gz;1;0;1;2.04 MB;2.04 MB
/releases/19.07.0/targets/ar71xx/nand/openwrt-19.07.0-ar71xx-nand-c-60-squashfs-sysupgrade.tar;1;0;1;4.06 MB;4.06 MB
/releases/17.01.0/targets/ipq806x/generic/lede-17.01.0-r3205-59508e3-ipq806x-AP148-ubifs-nand-sysupgrade.tar;1;0;1;2.80 MB;2.80 MB
/releases/18.06.7/targets/armvirt/64/openwrt-18.06.7-armvirt-64-default-rootfs.tar.gz;1;0;1;1.97 MB;1.97 MB
/releases/19.07.1/targets/mvebu/cortexa53/openwrt-19.07.1-mvebu-cortexa53-globalscale_espressobin-v7-squashfs-sdcard.img.gz;1;0;1;5.56 MB;5.56 MB
/releases/19.07.1/targets/mvebu/cortexa9/omnia-medkit-openwrt-19.07.1-mvebu-cortexa9-cznic_turris-omnia-initramfs.tar.gz;1;0;1;3.83 MB;3.83 MB
/snapshots/targets/scheduled_for_removal/ar71xx/tiny/kernel-debug.tar.bz2;1;0;1;0;0
/releases/17.01-SNAPSHOT/targets/sunxi/generic/lede-17.01-snapshot-r4046-beaa2ec-sunxi-sun7i-a20-lamobo-r1-squashfs-sdcard.img.gz;1;0;1;287.75 KB;287.75 KB
/releases/17.01.6/targets/zynq/generic/lede-17.01.6-zynq-rootfs.tar.gz;1;0;1;143.75 KB;143.75 KB
/releases/18.06.4/targets/armvirt/32/openwrt-18.06.4-armvirt-32-root.ext4.gz;1;0;1;2.12 MB;2.12 MB
/releases/19.07.2/targets/layerscape/armv7/openwrt-19.07.2-layerscape-armv7-ls1021aiot-sdboot-ext4-sdcard.img.gz;1;0;1;6.28 MB;6.28 MB
/releases/18.06.0-rc1/targets/x86/geode/openwrt-18.06.0-rc1-x86-geode-rootfs-ext4.img.gz;1;0;1;4.51 MB;4.51 MB
//snapshots/targets/mediatek/mt7623/openwrt-mediatek-mt7623-unielec_u7623-02-emmc-512m-legacy-squashfs-sysupgrade-emmc.bin.gz;1;0;1;5.24 MB;5.24 MB
/releases/18.06.4/targets/sunxi/cortexa7/openwrt-18.06.4-sunxi-cortexa7-sun8i-h3-nanopi-neo-squashfs-sdcard.img.gz;1;0;1;175.54 KB;175.54 KB
/releases/17.01.0/targets/ipq806x/generic/lede-17.01.0-r3205-59508e3-ipq806x-R7800-squashfs-sysupgrade.tar;1;0;1;3.11 MB;3.11 MB
/releases/19.07.0-rc2/targets/sunxi/cortexa8/openwrt-19.07.0-rc2-sunxi-cortexa8-sun5i-a13-olinuxino-squashfs-sdcard.img.gz;1;0;1;5.10 MB;5.10 MB
/releases/18.06.0-rc1/targets/sunxi/cortexa7/openwrt-18.06.0-rc1-sunxi-cortexa7-sun7i-a20-bananapi-ext4-sdcard.img.gz;1;0;1;5.30 MB;5.30 MB
/releases/17.01.2/targets/ipq806x/generic/lede-17.01.2-ipq806x-EA8500-squashfs-sysupgrade.tar;1;0;1;271.75 KB;271.75 KB
/releases/17.01.6/targets/sunxi/generic/lede-17.01.6-sunxi-sun7i-a20-cubietruck-squashfs-sdcard.img.gz;1;0;1;143.75 KB;143.75 KB
/releases/19.07.0-rc1/targets/sunxi/cortexa7/openwrt-19.07.0-rc1-sunxi-cortexa7-sun7i-a20-olinuxino-lime2-ext4-sdcard.img.gz;1;0;1;5.73 MB;5.73 MB
/releases/19.07.0-rc2/targets/omap/generic/openwrt-19.07.0-rc2-omap-ti_omap4-panda-ext4-sdcard.img.gz;1;0;1;6.54 MB;6.54 MB
/releases/19.07.0-rc1/targets/sunxi/cortexa7/openwrt-19.07.0-rc1-sunxi-cortexa7-sun7i-a20-lamobo-r1-ext4-sdcard.img.gz;1;0;1;6.47 MB;6.47 MB
/releases/19.07.2/targets/ar71xx/nand/openwrt-19.07.2-ar71xx-nand-nbg6716-squashfs-sysupgrade.tar;1;0;1;1.73 MB;1.73 MB
/releases/18.06.2/targets/pistachio/generic/openwrt-18.06.2-pistachio-rootfs.tar.gz;1;0;1;1.72 MB;1.72 MB
/releases/18.06.7/targets/sunxi/cortexa7/openwrt-18.06.7-sunxi-cortexa7-sun7i-a20-bananapro-ext4-sdcard.img.gz;1;0;1;1.27 MB;1.27 MB
/releases/19.07.2/targets/layerscape/armv8_64b/openwrt-19.07.2-layerscape-armv8_64b-ls1012afrwy-ext4-firmware.bin.gz;1;0;1;304.60 KB;304.60 KB
/releases/19.07.0-rc2/targets/at91/sama5/openwrt-19.07.0-rc2-at91-sama5-at91-sama5d3_xplained-ext4-zImage.gz;1;0;1;3.31 MB;3.31 MB
/releases/18.06.3/targets/pistachio/generic/openwrt-18.06.3-pistachio-rootfs.tar.gz;1;0;1;1.93 MB;1.93 MB
/releases/19.07.1/targets/sunxi/cortexa7/openwrt-19.07.1-sunxi-cortexa7-sun7i-a20-bananapi-squashfs-sdcard.img.gz;1;0;1;4.80 MB;4.80 MB
/releases/18.06.0/targets/pistachio/generic/openwrt-18.06.0-pistachio-marduk-squashfs-sysupgrade.tar;1;0;1;4.70 MB;4.70 MB
/releases/19.07.0-rc2/targets/armvirt/32/openwrt-19.07.0-rc2-armvirt-32-rootfs.cpio.gz;1;0;1;20 Bytes;20 Bytes
/releases/18.06.0-rc1/targets/at91/sama5d2/openwrt-18.06.0-rc1-at91-sama5d2-at91-sama5d27_som1_ek-ext4-zImage.gz;1;0;1;3.03 MB;3.03 MB
/releases/19.07.1/targets/layerscape/armv8_64b/openwrt-19.07.1-layerscape-armv8_64b-ls1043ardb-sdboot-ext4-sdcard.img.gz;1;0;1;8.37 MB;8.37 MB
/releases/18.06.4/targets/ar71xx/nand/openwrt-18.06.4-ar71xx-nand-rambutan-squashfs-sysupgrade.tar;1;0;1;3.70 MB;3.70 MB
/releases/17.01.7/targets/ar71xx/nand/lede-17.01.7-ar71xx-nand-nbg6716-squashfs-sysupgrade.tar;1;0;1;79.75 KB;79.75 KB
/releases/19.07.0-rc1/targets/brcm2708/bcm2708/openwrt-19.07.0-rc1-brcm2708-bcm2708-rpi-ext4-factory.img.gz;1;0;1;11.48 MB;11.48 MB
/releases/18.06.0-rc1/targets/at91/sama5d2/openwrt-18.06.0-rc1-at91-sama5d2-at91-sama5d27_som1_ek-ext4-sdcard.img.gz;1;0;1;5.53 MB;5.53 MB
/releases/17.01.0-rc1/targets/sunxi/generic/lede-17.01.0-rc1-r3042-ec095b5-sunxi-sun4i-a10-pcduino-ext4-sdcard.img.gz;1;0;1;271.75 KB;271.75 KB
//snapshots/targets/rockchip/armv8/openwrt-rockchip-armv8-pine64_rockpro64-squashfs-sysupgrade.img.gz;1;0;1;7.92 MB;7.92 MB
/releases/19.07.0-rc1/targets/mvebu/cortexa53/openwrt-19.07.0-rc1-mvebu-cortexa53-globalscale_espressobin-v7-emmc-ext4-sdcard.img.gz;1;0;1;6.37 MB;6.37 MB
//releases/19.07.3/targets/zynq/generic/openwrt-19.07.3-zynq-avnet_zynq-zed-squashfs-sdcard.img.gz;1;0;1;5.86 MB;5.86 MB
/releases/17.01.7/targets/x86/legacy/lede-17.01.7-x86-legacy-generic-rootfs.tar.gz;1;0;1;159.75 KB;159.75 KB
/releases/18.06.0-rc1/targets/archs38/generic/openwrt-18.06.0-rc1-archs38-generic-root.ext4.gz;1;0;1;2.81 MB;2.81 MB
//snapshots/targets/at91/sama5/openwrt-at91-sama5-microchip_sama5d3-xplained-ext4-sdcard.img.gz;1;0;1;6.88 MB;6.88 MB
/releases/19.07.0-rc2/targets/omap/generic/openwrt-19.07.0-rc2-omap-ti_am335x-bone-black-ext4-sdcard.img.gz;1;0;1;6.58 MB;6.58 MB
/releases/18.06-SNAPSHOT/targets/sunxi/cortexa53/openwrt-18.06-snapshot-r8073-5625f5bc36-sunxi-cortexa53-sun50i-h5-orangepi-zero-plus-squashfs-sdcard.img.gz;1;0;1;5.63 MB;5.63 MB
//snapshots/targets/at91/sama5d4/openwrt-at91-sama5d4-rootfs.tar.gz;1;0;1;1.61 MB;1.61 MB
/releases/17.01.0-rc1/targets/armvirt/generic/lede-17.01.0-rc1-r3042-ec095b5-armvirt-root.squashfs.gz;1;0;1;255.75 KB;255.75 KB
/snapshots/faillogs/mips_4kec/packages/perl-inline/host-compile.txt;1;0;1;391 Bytes;391 Bytes
/releases/18.06.0-rc1/targets/omap/generic/openwrt-18.06.0-rc1-omap-am335x-evm-ubifs-sdcard.img.gz;1;0;1;5.97 MB;5.97 MB
/releases/18.06.0-rc2/targets/sunxi/cortexa8/openwrt-18.06.0-rc2-sunxi-cortexa8-sun4i-a10-olinuxino-lime-ext4-sdcard.img.gz;1;0;1;5.24 MB;5.24 MB
/releases/18.06.0/targets/brcm2708/bcm2710/openwrt-18.06.0-brcm2708-bcm2710-rpi-3-squashfs-factory.img.gz;1;0;1;7.77 MB;7.77 MB
/releases/17.01-SNAPSHOT/targets/brcm2708/bcm2708/lede-17.01-snapshot-r4046-beaa2ec-brcm2708-bcm2708-rpi-ext4-sdcard.img.gz;1;0;1;175.75 KB;175.75 KB
/releases/18.06.9/targets/ath25/generic/openwrt-18.06.9-ath25-generic-kernel.lzma;1;0;1;287.54 KB;287.54 KB
/releases/18.06.0-rc2/targets/archs38/generic/openwrt-18.06.0-rc2-archs38-generic-Default-sdcard-vfat-ext4.img.gz;1;0;1;5.89 MB;5.89 MB
/releases/19.07.0-rc2/targets/brcm2708/bcm2708/openwrt-19.07.0-rc2-brcm2708-bcm2708-rpi-ext4-factory.img.gz;1;0;1;11.49 MB;11.49 MB
/releases/17.01.0-rc1/targets/x86/generic/lede-17.01.0-rc1-r3042-ec095b5-x86-generic-generic-rootfs.tar.gz;1;0;1;63.75 KB;63.75 KB
/releases/17.01.4/targets/mvebu/generic/lede-17.01.4-mvebu-armada-388-clearfog-sdcard.img.gz;1;0;1;143.75 KB;143.75 KB
/releases/19.07.1/targets/brcm2708/bcm2708/openwrt-19.07.1-brcm2708-bcm2708-rpi-squashfs-factory.img.gz;1;0;1;10.34 MB;10.34 MB
/releases/17.01.6/targets/oxnas/generic/lede-17.01.6-oxnas-akitio-squashfs-sysupgrade.tar;1;0;1;159.75 KB;159.75 KB
/releases/19.07.1/targets/armvirt/64/openwrt-19.07.1-armvirt-64-default-rootfs.tar.gz;1;0;1;2.05 MB;2.05 MB
/releases/18.06.1/targets/arc770/generic/openwrt-18.06.1-arc770-generic-root.ext4.gz;1;0;1;2.68 MB;2.68 MB
/releases/17.01.0-rc2/targets/ipq806x/generic/lede-17.01.0-rc2-r3131-42f3c1f-ipq806x-D7800-squashfs-sysupgrade.tar;1;0;1;63.75 KB;63.75 KB
//snapshots/targets/layerscape/armv8_32b/kernel-debug.tar.bz2;1;0;1;70.63 MB;70.63 MB
/releases/19.07.0-rc2/targets/at91/sama5/openwrt-19.07.0-rc2-at91-sama5-at91-sama5d2_xplained-ext4-zImage.gz;1;0;1;3.31 MB;3.31 MB
/releases/18.06.0-rc2/targets/sunxi/cortexa7/openwrt-18.06.0-rc2-sunxi-cortexa7-sun7i-a20-bananapi-ext4-sdcard.img.gz;1;0;1;5.31 MB;5.31 MB
/releases/18.06.0-rc2/targets/mxs/generic/openwrt-18.06.0-rc2-mxs-root.ext4.gz;1;0;1;5.22 MB;5.22 MB
/releases/19.07.1/targets/gemini/generic/openwrt-19.07.1-gemini-dlink_dir-685-ext4-factory.bin.gz;1;0;1;9.02 MB;9.02 MB
/releases/18.06.0-rc1/targets/omap/generic/openwrt-18.06.0-rc1-omap-rootfs.tar.gz;1;0;1;1.93 MB;1.93 MB
/releases/17.01.7/targets/sunxi/generic/lede-17.01.7-sunxi-sun6i-a31-m9-squashfs-sdcard.img.gz;1;0;1;143.75 KB;143.75 KB
/releases/18.06.0-rc2/targets/sunxi/cortexa53/openwrt-18.06.0-rc2-sunxi-cortexa53-sun50i-h5-orangepi-zero-plus-ext4-sdcard.img.gz;1;0;1;6.36 MB;6.36 MB
//releases/19.07.3/targets/brcm2708/bcm2710/openwrt-19.07.3-brcm2708-bcm2710-rpi-3-squashfs-factory.img.gz;1;0;1;10.94 MB;10.94 MB
/releases/17.01.0/targets/x86/legacy/lede-17.01.0-r3205-59508e3-x86-legacy-rootfs-ext4.img.gz;1;0;1;159.75 KB;159.75 KB
/releases/17.01.0-rc2/targets/zynq/generic/lede-17.01.0-rc2-r3131-42f3c1f-zynq-rootfs.tar.gz;1;0;1;271.75 KB;271.75 KB
//snapshots/targets/bcm27xx/bcm2710/openwrt-bcm27xx-bcm2710-rpi-3-ext4-sysupgrade.img.gz;1;0;1;14.49 MB;14.49 MB
/releases/18.06.0-rc2/targets/rb532/generic/openwrt-18.06.0-rc2-rb532-default-rootfs.tar.gz;1;0;1;3.40 MB;3.40 MB
//snapshots/targets/apm821xx/sata/openwrt-apm821xx-sata-wd_mybooklive-squashfs-factory.img.gz;1;0;1;6.86 MB;6.86 MB
/releases/17.01.4/targets/ipq806x/generic/lede-17.01.4-ipq806x-AP148-legacy-ubifs-nand-sysupgrade.tar;1;0;1;2.69 MB;2.69 MB
/releases/17.01.7/targets/oxnas/generic/lede-17.01.7-oxnas-pogoplug-v3-squashfs-sysupgrade.tar;1;0;1;159.75 KB;159.75 KB
/releases/17.01.6/targets/ar71xx/nand/lede-17.01.6-ar71xx-nand-mr18-squashfs-sysupgrade.tar;1;0;1;159.75 KB;159.75 KB
//snapshots/targets/sunxi/cortexa7/openwrt-sunxi-cortexa7-cubietech_cubietruck-ext4-sdcard.img.gz;1;0;1;7.14 MB;7.14 MB
/releases/18.06.0-rc2/targets/armvirt/32/openwrt-18.06.0-rc2-armvirt-32-root.squashfs.gz;1;0;1;1.44 MB;1.44 MB
/releases/19.07.0-rc2/targets/sunxi/cortexa53/openwrt-19.07.0-rc2-sunxi-cortexa53-sun50i-a64-pine64-plus-ext4-sdcard.img.gz;1;0;1;6.77 MB;6.77 MB
/snapshots/targets/scheduled_for_removal/brcm2708/bcm2709/openwrt-brcm2708-bcm2709-rpi-2-squashfs-sysupgrade.img.gz;1;0;1;0;0
/releases/18.06.9/targets/x86/geode/openwrt-18.06.9-x86-geode-combined-squashfs.img.gz;1;0;1;6.21 MB;6.21 MB
/releases/18.06.5/targets/octeon/generic/openwrt-18.06.5-octeon-erlite-squashfs-sysupgrade.tar;1;0;1;8.83 MB;8.83 MB
/releases/18.06.1/targets/archs38/generic/openwrt-18.06.1-archs38-generic-root.ext4.gz;1;0;1;2.81 MB;2.81 MB
/releases/18.06.0-rc1/targets/at91/sama5d2/openwrt-18.06.0-rc1-at91-sama5d2-at91-sama5d2_ptc_ek-ext4-sdcard.img.gz;1;0;1;5.54 MB;5.54 MB
/releases/18.06.9/targets/x86/generic/openwrt-18.06.9-x86-generic-combined-ext4.img.gz;1;0;1;7.64 MB;7.64 MB
/releases/17.01-SNAPSHOT/targets/sunxi/generic/lede-17.01-snapshot-r4046-beaa2ec-sunxi-sun7i-a20-olinuxino-micro-ext4-sdcard.img.gz;1;0;1;191.75 KB;191.75 KB
/releases/17.01.0-rc1/targets/armvirt/generic/lede-17.01.0-rc1-r3042-ec095b5-armvirt-default-rootfs.tar.gz;1;0;1;191.75 KB;191.75 KB
//snapshots/targets/sunxi/cortexa7/openwrt-sunxi-cortexa7-friendlyarm_nanopi-neo-air-ext4-sdcard.img.gz;1;0;1;7.70 MB;7.70 MB
//snapshots/targets/at91/legacy/openwrt-at91-legacy-tny_a9263-ext4-factory.bin.gz;1;0;1;5.30 MB;5.30 MB
/releases/18.06.5/targets/ar71xx/nand/openwrt-18.06.5-ar71xx-nand-hiveap-121-squashfs-sysupgrade.tar;1;0;1;3.72 MB;3.72 MB
/releases/19.07.0-rc1/targets/at91/sama5/openwrt-19.07.0-rc1-at91-sama5-at91-sama5d2_xplained-ext4-root.ubi.gz;1;0;1;2.45 MB;2.45 MB
/releases/18.06.0-rc1/targets/sunxi/cortexa7/openwrt-18.06.0-rc1-sunxi-cortexa7-sun7i-a20-bananapro-ext4-sdcard.img.gz;1;0;1;6.04 MB;6.04 MB
/releases/17.01.6/targets/sunxi/generic/lede-17.01.6-sunxi-sun6i-a31-m9-squashfs-sdcard.img.gz;1;0;1;159.75 KB;159.75 KB
//releases/19.07.3/targets/brcm2708/bcm2710/openwrt-19.07.3-brcm2708-bcm2710-rpi-3-ext4-sysupgrade.img.gz;1;0;1;12.08 MB;12.08 MB
/snapshots/targets/scheduled_for_removal/xburst/qi_lb60/kernel-debug.tar.bz2;1;0;1;0;0
/releases/17.01.7/targets/sunxi/generic/lede-17.01.7-sunxi-sun5i-a13-olinuxino-ext4-sdcard.img.gz;1;0;1;159.75 KB;159.75 KB
/releases/17.01.6/targets/sunxi/generic/lede-17.01.6-sunxi-sun7i-a20-cubieboard2-squashfs-sdcard.img.gz;1;0;1;159.75 KB;159.75 KB
/releases/17.01.0-rc1/targets/sunxi/generic/lede-17.01.0-rc1-r3042-ec095b5-sunxi-sun5i-a13-olinuxino-squashfs-sdcard.img.gz;1;0;1;319.75 KB;319.75 KB
/releases/17.01.0-rc1/targets/gemini/raidsonic/lede-17.01.0-rc1-r3042-ec095b5-gemini-raidsonic-sysupgrade-ib4220.tar.gz;1;0;1;63.75 KB;63.75 KB
/releases/17.01.6/targets/mxs/generic/lede-17.01.6-mxs-root.ext4.gz;1;0;1;255.75 KB;255.75 KB
/releases/18.06-SNAPSHOT/targets/brcm2708/bcm2709/openwrt-18.06-snapshot-r8079-0e25552dd8-brcm2708-bcm2709-rpi-2-squashfs-factory.img.gz;1;0;1;7.78 MB;7.78 MB
//snapshots/targets/mvebu/cortexa72/openwrt-mvebu-cortexa72-marvell_armada8040-db-squashfs-sdcard.img.gz;1;0;1;6.94 MB;6.94 MB
//snapshots/targets/sunxi/cortexa7/openwrt-sunxi-cortexa7-sinovoip_bananapi-m2-plus-ext4-sdcard.img.gz;1;0;1;7.73 MB;7.73 MB
/releases/19.07.2/targets/ar71xx/nand/openwrt-19.07.2-ar71xx-nand-wndr3700v4-squashfs-sysupgrade.tar;1;0;1;4.51 MB;4.51 MB
/releases/19.07-SNAPSHOT/targets/sunxi/cortexa8/openwrt-19.07-snapshot-r11228-78c4c04dd7-sunxi-cortexa8-sun4i-a10-olinuxino-lime-squashfs-sdcard.img.gz;1;0;1;4.73 MB;4.73 MB
/releases/17.01.0-rc2/targets/zynq/generic/lede-17.01.0-rc2-r3131-42f3c1f-zynq-zed-uramdisk.image.gz;1;0;1;223.75 KB;223.75 KB
/releases/17.01.0-rc2/targets/sunxi/generic/lede-17.01.0-rc2-r3131-42f3c1f-sunxi-sun4i-a10-olinuxino-lime-squashfs-sdcard.img.gz;1;0;1;127.75 KB;127.75 KB
/releases/18.06.0-rc2/targets/mvebu/cortexa9/openwrt-18.06.0-rc2-mvebu-cortexa9-armada-388-clearfog-base-squashfs-sdcard.img.gz;1;0;1;4.50 MB;4.50 MB
/releases/19.07.0-rc2/targets/omap/generic/openwrt-19.07.0-rc2-omap-ti_am335x-evm-squashfs-sdcard.img.gz;1;0;1;5.78 MB;5.78 MB
/releases/18.06.7/targets/brcm63xx/smp/openwrt-18.06.7-brcm63xx-smp-livebox-vmlinux.gz;1;0;1;2.06 MB;2.06 MB
/releases/18.06-SNAPSHOT/targets/at91/legacy/openwrt-18.06-snapshot-r8080-9f2a40c72f-at91-legacy-wb45n-ext4-root.ubi.gz;1;0;1;3.57 MB;3.57 MB
/releases/18.06.0-rc1/targets/sunxi/cortexa53/openwrt-18.06.0-rc1-sunxi-cortexa53-sun50i-h5-orangepi-zero-plus-ext4-sdcard.img.gz;1;0;1;6.36 MB;6.36 MB
//snapshots/targets/bcm27xx/bcm2710/openwrt-bcm27xx-bcm2710-rpi-3-squashfs-factory.img.gz;1;0;1;13.14 MB;13.14 MB
/releases/17.01-SNAPSHOT/targets/sunxi/generic/lede-17.01-snapshot-r4046-beaa2ec-sunxi-sun7i-a20-olinuxino-lime-squashfs-sdcard.img.gz;1;0;1;239.75 KB;239.75 KB
/releases/18.06.4/targets/x86/geode/openwrt-18.06.4-x86-geode-combined-squashfs.img.gz;1;0;1;287.54 KB;287.54 KB
/releases/18.06.7/targets/ar71xx/nand/openwrt-18.06.7-ar71xx-nand-nbg6716-squashfs-sysupgrade.tar;1;0;1;4.76 MB;4.76 MB
/releases/18.06.7/targets/sunxi/cortexa7/openwrt-18.06.7-sunxi-cortexa7-sun7i-a20-cubietruck-squashfs-sdcard.img.gz;1;0;1;1.31 MB;1.31 MB
/releases/18.06.0/targets/octeon/generic/openwrt-18.06.0-octeon-er-squashfs-sysupgrade.tar;1;0;1;8.75 MB;8.75 MB
/releases/19.07.1/targets/sunxi/cortexa7/openwrt-19.07.1-sunxi-cortexa7-sun8i-h3-orangepi-pc-plus-squashfs-sdcard.img.gz;1;0;1;4.77 MB;4.77 MB
/releases/19.07.4/packages/aarch64_cortex-a53/base/Packages.gz;1;0;1;50.76 KB;50.76 KB
/releases/18.06.0/targets/archs38/generic/openwrt-18.06.0-archs38-generic-root.ext4.gz;1;0;1;2.81 MB;2.81 MB
/releases/19.07.1/targets/layerscape/armv8_64b/openwrt-19.07.1-layerscape-armv8_64b-ls1088ardb-sdboot-ext4-sdcard.img.gz;1;0;1;8.81 MB;8.81 MB
/releases/19.07.2/targets/sunxi/cortexa7/openwrt-19.07.2-sunxi-cortexa7-sun7i-a20-olinuxino-lime2-emmc-ext4-sdcard.img.gz;1;0;1;5.74 MB;5.74 MB
/snapshots/targets/scheduled_for_removal/brcm2708/bcm2711/openwrt-brcm2708-bcm2711-rpi-4-ext4-sysupgrade.img.gz;1;0;1;0;0
//snapshots/targets/at91/legacy/openwrt-at91-legacy-wb45n-ext4-root.ubi.gz;1;0;1;3.21 MB;3.21 MB
/releases/18.06.3/targets/ramips/mt7621/openwrt-18.06.3-ramips-mt7621-mir3g-squashfs-sysupgrade.tar;1;0;1;4.17 MB;4.17 MB
/releases/19.07.0-rc2/targets/sunxi/cortexa53/openwrt-19.07.0-rc2-sunxi-cortexa53-sun50i-a64-sopine-baseboard-ext4-sdcard.img.gz;1;0;1;6.77 MB;6.77 MB
/releases/19.07.0-rc2/targets/layerscape/armv7/openwrt-19.07.0-rc2-layerscape-armv7-ls1021atwr-sdboot-ext4-sdcard.img.gz;1;0;1;6.34 MB;6.34 MB
/releases/17.01.7/targets/oxnas/generic/lede-17.01.7-oxnas-kd20-factory.tar.gz;1;0;1;143.75 KB;143.75 KB
/releases/18.06.4/targets/sunxi/cortexa7/openwrt-18.06.4-sunxi-cortexa7-sun7i-a20-olinuxino-lime2-emmc-squashfs-sdcard.img.gz;1;0;1;143.54 KB;143.54 KB
/releases/19.07.0-rc2/targets/apm821xx/sata/openwrt-19.07.0-rc2-apm821xx-sata-wd_mybooklive-squashfs-factory.img.gz;1;0;1;5.40 MB;5.40 MB
/releases/18.06.0-rc1/targets/sunxi/cortexa8/openwrt-18.06.0-rc1-sunxi-cortexa8-sun5i-a13-olinuxino-squashfs-sdcard.img.gz;1;0;1;4.74 MB;4.74 MB
/releases/18.06.9/targets/brcm2708/bcm2708/openwrt-18.06.9-brcm2708-bcm2708-rpi-squashfs-sysupgrade.img.gz;1;0;1;7.63 MB;7.63 MB
/releases/18.06.4/targets/armvirt/32/openwrt-18.06.4-armvirt-32-root.squashfs.gz;1;0;1;1.44 MB;1.44 MB
/releases/19.07.0-rc2/targets/brcm2708/bcm2709/openwrt-19.07.0-rc2-brcm2708-bcm2709-rpi-2-squashfs-factory.img.gz;1;0;1;10.76 MB;10.76 MB
/releases/18.06.0-rc2/targets/sunxi/cortexa7/openwrt-18.06.0-rc2-sunxi-cortexa7-sun8i-h3-orangepi-plus-squashfs-sdcard.img.gz;1;0;1;4.43 MB;4.43 MB
//snapshots/targets/arc770/generic/openwrt-arc770-generic-root.ext4.gz;1;0;1;2.69 MB;2.69 MB
/releases/18.06.0/targets/armvirt/32/openwrt-18.06.0-armvirt-32-root.squashfs.gz;1;0;1;1.44 MB;1.44 MB
/releases/19.07-SNAPSHOT/targets/sunxi/cortexa8/openwrt-19.07-snapshot-r11228-78c4c04dd7-sunxi-cortexa8-sun4i-a10-pcduino-ext4-sdcard.img.gz;1;0;1;6.08 MB;6.08 MB
/releases/19.07.0-rc2/targets/archs38/generic/openwrt-19.07.0-rc2-archs38-generic-Default-sdcard-vfat-ext4.img.gz;1;0;1;5.77 MB;5.77 MB
/releases/17.01-SNAPSHOT/targets/kirkwood/generic/lede-17.01-snapshot-r4046-beaa2ec-kirkwood-linksys-viper-squashfs-sysupgrade.tar;1;0;1;127.75 KB;127.75 KB
/releases/19.07.2/targets/mvebu/cortexa53/openwrt-19.07.2-mvebu-cortexa53-globalscale_espressobin-ext4-sdcard.img.gz;1;0;1;6.39 MB;6.39 MB
/releases/19.07.2/targets/layerscape/armv8_64b/openwrt-19.07.2-layerscape-armv8_64b-ls1043ardb-sdboot-ext4-sdcard.img.gz;1;0;1;1.70 MB;1.70 MB
/releases/faillogs/arm_cortex-a9_neon/packages/softethervpn/host-compile.txt;1;0;1;2.17 KB;2.17 KB
/releases/19.07.0-rc2/targets/octeon/generic/openwrt-19.07.0-rc2-octeon-erlite-squashfs-sysupgrade.tar;1;0;1;8.83 MB;8.83 MB
/releases/19.07.0-rc1/targets/oxnas/ox820/openwrt-19.07.0-rc1-oxnas-ox820-shuttle_kd20-ubifs-sysupgrade.tar;1;0;1;9.19 MB;9.19 MB
/releases/19.07.1/targets/gemini/generic/openwrt-19.07.1-gemini-itian_sq201-ext4-factory.bin.gz;1;0;1;8.73 MB;8.73 MB
/releases/18.06.0-rc2/targets/arc770/generic/openwrt-18.06.0-rc2-arc770-generic-root.ext4.gz;1;0;1;2.69 MB;2.69 MB
/releases/17.01-SNAPSHOT/targets/omap/generic/lede-17.01-snapshot-r4046-beaa2ec-omap-default-rootfs.tar.gz;1;0;1;143.75 KB;143.75 KB
/releases/17.01-SNAPSHOT/targets/sunxi/generic/lede-17.01-snapshot-r4046-beaa2ec-sunxi-sun5i-a13-olinuxino-squashfs-sdcard.img.gz;1;0;1;143.75 KB;143.75 KB
/releases/18.06.9/targets/ar71xx/nand/openwrt-18.06.9-ar71xx-nand-vmlinux.lzma;1;0;1;287.54 KB;287.54 KB
/releases/19.07.0-rc2/targets/imx6/generic/openwrt-19.07.0-rc2-imx6-rootfs.tar.gz;1;0;1;2.55 MB;2.55 MB
/releases/19.07.0-rc1/targets/sunxi/cortexa8/openwrt-19.07.0-rc1-sunxi-cortexa8-sun4i-a10-pcduino-squashfs-sdcard.img.gz;1;0;1;5.08 MB;5.08 MB
/releases/18.06.0-rc1/targets/sunxi/cortexa8/openwrt-18.06.0-rc1-sunxi-cortexa8-sun4i-a10-olinuxino-lime-squashfs-sdcard.img.gz;1;0;1;4.39 MB;4.39 MB
/releases/19.07.1/targets/sunxi/cortexa7/openwrt-19.07.1-sunxi-cortexa7-sun8i-h3-orangepi-pc-ext4-sdcard.img.gz;1;0;1;5.61 MB;5.61 MB
/releases/17.01-SNAPSHOT/targets/x86/xen_domu/lede-17.01-snapshot-r3007-b850218-x86-xen_domu-rootfs-ext4.img.gz;1;0;1;63.75 KB;63.75 KB
//snapshots/targets/mvebu/cortexa72/openwrt-mvebu-cortexa72-marvell_macchiatobin-doubleshot-ext4-sdcard.img.gz;1;0;1;7.73 MB;7.73 MB
/releases/19.07.0-rc1/targets/at91/sama5/openwrt-19.07.0-rc1-at91-sama5-at91-sama5d27_som1_ek-ext4-zImage.gz;1;0;1;3.31 MB;3.31 MB
/releases/19.07.0-rc1/targets/mvebu/cortexa53/openwrt-19.07.0-rc1-mvebu-cortexa53-globalscale_espressobin-emmc-squashfs-sdcard.img.gz;1;0;1;5.55 MB;5.55 MB
/releases/18.06.0-rc1/targets/x86/generic/openwrt-18.06.0-rc1-x86-generic-combined-ext4.img.gz;1;0;1;7.53 MB;7.53 MB
/releases/19.07.0-rc1/targets/sunxi/cortexa53/openwrt-19.07.0-rc1-sunxi-cortexa53-sun50i-a64-sopine-baseboard-squashfs-sdcard.img.gz;1;0;1;5.98 MB;5.98 MB
/releases/19.07-SNAPSHOT/targets/brcm2708/bcm2708/openwrt-19.07-snapshot-r11242-6703abb7ca-brcm2708-bcm2708-rpi-ext4-factory.img.gz;1;0;1;11.51 MB;11.51 MB
//snapshots/targets/mvebu/cortexa72/openwrt-mvebu-cortexa72-marvell_armada7040-db-ext4-sdcard.img.gz;1;0;1;7.72 MB;7.72 MB
/releases/19.07.0-rc1/targets/x86/legacy/openwrt-19.07.0-rc1-x86-legacy-rootfs-ext4.img.gz;1;0;1;3.13 MB;3.13 MB
/releases/17.01.6/targets/sunxi/generic/lede-17.01.6-sunxi-sun7i-a20-pcduino3-ext4-sdcard.img.gz;1;0;1;191.75 KB;191.75 KB
/releases/19.07.1/targets/ar71xx/generic/openwrt-19.07.1-ar71xx-generic-vmlinux.lzma;1;0;1;175.54 KB;175.54 KB
//snapshots/targets/omap/generic/openwrt-omap-ti_am335x-evm-squashfs-sdcard.img.gz;1;0;1;6.37 MB;6.37 MB
/releases/18.06.0-rc2/targets/sunxi/cortexa7/openwrt-18.06.0-rc2-sunxi-cortexa7-sun7i-a20-pcduino3-squashfs-sdcard.img.gz;1;0;1;4.81 MB;4.81 MB
/releases/18.06.0-rc1/targets/x86/geode/openwrt-18.06.0-rc1-x86-geode-combined-squashfs.img.gz;1;0;1;6.13 MB;6.13 MB
/releases/19.07.0-rc2/targets/oxnas/ox820/openwrt-19.07.0-rc2-oxnas-ox820-mitrastar_stg-212-ubifs-sysupgrade.tar;1;0;1;9.06 MB;9.06 MB
/releases/17.01-SNAPSHOT/targets/sunxi/generic/lede-17.01-snapshot-r4046-beaa2ec-sunxi-sun7i-a20-pcduino3-ext4-sdcard.img.gz;1;0;1;95.75 KB;95.75 KB
/releases/18.06.0-rc1/targets/mvebu/cortexa9/openwrt-18.06.0-rc1-mvebu-cortexa9-armada-388-clearfog-pro-squashfs-sdcard.img.gz;1;0;1;4.50 MB;4.50 MB
/releases/19.07.1/targets/octeontx/generic/openwrt-19.07.1-octeontx-default-rootfs.tar.gz;1;0;1;2.05 MB;2.05 MB
/releases/17.01-SNAPSHOT/targets/sunxi/generic/lede-17.01-snapshot-r4046-beaa2ec-sunxi-sun7i-a20-olinuxino-lime-ext4-sdcard.img.gz;1;0;1;143.75 KB;143.75 KB
/releases/17.01.7/targets/x86/legacy/lede-17.01.7-x86-legacy-combined-ext4.img.gz;1;0;1;159.75 KB;159.75 KB
/releases/17.01.5/targets/apm821xx/sata/lede-17.01.5-apm821xx-sata-MyBookLiveSingle-ext4-rootfs.img.gz;1;0;1;4.89 MB;4.89 MB
/releases/18.06.0-rc1/targets/armvirt/64/openwrt-18.06.0-rc1-armvirt-64-root.squashfs.gz;1;0;1;1.57 MB;1.57 MB
//snapshots/targets/sunxi/cortexa7/openwrt-sunxi-cortexa7-olimex_a20-olinuxino-micro-squashfs-sdcard.img.gz;1;0;1;5.59 MB;5.59 MB
/releases/18.06.5/targets/ar71xx/nand/openwrt-18.06.5-ar71xx-nand-wndr3700v4-squashfs-sysupgrade.tar;1;0;1;4.51 MB;4.51 MB
/releases/19.07.1/targets/sunxi/cortexa7/openwrt-19.07.1-sunxi-cortexa7-sun8i-h3-orangepi-pc-squashfs-sdcard.img.gz;1;0;1;4.77 MB;4.77 MB
/releases/18.06.7/targets/sunxi/cortexa7/openwrt-18.06.7-sunxi-cortexa7-sun8i-h3-orangepi-plus-ext4-sdcard.img.gz;1;0;1;1.27 MB;1.27 MB
/releases/18.06.0-rc1/targets/at91/sama5d4/openwrt-18.06.0-rc1-at91-sama5d4-rootfs.tar.gz;1;0;1;1.96 MB;1.96 MB
/releases/18.06-SNAPSHOT/targets/sunxi/cortexa53/openwrt-18.06-snapshot-r8073-5625f5bc36-sunxi-cortexa53-sun50i-h5-nanopi-neo-plus2-ext4-sdcard.img.gz;1;0;1;6.40 MB;6.40 MB
/releases/18.06.4/targets/sunxi/cortexa53/openwrt-18.06.4-sunxi-cortexa53-sun50i-h5-orangepi-zero-plus-squashfs-sdcard.img.gz;1;0;1;159.54 KB;159.54 KB
//snapshots/targets/sunxi/cortexa7/openwrt-sunxi-cortexa7-mele_m9-squashfs-sdcard.img.gz;1;0;1;6.00 MB;6.00 MB
/releases/17.01.0-rc2/targets/oxnas/generic/lede-17.01.0-rc2-r3131-42f3c1f-oxnas-stg212-squashfs-sysupgrade.tar;1;0;1;303.75 KB;303.75 KB
/releases/17.01.7/targets/sunxi/generic/lede-17.01.7-sunxi-sun7i-a20-pcduino3-squashfs-sdcard.img.gz;1;0;1;79.75 KB;79.75 KB
/snapshots/faillogs/mipsel_24kc/packages/python3/host-compile.txt;1;0;1;810.22 KB;810.22 KB
/releases/19.07.0-rc2/targets/at91/sam9x/openwrt-19.07.0-rc2-at91-sam9x-wb45n-ext4-root.ubi.gz;1;0;1;3.71 MB;3.71 MB
/releases/17.01-SNAPSHOT/targets/sunxi/generic/lede-17.01-snapshot-r4046-beaa2ec-sunxi-sun7i-a20-cubietruck-squashfs-sdcard.img.gz;1;0;1;143.75 KB;143.75 KB
/releases/19.07.0-rc1/targets/tegra/generic/openwrt-19.07.0-rc1-tegra-compulab_trimslice-ext4-sdcard.img.gz;1;0;1;6.42 MB;6.42 MB
/releases/18.06.0-rc2/targets/sunxi/cortexa8/openwrt-18.06.0-rc2-sunxi-cortexa8-sun4i-a10-marsboard-ext4-sdcard.img.gz;1;0;1;5.24 MB;5.24 MB
/releases/17.01.0-rc1/targets/sunxi/generic/lede-17.01.0-rc1-r3042-ec095b5-sunxi-sun7i-a20-olinuxino-lime-ext4-sdcard.img.gz;1;0;1;127.75 KB;127.75 KB
/releases/19.07.1/targets/sunxi/cortexa53/openwrt-19.07.1-sunxi-cortexa53-sun50i-h5-orangepi-zero-plus-squashfs-sdcard.img.gz;1;0;1;5.99 MB;5.99 MB
/releases/17.01.6/targets/sunxi/generic/lede-17.01.6-sunxi-sun6i-a31-m9-ext4-sdcard.img.gz;1;0;1;143.75 KB;143.75 KB
//snapshots/targets/bcm27xx/bcm2711/openwrt-bcm27xx-bcm2711-rpi-4-ext4-sysupgrade.img.gz;1;0;1;14.12 MB;14.12 MB
/releases/17.01.2/targets/ipq806x/generic/lede-17.01.2-ipq806x-D7800-squashfs-sysupgrade.tar;1;0;1;127.75 KB;127.75 KB
/releases/19.07.2/targets/mvebu/cortexa53/openwrt-19.07.2-mvebu-cortexa53-marvell_armada-3720-db-ext4-sdcard.img.gz;1;0;1;3.25 MB;3.25 MB
/releases/18.06.4/targets/x86/generic/openwrt-18.06.4-x86-generic-rootfs-ext4.img.gz;1;0;1;143.54 KB;143.54 KB
/releases/18.06-SNAPSHOT/targets/mediatek/32/openwrt-18.06-snapshot-r7027-d6ee5e4-mediatek-32-mediatek,mt7623a-rfb-emmc-sysupgrade.tar;1;0;1;175.54 KB;175.54 KB
/releases/19.07-SNAPSHOT/targets/sunxi/cortexa8/openwrt-19.07-snapshot-r11228-78c4c04dd7-sunxi-cortexa8-sun4i-a10-cubieboard-squashfs-sdcard.img.gz;1;0;1;4.73 MB;4.73 MB
/releases/18.06.0-rc1/targets/sunxi/cortexa7/openwrt-18.06.0-rc1-sunxi-cortexa7-sun7i-a20-pcduino3-ext4-sdcard.img.gz;1;0;1;5.76 MB;5.76 MB
//releases/19.07.3/targets/omap/generic/openwrt-19.07.3-omap-ti_omap4-panda-ext4-sdcard.img.gz;1;0;1;6.55 MB;6.55 MB
/releases/17.01.6/targets/sunxi/generic/lede-17.01.6-sunxi-sun4i-a10-cubieboard-squashfs-sdcard.img.gz;1;0;1;159.75 KB;159.75 KB
/releases/18.06.0-rc2/targets/sunxi/cortexa7/openwrt-18.06.0-rc2-sunxi-cortexa7-sun8i-h3-nanopi-m1-plus-ext4-sdcard.img.gz;1;0;1;6.51 MB;6.51 MB
/releases/19.07-SNAPSHOT/targets/sunxi/cortexa8/openwrt-19.07-snapshot-r11228-78c4c04dd7-sunxi-cortexa8-sun5i-a13-olinuxino-squashfs-sdcard.img.gz;1;0;1;5.12 MB;5.12 MB
/releases/17.01.5/targets/brcm63xx/smp/lede-17.01.5-brcm63xx-smp-livebox-vmlinux.gz;1;0;1;1.88 MB;1.88 MB
//snapshots/targets/sunxi/cortexa7/openwrt-sunxi-cortexa7-cubietech_cubieboard2-ext4-sdcard.img.gz;1;0;1;6.32 MB;6.32 MB
/releases/18.06.0-rc2/targets/mvebu/cortexa9/openwrt-18.06.0-rc2-mvebu-cortexa9-turris-omnia-sysupgrade.img.gz;1;0;1;5.16 MB;5.16 MB
/releases/19.07.1/targets/armvirt/32/openwrt-19.07.1-armvirt-32-rootfs.cpio.gz;1;0;1;20 Bytes;20 Bytes
/releases/18.06.0-rc1/targets/mvebu/cortexa72/openwrt-18.06.0-rc1-mvebu-cortexa72-armada-macchiatobin-squashfs-sdcard.img.gz;1;0;1;5.33 MB;5.33 MB
/releases/19.07.0-rc1/targets/oxnas/ox820/openwrt-19.07.0-rc1-oxnas-ox820-akitio_mycloud-squashfs-sysupgrade.tar;1;0;1;5.06 MB;5.06 MB
/releases/18.06.5/targets/pistachio/generic/openwrt-18.06.5-pistachio-marduk-squashfs-sysupgrade.tar;1;0;1;4.75 MB;4.75 MB
/releases/19.07.0-rc1/targets/at91/sam9x/openwrt-19.07.0-rc1-at91-sam9x-tny_a9263-ext4-factory.bin.gz;1;0;1;5.84 MB;5.84 MB
//snapshots/targets/layerscape/armv7/openwrt-layerscape-armv7-fsl_ls1021a-iot-sdboot-squashfs-sdcard.img.gz;1;0;1;7.20 MB;7.20 MB
/releases/19.07.0-rc2/targets/at91/sam9x/openwrt-19.07.0-rc2-at91-sam9x-at91sam9263ek-ext4-zImage.gz;1;0;1;3.35 MB;3.35 MB
/releases/18.06.6/targets/armvirt/64/openwrt-18.06.6-armvirt-64-root.squashfs.gz;1;0;1;1.57 MB;1.57 MB
//snapshots/targets/at91/sama5d4/kernel-debug.tar.bz2;1;0;1;12.46 MB;12.46 MB
/releases/19.07.1/targets/mvebu/cortexa72/openwrt-19.07.1-mvebu-cortexa72-marvell_armada8040-db-squashfs-sdcard.img.gz;1;0;1;5.58 MB;5.58 MB
/releases/19.07.0-rc1/targets/sunxi/cortexa53/openwrt-19.07.0-rc1-sunxi-cortexa53-sun50i-a64-pine64-plus-squashfs-sdcard.img.gz;1;0;1;5.98 MB;5.98 MB
/releases/19.07-SNAPSHOT/targets/brcm63xx/generic/openwrt-19.07-snapshot-r11228-78c4c04dd7-brcm63xx-generic-livebox-vmlinux.gz;1;0;1;2.25 MB;2.25 MB
/releases/19.07.2/targets/sunxi/cortexa7/openwrt-19.07.2-sunxi-cortexa7-sun8i-h2-plus-orangepi-r1-squashfs-sdcard.img.gz;1;0;1;4.77 MB;4.77 MB
//snapshots/targets/mvebu/cortexa9/openwrt-mvebu-cortexa9-kobol_helios4-squashfs-sdcard.img.gz;1;0;1;5.47 MB;5.47 MB
/releases/18.06.2/targets/brcm2708/bcm2708/openwrt-18.06.2-brcm2708-bcm2708-rpi-squashfs-factory.img.gz;1;0;1;7.60 MB;7.60 MB
/releases/17.01.0/targets/x86/legacy/lede-17.01.0-r3205-59508e3-x86-legacy-generic-rootfs.tar.gz;1;0;1;159.75 KB;159.75 KB
/releases/19.07.0-rc2/targets/tegra/generic/openwrt-19.07.0-rc2-tegra-compulab_trimslice-ext4-sdcard.img.gz;1;0;1;6.43 MB;6.43 MB
/releases/17.01.0-rc2/targets/kirkwood/generic/lede-17.01.0-rc2-r3131-42f3c1f-kirkwood-linksys-audi-squashfs-sysupgrade.tar;1;0;1;175.75 KB;175.75 KB
/releases/19.07.0-rc2/targets/sunxi/cortexa8/openwrt-19.07.0-rc2-sunxi-cortexa8-sun4i-a10-marsboard-squashfs-sdcard.img.gz;1;0;1;4.71 MB;4.71 MB
//snapshots/targets/omap/generic/openwrt-omap-ti_am335x-bone-black-squashfs-sdcard.img.gz;1;0;1;6.37 MB;6.37 MB
/releases/18.06.7/targets/sunxi/cortexa7/openwrt-18.06.7-sunxi-cortexa7-sun8i-h3-nanopi-m1-plus-squashfs-sdcard.img.gz;1;0;1;1.30 MB;1.30 MB
/releases/17.01.5/targets/archs38/generic/lede-17.01.5-archs38-generic-Default-sdcard-vfat-ext4.img.gz;1;0;1;5.42 MB;5.42 MB
/releases/18.06.4/targets/sunxi/cortexa7/openwrt-18.06.4-sunxi-cortexa7-sun8i-h3-orangepi-pc-squashfs-sdcard.img.gz;1;0;1;143.54 KB;143.54 KB
/releases/18.06.0-rc2/targets/x86/legacy/openwrt-18.06.0-rc2-x86-legacy-combined-squashfs.img.gz;1;0;1;5.98 MB;5.98 MB
/releases/18.06.4/targets/apm821xx/sata/openwrt-18.06.4-apm821xx-sata-wd_mybooklive-duo-ext4-rootfs.img.gz;1;0;1;6.12 MB;6.12 MB
/releases/18.06.6/targets/gemini/generic/openwrt-18.06.6-gemini-nas4220b-rd.gz;1;0;1;6.00 MB;6.00 MB
/releases/19.07.0-rc2/targets/omap/generic/openwrt-19.07.0-rc2-omap-ti_omap3-beagle-ext4-sdcard.img.gz;1;0;1;6.66 MB;6.66 MB
/releases/18.06.5/targets/archs38/generic/openwrt-18.06.5-archs38-generic-root.ext4.gz;1;0;1;2.81 MB;2.81 MB
/releases/19.07.3/targets/mvebu/cortexa53/openwrt-19.07.3-mvebu-cortexa53-globalscale_espressobin-ext4-sdcard.img.gz;1;0;1;6.39 MB;6.39 MB
/releases/17.01-SNAPSHOT/targets/kirkwood/generic/lede-17.01-snapshot-r4046-beaa2ec-kirkwood-linksys-audi-squashfs-sysupgrade.tar;1;0;1;159.75 KB;159.75 KB
/releases/17.01.2/targets/ipq806x/generic/lede-17.01.2-ipq806x-AP148-legacy-squashfs-nand-sysupgrade.tar;1;0;1;1.14 MB;1.14 MB
/releases/17.01.0-rc1/targets/ath25/generic/lede-17.01.0-rc1-r3042-ec095b5-ath25-generic-kernel.gz;1;0;1;255.75 KB;255.75 KB
/releases/19.07.0-rc1/targets/ath25/generic/openwrt-19.07.0-rc1-ath25-generic-kernel.gz;1;0;1;1.81 MB;1.81 MB
/releases/17.01.5/targets/ipq806x/generic/lede-17.01.5-ipq806x-R7500-squashfs-sysupgrade.tar;1;0;1;4.59 MB;4.59 MB
/releases/18.06.0-rc1/targets/armvirt/32/openwrt-18.06.0-rc1-armvirt-32-default-rootfs.tar.gz;1;0;1;1.85 MB;1.85 MB
/releases/18.06.3/targets/arc770/generic/openwrt-18.06.3-arc770-generic-root.ext4.gz;1;0;1;2.68 MB;2.68 MB
//snapshots/targets/ath25/generic/openwrt-ath25-generic-kernel.gz;1;0;1;2.25 MB;2.25 MB
//snapshots/targets/sunxi/cortexa7/openwrt-sunxi-cortexa7-friendlyarm_nanopi-m1-plus-ext4-sdcard.img.gz;1;0;1;7.71 MB;7.71 MB
/releases/19.07.0-rc1/targets/sunxi/cortexa7/openwrt-19.07.0-rc1-sunxi-cortexa7-sun7i-a20-pcduino3-squashfs-sdcard.img.gz;1;0;1;5.14 MB;5.14 MB
/releases/17.01.4/targets/mediatek/generic/lede-17.01.4-mediatek-eMMC-sysupgrade.tar;1;0;1;175.75 KB;175.75 KB
/releases/18.06.0-rc1/targets/x86/generic/openwrt-18.06.0-rc1-x86-generic-rootfs-squashfs.img.gz;1;0;1;2.28 MB;2.28 MB
/releases/17.01.6/targets/sunxi/generic/lede-17.01.6-sunxi-sun7i-a20-olinuxino-lime-squashfs-sdcard.img.gz;1;0;1;303.75 KB;303.75 KB
/releases/18.06.0-rc1/targets/brcm2708/bcm2708/openwrt-18.06.0-rc1-brcm2708-bcm2708-rpi-squashfs-sdcard.img.gz;1;0;1;7.58 MB;7.58 MB
/releases/19.07-SNAPSHOT/targets/sunxi/cortexa8/openwrt-19.07-snapshot-r11228-78c4c04dd7-sunxi-cortexa8-sun4i-a10-pcduino-squashfs-sdcard.img.gz;1;0;1;5.10 MB;5.10 MB
/releases/17.01.0-rc1/targets/x86/geode/lede-17.01.0-rc1-r3042-ec095b5-x86-geode-rootfs-ext4.img.gz;1;0;1;191.75 KB;191.75 KB
/releases/19.07.0-rc1/targets/x86/legacy/openwrt-19.07.0-rc1-x86-legacy-rootfs-squashfs.img.gz;1;0;1;2.40 MB;2.40 MB
/snapshots/targets/scheduled_for_removal/brcm2708/bcm2709/openwrt-brcm2708-bcm2709-rpi-2-ext4-sysupgrade.img.gz;1;0;1;0;0
/releases/19.07.0-rc2/targets/sunxi/cortexa8/openwrt-19.07.0-rc2-sunxi-cortexa8-sun4i-a10-olinuxino-lime-ext4-sdcard.img.gz;1;0;1;5.56 MB;5.56 MB
/releases/18.06.0-rc1/targets/pistachio/generic/openwrt-18.06.0-rc1-pistachio-rootfs.tar.gz;1;0;1;1.93 MB;1.93 MB
/releases/18.06.0-rc2/targets/at91/sama5d2/openwrt-18.06.0-rc2-at91-sama5d2-at91-sama5d2_xplained-ext4-zImage.gz;1;0;1;1.28 MB;1.28 MB
/releases/18.06.0-rc2/targets/sunxi/cortexa7/openwrt-18.06.0-rc2-sunxi-cortexa7-sun7i-a20-cubietruck-squashfs-sdcard.img.gz;1;0;1;5.11 MB;5.11 MB
/releases/19.07.1/targets/sunxi/cortexa8/openwrt-19.07.1-sunxi-cortexa8-sun5i-a13-olinuxino-ext4-sdcard.img.gz;1;0;1;6.08 MB;6.08 MB
/releases/19.07.0/targets/ar71xx/nand/openwrt-19.07.0-ar71xx-nand-wndr3700v4-squashfs-sysupgrade.tar;1;0;1;4.51 MB;4.51 MB
/snapshots/targets/scheduled_for_removal/brcm2708/bcm2710/kernel-debug.tar.bz2;1;0;1;0;0
/releases/17.01.1/targets/x86/generic/lede-17.01.1-x86-generic-rootfs-ext4.img.gz;1;0;1;143.75 KB;143.75 KB
/releases/18.06.0-rc1/targets/sunxi/cortexa7/openwrt-18.06.0-rc1-sunxi-cortexa7-sun7i-a20-olinuxino-lime2-emmc-ext4-sdcard.img.gz;1;0;1;5.39 MB;5.39 MB
/releases/18.06.0-rc2/targets/at91/sama5d2/openwrt-18.06.0-rc2-at91-sama5d2-at91-sama5d2_ptc_ek-ext4-zImage.gz;1;0;1;1.27 MB;1.27 MB
/releases/18.06.0-rc2/targets/x86/legacy/openwrt-18.06.0-rc2-x86-legacy-combined-ext4.img.gz;1;0;1;6.69 MB;6.69 MB
/releases/18.06.7/targets/sunxi/cortexa7/openwrt-18.06.7-sunxi-cortexa7-sun8i-h3-orangepi-pc-squashfs-sdcard.img.gz;1;0;1;1.31 MB;1.31 MB
/releases/18.06.6/targets/ar71xx/nand/openwrt-18.06.6-ar71xx-nand-nbg6716-squashfs-sysupgrade.tar;1;0;1;4.76 MB;4.76 MB
/snapshots/targets/scheduled_for_removal/ar71xx/nand/openwrt-ar71xx-nand-wndr3700v4-squashfs-sysupgrade.tar;1;0;1;0;0
/releases/17.01.0-rc2/targets/kirkwood/generic/lede-17.01.0-rc2-r3131-42f3c1f-kirkwood-linksys-viper-squashfs-sysupgrade.tar;1;0;1;159.75 KB;159.75 KB
/releases/17.01.0-rc1/targets/sunxi/generic/lede-17.01.0-rc1-r3042-ec095b5-sunxi-sun7i-a20-pcduino3-squashfs-sdcard.img.gz;1;0;1;79.75 KB;79.75 KB
/releases/19.07.0-rc1/targets/x86/geode/openwrt-19.07.0-rc1-x86-geode-combined-ext4.img.gz;1;0;1;7.38 MB;7.38 MB
/releases/19.07.0-rc1/targets/sunxi/cortexa7/openwrt-19.07.0-rc1-sunxi-cortexa7-sun6i-a31-m9-ext4-sdcard.img.gz;1;0;1;6.12 MB;6.12 MB
/releases/19.07.2/targets/sunxi/cortexa7/openwrt-19.07.2-sunxi-cortexa7-sun7i-a20-olinuxino-micro-squashfs-sdcard.img.gz;1;0;1;4.80 MB;4.80 MB
/releases/17.01-SNAPSHOT/targets/sunxi/generic/lede-17.01-snapshot-r4046-beaa2ec-sunxi-sun7i-a20-olinuxino-micro-squashfs-sdcard.img.gz;1;0;1;287.75 KB;287.75 KB
/releases/18.06.4/targets/sunxi/cortexa8/openwrt-18.06.4-sunxi-cortexa8-sun5i-a13-olimex-som-squashfs-sdcard.img.gz;1;0;1;351.54 KB;351.54 KB
/releases/18.06.0-rc2/targets/mvebu/cortexa53/openwrt-18.06.0-rc2-mvebu-cortexa53-globalscale-espressobin-ext4-sdcard.img.gz;1;0;1;6.11 MB;6.11 MB
/releases/18.06.3/targets/brcm2708/bcm2709/openwrt-18.06.3-brcm2708-bcm2709-rpi-2-ext4-sysupgrade.img.gz;1;0;1;8.86 MB;8.86 MB
/releases/17.01.0-rc2/targets/imx6/generic/lede-17.01.0-rc2-r3131-42f3c1f-imx6-ventana-squashfs-bootfs.tar.gz;1;0;1;63.75 KB;63.75 KB
/releases/19.07.0-rc2/targets/oxnas/ox820/openwrt-19.07.0-rc2-oxnas-ox820-akitio_mycloud-squashfs-sysupgrade.tar;1;0;1;5.06 MB;5.06 MB
/releases/18.06.0/targets/brcm2708/bcm2709/openwrt-18.06.0-brcm2708-bcm2709-rpi-2-ext4-sysupgrade.img.gz;1;0;1;8.83 MB;8.83 MB
/releases/17.01.7/targets/x86/generic/lede-17.01.7-x86-generic-generic-rootfs.tar.gz;1;0;1;159.75 KB;159.75 KB
/releases/18.06.2/targets/arc770/generic/openwrt-18.06.2-arc770-generic-Default-sdcard-vfat-ext4.img.gz;1;0;1;4.86 MB;4.86 MB
/snapshots/targets/scheduled_for_removal/ath25/generic/openwrt-ath25-generic-kernel.gz;1;0;1;0;0
/releases/18.06-SNAPSHOT/targets/sunxi/cortexa53/openwrt-18.06-snapshot-r8073-5625f5bc36-sunxi-cortexa53-sun50i-h5-orangepi-zero-plus-ext4-sdcard.img.gz;1;0;1;6.40 MB;6.40 MB
/releases/17.01.0/targets/gemini/raidsonic/lede-17.01.0-r3205-59508e3-gemini-raidsonic-nas4220-rd.gz;1;0;1;143.75 KB;143.75 KB
/releases/18.06.7/targets/arc770/generic/openwrt-18.06.7-arc770-generic-root.ext4.gz;1;0;1;1.75 MB;1.75 MB
/releases/19.07.0-rc1/targets/zynq/generic/openwrt-19.07.0-rc1-zynq-xlnx_zynq-zc702-squashfs-sdcard.img.gz;1;0;1;5.86 MB;5.86 MB
/releases/18.06.4/targets/sunxi/cortexa8/openwrt-18.06.4-sunxi-cortexa8-sun4i-a10-pcduino-squashfs-sdcard.img.gz;1;0;1;143.54 KB;143.54 KB
/releases/18.06.7/targets/brcm2708/bcm2708/openwrt-18.06.7-brcm2708-bcm2708-rpi-ext4-sysupgrade.img.gz;1;0;1;1.30 MB;1.30 MB
/releases/17.01.7/targets/oxnas/generic/lede-17.01.7-oxnas-stg212-squashfs-sysupgrade.tar;1;0;1;159.75 KB;159.75 KB
/releases/17.01.0/targets/ipq806x/generic/lede-17.01.0-r3205-59508e3-ipq806x-AP148-squashfs-nand-sysupgrade.tar;1;0;1;3.00 MB;3.00 MB
/releases/17.01.0-rc1/targets/sunxi/generic/lede-17.01.0-rc1-r3042-ec095b5-sunxi-sun4i-a10-cubieboard-ext4-sdcard.img.gz;1;0;1;159.75 KB;159.75 KB
/releases/18.06.4/targets/sunxi/cortexa8/openwrt-18.06.4-sunxi-cortexa8-sun4i-a10-olinuxino-lime-ext4-sdcard.img.gz;1;0;1;159.54 KB;159.54 KB
/releases/17.01.4/targets/x86/legacy/lede-17.01.4-x86-legacy-generic-rootfs.tar.gz;1;0;1;159.75 KB;159.75 KB
/releases/19.07.0-rc1/targets/sunxi/cortexa8/openwrt-19.07.0-rc1-sunxi-cortexa8-sun5i-a13-olinuxino-ext4-sdcard.img.gz;1;0;1;6.07 MB;6.07 MB
/releases/17.01.5/targets/apm821xx/sata/lede-17.01.5-apm821xx-sata-MyBookLiveDuo-ext4-rootfs.img.gz;1;0;1;5.34 MB;5.34 MB
/releases/17.01.2/targets/mxs/generic/lede-17.01.2-mxs-duckbill-sdcard.img.gz;1;0;1;143.75 KB;143.75 KB
/releases/18.06.7/targets/gemini/generic/openwrt-18.06.7-gemini-sysupgrade-ib4220b.tar.gz;1;0;1;10.51 MB;10.51 MB
/releases/faillogs-18.06/mipsel_24kc/packages/perl-parse-recdescent/host-compile.txt;1;0;1;902 Bytes;902 Bytes
/releases/17.01.6/targets/oxnas/generic/lede-17.01.6-oxnas-pogoplug-pro-ubifs-sysupgrade.tar;1;0;1;319.75 KB;319.75 KB
//snapshots/targets/sunxi/cortexa7/openwrt-sunxi-cortexa7-lamobo_lamobo-r1-squashfs-sdcard.img.gz;1;0;1;6.32 MB;6.32 MB
/releases/17.01.7/targets/sunxi/generic/lede-17.01.7-sunxi-sun7i-a20-olinuxino-micro-squashfs-sdcard.img.gz;1;0;1;159.75 KB;159.75 KB
/releases/17.01.0-rc1/targets/zynq/generic/lede-17.01.0-rc1-r3042-ec095b5-zynq-zed-uramdisk.image.gz;1;0;1;319.75 KB;319.75 KB
/releases/18.06.0-rc1/targets/armvirt/64/openwrt-18.06.0-rc1-armvirt-64-default-rootfs.tar.gz;1;0;1;1.96 MB;1.96 MB
/releases/19.07.3/targets/layerscape/armv7/openwrt-19.07.3-layerscape-armv7-ls1021aiot-sdboot-ext4-sdcard.img.gz;1;0;1;6.28 MB;6.28 MB
/releases/19.07.0-rc1/targets/at91/sama5/openwrt-19.07.0-rc1-at91-sama5-at91-sama5d2_xplained-ext4-zImage.gz;1;0;1;3.31 MB;3.31 MB
/releases/17.01.7/targets/ar71xx/nand/lede-17.01.7-ar71xx-nand-z1-squashfs-sysupgrade.tar;1;0;1;303.75 KB;303.75 KB
/releases/18.06.0-rc2/targets/ar71xx/tiny/openwrt-18.06.0-rc2-ar71xx-tiny-vmlinux.lzma;1;0;1;1.31 MB;1.31 MB
/releases/18.06.6/targets/brcm2708/bcm2709/openwrt-18.06.6-brcm2708-bcm2709-rpi-2-squashfs-factory.img.gz;1;0;1;1.72 MB;1.72 MB
/releases/19.07.0-rc1/targets/omap/generic/openwrt-19.07.0-rc1-omap-ti_omap3-beagle-squashfs-sdcard.img.gz;1;0;1;5.78 MB;5.78 MB
/releases/17.01.0-rc2/targets/x86/legacy/lede-17.01.0-rc2-r3131-42f3c1f-x86-legacy-generic-rootfs.tar.gz;1;0;1;191.75 KB;191.75 KB
/releases/18.06.4/targets/sunxi/cortexa7/openwrt-18.06.4-sunxi-cortexa7-sun7i-a20-pcduino3-squashfs-sdcard.img.gz;1;0;1;159.54 KB;159.54 KB
//snapshots/targets/bcm27xx/bcm2711/openwrt-bcm27xx-bcm2711-rpi-4-squashfs-factory.img.gz;1;0;1;12.81 MB;12.81 MB
/releases/19.07.1/targets/sunxi/cortexa53/openwrt-19.07.1-sunxi-cortexa53-sun50i-h5-nanopi-neo2-ext4-sdcard.img.gz;1;0;1;6.78 MB;6.78 MB
//snapshots/targets/sunxi/cortexa8/openwrt-sunxi-cortexa8-cubietech_a10-cubieboard-ext4-sdcard.img.gz;1;0;1;6.30 MB;6.30 MB
/releases/18.06.0-rc2/targets/armvirt/32/openwrt-18.06.0-rc2-armvirt-32-root.ext4.gz;1;0;1;2.13 MB;2.13 MB
//snapshots/targets/at91/sama5d3/kernel-debug.tar.bz2;1;0;1;12.43 MB;12.43 MB
/releases/19.07.0-rc1/targets/sunxi/cortexa53/openwrt-19.07.0-rc1-sunxi-cortexa53-sun50i-a64-sopine-baseboard-ext4-sdcard.img.gz;1;0;1;6.77 MB;6.77 MB
/releases/19.07.0-rc1/targets/x86/64/openwrt-19.07.0-rc1-x86-64-generic-rootfs.tar.gz;1;0;1;3.64 MB;3.64 MB
//snapshots/targets/sunxi/cortexa8/openwrt-sunxi-cortexa8-olimex_a10-olinuxino-lime-ext4-sdcard.img.gz;1;0;1;6.29 MB;6.29 MB
/releases/19.07.0-rc2/targets/omap/generic/openwrt-19.07.0-rc2-omap-ti_am335x-bone-black-squashfs-sdcard.img.gz;1;0;1;5.72 MB;5.72 MB
/releases/19.07.3/targets/ar71xx/nand/openwrt-19.07.3-ar71xx-nand-r6100-squashfs-sysupgrade.tar;1;3;4;5.20 MB;1.30 MB
//snapshots/targets/sunxi/cortexa8/openwrt-sunxi-cortexa8-cubietech_a10-cubieboard-squashfs-sdcard.img.gz;1;0;1;5.56 MB;5.56 MB
/releases/19.07.0-rc1/targets/brcm2708/bcm2710/openwrt-19.07.0-rc1-brcm2708-bcm2710-rpi-3-squashfs-factory.img.gz;1;0;1;10.92 MB;10.92 MB
/releases/17.01.0/targets/ipq806x/generic/lede-17.01.0-r3205-59508e3-ipq806x-D7800-squashfs-sysupgrade.tar;1;0;1;2.91 MB;2.91 MB
/releases/18.06.7/targets/sunxi/cortexa7/openwrt-18.06.7-sunxi-cortexa7-sun7i-a20-olinuxino-lime-squashfs-sdcard.img.gz;1;0;1;1.28 MB;1.28 MB
/releases/18.06.0-rc1/targets/x86/legacy/openwrt-18.06.0-rc1-x86-legacy-combined-ext4.img.gz;1;0;1;6.68 MB;6.68 MB
/releases/19.07.2/targets/pistachio/generic/openwrt-19.07.2-pistachio-rootfs.tar.gz;1;0;1;2.00 MB;2.00 MB
/releases/17.01.0-rc1/targets/sunxi/generic/lede-17.01.0-rc1-r3042-ec095b5-sunxi-sun5i-a13-olinuxino-ext4-sdcard.img.gz;1;0;1;191.75 KB;191.75 KB
/releases/18.06.4/targets/x86/geode/openwrt-18.06.4-x86-geode-rootfs-ext4.img.gz;1;0;1;143.54 KB;143.54 KB
/releases/18.06.4/targets/sunxi/cortexa7/openwrt-18.06.4-sunxi-cortexa7-sun8i-h3-orangepi-2-squashfs-sdcard.img.gz;1;0;1;143.54 KB;143.54 KB
/releases/19.07.0/targets/apm821xx/sata/openwrt-19.07.0-apm821xx-sata-wd_mybooklive-ext4-factory.img.gz;1;0;1;6.54 MB;6.54 MB
/releases/18.06.6/targets/brcm63xx/smp/openwrt-18.06.6-brcm63xx-smp-livebox-vmlinux.gz;1;0;1;2.06 MB;2.06 MB
/releases/17.01.0-rc1/targets/sunxi/generic/lede-17.01.0-rc1-r3042-ec095b5-sunxi-sun7i-a20-cubietruck-ext4-sdcard.img.gz;1;0;1;79.75 KB;79.75 KB
/releases/19.07.0-rc2/targets/at91/sam9x/openwrt-19.07.0-rc2-at91-sam9x-tny_a9g20-ext4-factory.bin.gz;1;0;1;5.85 MB;5.85 MB
/releases/18.06.4/targets/apm821xx/nand/openwrt-18.06.4-apm821xx-nand-meraki_mx60-squashfs-sysupgrade.tar;1;0;1;5.06 MB;5.06 MB
/snapshots/targets/scheduled_for_removal/ar71xx/nand/openwrt-ar71xx-nand-wndr4300-squashfs-sysupgrade.tar;1;0;1;0;0
/releases/17.01.0-rc1/targets/sunxi/generic/lede-17.01.0-rc1-r3042-ec095b5-sunxi-sun8i-h3-orangepi-plus-ext4-sdcard.img.gz;1;0;1;143.75 KB;143.75 KB
/releases/17.01.6/targets/sunxi/generic/lede-17.01.6-sunxi-sun4i-a10-olinuxino-lime-ext4-sdcard.img.gz;1;0;1;143.75 KB;143.75 KB
/releases/18.06.1/targets/octeontx/generic/openwrt-18.06.1-octeontx-default-rootfs.tar.gz;1;0;1;1.30 MB;1.30 MB
/releases/18.06.0-rc2/targets/sunxi/cortexa7/openwrt-18.06.0-rc2-sunxi-cortexa7-sun7i-a20-olinuxino-lime-ext4-sdcard.img.gz;1;0;1;5.30 MB;5.30 MB
/releases/17.01.0-rc2/targets/rb532/generic/lede-17.01.0-rc2-r3131-42f3c1f-rb532-default-rootfs.tar.gz;1;0;1;175.75 KB;175.75 KB
//snapshots/targets/at91/legacy/openwrt-at91-legacy-at91sam9x25ek-ext4-root.ubi.gz;1;0;1;1.98 MB;1.98 MB
/releases/18.06.0/targets/brcm2708/bcm2709/openwrt-18.06.0-brcm2708-bcm2709-rpi-2-squashfs-factory.img.gz;1;0;1;7.74 MB;7.74 MB
/releases/18.06.0-rc1/targets/sunxi/cortexa8/openwrt-18.06.0-rc1-sunxi-cortexa8-sun4i-a10-pcduino-ext4-sdcard.img.gz;1;0;1;5.68 MB;5.68 MB
/releases/19.07.0-rc2/targets/at91/sama5/openwrt-19.07.0-rc2-at91-sama5-at91-sama5d2_ptc_ek-ext4-zImage.gz;1;0;1;3.31 MB;3.31 MB
/releases/18.06.5/targets/ar71xx/nand/openwrt-18.06.5-ar71xx-nand-c-60-squashfs-sysupgrade.tar;1;0;1;3.71 MB;3.71 MB
/releases/18.06.0-rc2/targets/sunxi/cortexa8/openwrt-18.06.0-rc2-sunxi-cortexa8-sun4i-a10-cubieboard-ext4-sdcard.img.gz;1;0;1;5.24 MB;5.24 MB
/releases/18.06.0-rc2/targets/sunxi/cortexa53/openwrt-18.06.0-rc2-sunxi-cortexa53-sun50i-a64-sopine-baseboard-ext4-sdcard.img.gz;1;0;1;6.36 MB;6.36 MB
/releases/18.06.6/targets/brcm2708/bcm2708/openwrt-18.06.6-brcm2708-bcm2708-rpi-ext4-sysupgrade.img.gz;1;0;1;8.73 MB;8.73 MB
/snapshots/targets/scheduled_for_removal/brcm2708/bcm2711/openwrt-brcm2708-bcm2711-rpi-4-squashfs-factory.img.gz;1;0;1;0;0
/releases/18.06.0-rc2/targets/ar71xx/generic/openwrt-18.06.0-rc2-ar71xx-generic-vmlinux.lzma;1;0;1;271.54 KB;271.54 KB
/releases/19.07.0-rc1/targets/sunxi/cortexa7/openwrt-19.07.0-rc1-sunxi-cortexa7-sun7i-a20-cubietruck-ext4-sdcard.img.gz;1;0;1;6.42 MB;6.42 MB
/releases/17.01.6/targets/rb532/generic/lede-17.01.6-rb532-default-rootfs.tar.gz;1;0;1;143.75 KB;143.75 KB
/releases/19.07.2/targets/armvirt/64/openwrt-19.07.2-armvirt-64-root.squashfs.gz;1;0;1;1.65 MB;1.65 MB
/releases/19.07.0-rc1/targets/apm821xx/sata/openwrt-19.07.0-rc1-apm821xx-sata-wd_mybooklive-squashfs-factory.img.gz;1;0;1;5.40 MB;5.40 MB
/releases/17.01.6/targets/oxnas/generic/lede-17.01.6-oxnas-pogoplug-v3-squashfs-sysupgrade.tar;1;0;1;159.75 KB;159.75 KB
/releases/18.06.0-rc1/targets/octeontx/generic/openwrt-18.06.0-rc1-octeontx-default-rootfs.tar.gz;1;0;1;1.97 MB;1.97 MB
/releases/18.06.0-rc1/targets/apm821xx/sata/openwrt-18.06.0-rc1-apm821xx-sata-wd_mybooklive-ext4-rootfs.img.gz;1;0;1;5.59 MB;5.59 MB
/releases/19.07.1/targets/apm821xx/sata/openwrt-19.07.1-apm821xx-sata-wd_mybooklive-ext4-factory.img.gz;1;0;1;6.55 MB;6.55 MB
//snapshots/targets/omap/generic/openwrt-omap-ti_omap3-beagle-ext4-sdcard.img.gz;1;0;1;7.17 MB;7.17 MB
/releases/17.01.0-rc1/targets/brcm2708/bcm2709/lede-17.01.0-rc1-r3042-ec095b5-brcm2708-bcm2709-rpi-2-ext4-sdcard.img.gz;1;0;1;239.75 KB;239.75 KB
/releases/19.07.1/targets/sunxi/cortexa53/openwrt-19.07.1-sunxi-cortexa53-sun50i-h5-orangepi-pc2-squashfs-sdcard.img.gz;1;0;1;6.02 MB;6.02 MB
/releases/19.07.0-rc2/targets/mvebu/cortexa53/openwrt-19.07.0-rc2-mvebu-cortexa53-globalscale_espressobin-emmc-squashfs-sdcard.img.gz;1;0;1;5.55 MB;5.55 MB
/releases/17.01.4/targets/x86/generic/lede-17.01.4-x86-generic-rootfs-ext4.img.gz;1;0;1;175.75 KB;175.75 KB
/releases/19.07.0-rc1/targets/apm821xx/sata/openwrt-19.07.0-rc1-apm821xx-sata-wd_mybooklive-ext4-factory.img.gz;1;0;1;6.52 MB;6.52 MB
//snapshots/targets/sunxi/cortexa7/openwrt-sunxi-cortexa7-olimex_a20-olinuxino-lime2-squashfs-sdcard.img.gz;1;0;1;5.66 MB;5.66 MB
/releases/18.06.0-rc1/targets/sunxi/cortexa53/openwrt-18.06.0-rc1-sunxi-cortexa53-sun50i-h5-nanopi-neo-plus2-squashfs-sdcard.img.gz;1;0;1;5.59 MB;5.59 MB
//snapshots/targets/sunxi/cortexa7/openwrt-sunxi-cortexa7-xunlong_orangepi-pc-plus-squashfs-sdcard.img.gz;1;0;1;5.56 MB;5.56 MB
/releases/19.07.0-rc1/targets/sunxi/cortexa7/openwrt-19.07.0-rc1-sunxi-cortexa7-sun8i-h3-orangepi-2-ext4-sdcard.img.gz;1;0;1;5.59 MB;5.59 MB
/releases/18.06.0-rc1/targets/brcm2708/bcm2709/openwrt-18.06.0-rc1-brcm2708-bcm2709-rpi-2-squashfs-sdcard.img.gz;1;0;1;7.73 MB;7.73 MB
/releases/18.06.9/targets/x86/generic/openwrt-18.06.9-x86-generic-combined-squashfs.img.gz;1;56;57;13.14 MB;236.06 KB
/releases/18.06.7/targets/sunxi/cortexa7/openwrt-18.06.7-sunxi-cortexa7-sun7i-a20-lamobo-r1-ext4-sdcard.img.gz;1;0;1;1.28 MB;1.28 MB
//releases/19.07.3/targets/omap/generic/openwrt-19.07.3-omap-ti_am335x-evm-ext4-sdcard.img.gz;1;0;1;6.67 MB;6.67 MB
/releases/17.01.6/targets/sunxi/generic/lede-17.01.6-sunxi-sun8i-h3-orangepi-plus-ext4-sdcard.img.gz;1;0;1;143.75 KB;143.75 KB
//snapshots/targets/at91/legacy/openwrt-at91-legacy-lmu5000-ext4-factory.bin.gz;1;0;1;5.32 MB;5.32 MB
/releases/19.07.2/targets/ar71xx/nand/openwrt-19.07.2-ar71xx-nand-r6100-squashfs-sysupgrade.tar;1;0;1;1.27 MB;1.27 MB
/releases/19.07.1/targets/sunxi/cortexa53/openwrt-19.07.1-sunxi-cortexa53-sun50i-h5-orangepi-zero-plus-ext4-sdcard.img.gz;1;0;1;6.78 MB;6.78 MB
/releases/18.06.0-rc1/targets/sunxi/cortexa7/openwrt-18.06.0-rc1-sunxi-cortexa7-sun7i-a20-olinuxino-lime2-squashfs-sdcard.img.gz;1;0;1;4.54 MB;4.54 MB
/releases/19.07.1/targets/mvebu/cortexa9/openwrt-19.07.1-mvebu-cortexa9-solidrun_clearfog-base-a1-squashfs-sdcard.img.gz;1;0;1;4.72 MB;4.72 MB
/releases/19.07.0-rc2/targets/mvebu/cortexa9/openwrt-19.07.0-rc2-mvebu-cortexa9-solidrun_clearfog-pro-a1-squashfs-sdcard.img.gz;1;0;1;4.71 MB;4.71 MB
/releases/17.01.2/targets/ipq806x/generic/lede-17.01.2-ipq806x-NBG6817-squashfs-sysupgrade.tar;1;0;1;255.75 KB;255.75 KB
/releases/18.06.0-rc1/targets/brcm2708/bcm2708/openwrt-18.06.0-rc1-brcm2708-bcm2708-rpi-ext4-sdcard.img.gz;1;0;1;8.68 MB;8.68 MB
//releases/19.07.3/targets/octeon/generic/openwrt-19.07.3-octeon-erlite-squashfs-sysupgrade.tar;1;0;1;8.84 MB;8.84 MB
/releases/19.07.0-rc1/targets/oxnas/ox820/openwrt-19.07.0-rc1-oxnas-ox820-cloudengines_pogoplug-series-3-squashfs-sysupgrade.tar;1;0;1;4.90 MB;4.90 MB
/releases/17.01.5/targets/octeon/generic/lede-17.01.5-octeon-er-squashfs-sysupgrade.tar;1;0;1;7.41 MB;7.41 MB
/snapshots/targets/scheduled_for_removal/ar71xx/mikrotik/openwrt-ar71xx-mikrotik-vmlinux-initramfs.lzma;1;0;1;0;0
/releases/18.06.1/targets/archs38/generic/openwrt-18.06.1-archs38-generic-Default-sdcard-vfat-ext4.img.gz;1;0;1;5.89 MB;5.89 MB
//snapshots/targets/sunxi/cortexa8/openwrt-sunxi-cortexa8-linksprite_a10-pcduino-ext4-sdcard.img.gz;1;0;1;6.85 MB;6.85 MB
/releases/17.01.7/targets/sunxi/generic/lede-17.01.7-sunxi-sun7i-a20-cubieboard2-squashfs-sdcard.img.gz;1;0;1;319.75 KB;319.75 KB
/releases/18.06.9/targets/ar71xx/generic/openwrt-18.06.9-ar71xx-generic-vmlinux.lzma;1;0;1;287.54 KB;287.54 KB
/releases/19.07.0-rc2/targets/mvebu/cortexa53/openwrt-19.07.0-rc2-mvebu-cortexa53-globalscale_espressobin-ext4-sdcard.img.gz;1;0;1;6.37 MB;6.37 MB
//snapshots/targets/sunxi/cortexa7/openwrt-sunxi-cortexa7-linksprite_pcduino3-squashfs-sdcard.img.gz;1;0;1;5.99 MB;5.99 MB
/releases/18.06.0/targets/pistachio/generic/openwrt-18.06.0-pistachio-rootfs.tar.gz;1;0;1;1.93 MB;1.93 MB
/releases/19.07.1/targets/brcm2708/bcm2710/openwrt-19.07.1-brcm2708-bcm2710-rpi-3-squashfs-factory.img.gz;1;0;1;10.94 MB;10.94 MB
/releases/17.01.0-rc1/targets/gemini/raidsonic/lede-17.01.0-rc1-r3042-ec095b5-gemini-raidsonic-nas4220-rd.gz;1;0;1;447.75 KB;447.75 KB
/releases/18.06.7/targets/sunxi/cortexa7/openwrt-18.06.7-sunxi-cortexa7-sun7i-a20-lamobo-r1-squashfs-sdcard.img.gz;1;0;1;1.30 MB;1.30 MB
/releases/18.06.4/targets/ar71xx/nand/openwrt-18.06.4-ar71xx-nand-c-60-squashfs-sysupgrade.tar;1;0;1;3.70 MB;3.70 MB
/releases/17.01.7/targets/sunxi/generic/lede-17.01.7-sunxi-sun5i-a13-olimex-som-ext4-sdcard.img.gz;1;0;1;143.75 KB;143.75 KB
/releases/18.06.3/targets/ramips/mt7621/openwrt-18.06.3-ramips-mt7621-r6220-squashfs-sysupgrade.tar;1;0;1;4.16 MB;4.16 MB
/releases/17.01.6/targets/sunxi/generic/lede-17.01.6-sunxi-sun4i-a10-pcduino-squashfs-sdcard.img.gz;1;0;1;159.75 KB;159.75 KB
/releases/19.07.2/targets/mvebu/cortexa53/openwrt-19.07.2-mvebu-cortexa53-globalscale_espressobin-emmc-ext4-sdcard.img.gz;1;0;1;1.31 MB;1.31 MB
/releases/19.07.0-rc1/targets/sunxi/cortexa8/openwrt-19.07.0-rc1-sunxi-cortexa8-sun4i-a10-cubieboard-squashfs-sdcard.img.gz;1;0;1;4.71 MB;4.71 MB
/releases/19.07.1/targets/mvebu/cortexa53/openwrt-19.07.1-mvebu-cortexa53-globalscale_espressobin-emmc-ext4-sdcard.img.gz;1;0;1;6.39 MB;6.39 MB
/releases/19.07.0-rc2/targets/ar71xx/nand/openwrt-19.07.0-rc2-ar71xx-nand-rambutan-squashfs-sysupgrade.tar;1;0;1;4.05 MB;4.05 MB
/releases/19.07.2/targets/layerscape/armv8_64b/openwrt-19.07.2-layerscape-armv8_64b-ls1088ardb-sdboot-ext4-sdcard.img.gz;1;0;1;1.73 MB;1.73 MB
/snapshots/targets/scheduled_for_removal/ar71xx/generic/kernel-debug.tar.bz2;1;0;1;0;0
//snapshots/targets/sunxi/cortexa7/openwrt-sunxi-cortexa7-olimex_a20-olinuxino-lime2-emmc-squashfs-sdcard.img.gz;1;0;1;5.67 MB;5.67 MB
/releases/19.07.1/targets/sunxi/cortexa8/openwrt-19.07.1-sunxi-cortexa8-sun4i-a10-pcduino-ext4-sdcard.img.gz;1;0;1;6.07 MB;6.07 MB
/releases/18.06.7/targets/sunxi/cortexa8/openwrt-18.06.7-sunxi-cortexa8-sun4i-a10-pcduino-ext4-sdcard.img.gz;1;0;1;1.30 MB;1.30 MB
/releases/18.06.2/targets/octeontx/generic/openwrt-18.06.2-octeontx-default-rootfs.tar.gz;1;0;1;1.27 MB;1.27 MB
/releases/19.07.0-rc2/targets/oxnas/ox820/openwrt-19.07.0-rc2-oxnas-ox820-shuttle_kd20-ubifs-sysupgrade.tar;1;0;1;9.19 MB;9.19 MB
/releases/18.06.4/targets/apm821xx/nand/openwrt-18.06.4-apm821xx-nand-netgear_wndr4700-squashfs-sysupgrade.tar;1;0;1;5.21 MB;5.21 MB
/releases/18.06.0-rc1/targets/sunxi/cortexa8/openwrt-18.06.0-rc1-sunxi-cortexa8-sun5i-a13-olinuxino-ext4-sdcard.img.gz;1;0;1;5.70 MB;5.70 MB
/snapshots/faillogs/arm_arm926ej-s/packages/perl-parse-recdescent/host-compile.txt;1;0;1;429 Bytes;429 Bytes
/releases/18.06.6/targets/armvirt/64/openwrt-18.06.6-armvirt-64-rootfs.cpio.gz;1;0;1;20 Bytes;20 Bytes
/releases/18.06.1/targets/x86/64//openwrt-18.06.1-x86-64-generic-rootfs.tar.gz;1;0;1;2.81 MB;2.81 MB
/releases/19.07.0-rc1/targets/imx6/generic/openwrt-19.07.0-rc1-imx6-rootfs.tar.gz;1;0;1;2.55 MB;2.55 MB
/releases/19.07.2/targets/apm821xx/sata/openwrt-19.07.2-apm821xx-sata-wd_mybooklive-squashfs-factory.img.gz;1;0;1;5.41 MB;5.41 MB
/releases/18.06-SNAPSHOT/targets/ath25/generic/openwrt-18.06-snapshot-r8073-5625f5bc36-ath25-generic-kernel.lzma;1;0;1;255.54 KB;255.54 KB
/releases/19.07.0-rc1/targets/sunxi/cortexa7/openwrt-19.07.0-rc1-sunxi-cortexa7-sun7i-a20-cubietruck-squashfs-sdcard.img.gz;1;0;1;5.44 MB;5.44 MB
/snapshots/targets/scheduled_for_removal/brcm47xx/mips74k/kernel-debug.tar.bz2;1;0;1;0;0
/releases/18.06.0-rc1/targets/sunxi/cortexa7/openwrt-18.06.0-rc1-sunxi-cortexa7-sun7i-a20-olinuxino-lime2-emmc-squashfs-sdcard.img.gz;1;0;1;4.54 MB;4.54 MB
/releases/17.01.2/targets/ipq806x/generic/lede-17.01.2-ipq806x-R7500v2-squashfs-sysupgrade.tar;1;0;1;191.75 KB;191.75 KB
/releases/18.06.9/targets/apm821xx/nand/openwrt-18.06.9-apm821xx-nand-meraki_mr24-squashfs-sysupgrade.tar;1;0;1;4.18 MB;4.18 MB
/releases/18.06.0-rc2/targets/at91/sama5d4/openwrt-18.06.0-rc2-at91-sama5d4-rootfs.tar.gz;1;0;1;1.97 MB;1.97 MB
//snapshots/targets/sunxi/cortexa7/openwrt-sunxi-cortexa7-olimex_a20-olinuxino-lime-ext4-sdcard.img.gz;1;0;1;6.31 MB;6.31 MB
/releases/19.07.0-rc2/targets/octeontx/generic/openwrt-19.07.0-rc2-octeontx-default-rootfs.tar.gz;1;0;1;2.04 MB;2.04 MB
/releases/17.01.0-rc1/targets/sunxi/generic/lede-17.01.0-rc1-r3042-ec095b5-sunxi-sun4i-a10-cubieboard-squashfs-sdcard.img.gz;1;0;1;127.75 KB;127.75 KB
/snapshots/targets/scheduled_for_removal/brcm2708/bcm2711/kernel-debug.tar.bz2;1;0;1;0;0
//snapshots/targets/sunxi/cortexa7/openwrt-sunxi-cortexa7-friendlyarm_nanopi-neo-ext4-sdcard.img.gz;1;0;1;6.26 MB;6.26 MB
/releases/19.07.0-rc2/targets/at91/sama5/openwrt-19.07.0-rc2-at91-sama5-at91-sama5d27_som1_ek-ext4-sdcard.img.gz;1;0;1;5.93 MB;5.93 MB
/releases/18.06.4/targets/apm821xx/sata/openwrt-18.06.4-apm821xx-sata-wd_mybooklive-ext4-rootfs.img.gz;1;0;1;5.62 MB;5.62 MB
/releases/19.07.1/targets/sunxi/cortexa8/openwrt-19.07.1-sunxi-cortexa8-sun4i-a10-pcduino-squashfs-sdcard.img.gz;1;0;1;5.10 MB;5.10 MB
/releases/17.01.0-rc1/targets/x86/64/lede-17.01.0-rc1-r3042-ec095b5-x86-64-combined-ext4.img.gz;1;0;1;95.75 KB;95.75 KB
/releases/17.01.7/targets/oxnas/generic/lede-17.01.7-oxnas-akitio-squashfs-sysupgrade.tar;1;0;1;159.75 KB;159.75 KB
/releases/19.07.0-rc2/targets/ar71xx/nand/openwrt-19.07.0-rc2-ar71xx-nand-wndr3700v4-squashfs-sysupgrade.tar;1;0;1;4.51 MB;4.51 MB
/releases/19.07.0-rc2/targets/brcm2708/bcm2708/openwrt-19.07.0-rc2-brcm2708-bcm2708-rpi-ext4-sysupgrade.img.gz;1;0;1;11.49 MB;11.49 MB
//snapshots/targets/mvebu/cortexa72/openwrt-mvebu-cortexa72-marvell_armada8040-db-ext4-sdcard.img.gz;1;0;1;7.72 MB;7.72 MB
//snapshots/targets/mvebu/cortexa53/openwrt-mvebu-cortexa53-globalscale_espressobin-emmc-squashfs-sdcard.img.gz;1;0;1;6.89 MB;6.89 MB
//snapshots/targets/sunxi/cortexa7/openwrt-sunxi-cortexa7-xunlong_orangepi-2-squashfs-sdcard.img.gz;1;0;1;5.56 MB;5.56 MB
/releases/17.01.7/targets/x86/generic/lede-17.01.7-x86-generic-rootfs-ext4.img.gz;1;0;1;159.75 KB;159.75 KB
/releases/19.07.0-rc1/targets/at91/sama5/openwrt-19.07.0-rc1-at91-sama5-at91-sama5d2_ptc_ek-ext4-sdcard.img.gz;1;0;1;5.94 MB;5.94 MB
/releases/18.06.0-rc2/targets/omap/generic/openwrt-18.06.0-rc2-omap-am335x-boneblack-ext4-sdcard.img.gz;1;0;1;5.74 MB;5.74 MB
/releases/17.01.6/targets/sunxi/generic/lede-17.01.6-sunxi-sun5i-a13-olinuxino-ext4-sdcard.img.gz;1;0;1;143.75 KB;143.75 KB
/releases/18.06.0-rc2/targets/sunxi/cortexa7/openwrt-18.06.0-rc2-sunxi-cortexa7-sun7i-a20-lamobo-r1-squashfs-sdcard.img.gz;1;0;1;5.05 MB;5.05 MB
//snapshots/targets/mvebu/cortexa53/openwrt-mvebu-cortexa53-methode_udpu-firmware.tgz;1;0;1;15.08 MB;15.08 MB
/releases/19.07.1/targets/mvebu/cortexa72/openwrt-19.07.1-mvebu-cortexa72-marvell_armada7040-db-ext4-sdcard.img.gz;1;0;1;6.41 MB;6.41 MB
/releases/17.01.7/targets/mediatek/generic/lede-17.01.7-mediatek-NAND-squashfs-sysupgrade.tar;1;0;1;4.04 MB;4.04 MB
/releases/19.07.2/targets/armvirt/64/openwrt-19.07.2-armvirt-64-rootfs.cpio.gz;1;0;1;20 Bytes;20 Bytes
/releases/19.07.0-rc1/targets/sunxi/cortexa7/openwrt-19.07.0-rc1-sunxi-cortexa7-sun8i-h3-orangepi-pc-plus-squashfs-sdcard.img.gz;1;0;1;4.76 MB;4.76 MB
/releases/19.07.0-rc1/targets/sunxi/cortexa7/openwrt-19.07.0-rc1-sunxi-cortexa7-sun8i-h3-orangepi-pc-ext4-sdcard.img.gz;1;0;1;5.60 MB;5.60 MB
/releases/19.07.0-rc1/targets/sunxi/cortexa53/openwrt-19.07.0-rc1-sunxi-cortexa53-sun50i-h5-nanopi-neo-plus2-squashfs-sdcard.img.gz;1;0;1;5.98 MB;5.98 MB
//snapshots/targets/sunxi/cortexa7/openwrt-sunxi-cortexa7-xunlong_orangepi-one-ext4-sdcard.img.gz;1;0;1;6.28 MB;6.28 MB
/releases/19.07.0-rc2/targets/ar71xx/nand/openwrt-19.07.0-rc2-ar71xx-nand-wndr4300-squashfs-sysupgrade.tar;1;0;1;4.51 MB;4.51 MB
//snapshots/targets/mvebu/cortexa53/openwrt-mvebu-cortexa53-glinet_gl-mv1000-squashfs-sdcard.img.gz;1;0;1;6.89 MB;6.89 MB
/releases/19.07.1/targets/sunxi/cortexa8/openwrt-19.07.1-sunxi-cortexa8-sun4i-a10-olinuxino-lime-squashfs-sdcard.img.gz;1;0;1;4.72 MB;4.72 MB
/releases/18.06.4/targets/sunxi/cortexa53/openwrt-18.06.4-sunxi-cortexa53-sun50i-a64-pine64-plus-ext4-sdcard.img.gz;1;0;1;143.54 KB;143.54 KB
/releases/19.07.1/targets/sunxi/cortexa7/openwrt-19.07.1-sunxi-cortexa7-sun8i-h3-bananapi-m2-plus-ext4-sdcard.img.gz;1;0;1;6.96 MB;6.96 MB
/releases/19.07.0-rc1/targets/apm821xx/sata/openwrt-19.07.0-rc1-apm821xx-sata-wd_mybooklive-squashfs-sysupgrade.img.gz;1;0;1;5.40 MB;5.40 MB
/releases/19.07.0/targets/ar71xx/nand/openwrt-19.07.0-ar71xx-nand-nbg6716-squashfs-sysupgrade.tar;1;0;1;4.76 MB;4.76 MB
/releases/18.06.9/targets/x86/64/openwrt-18.06.9-x86-64-rootfs-ext4.img.gz;1;0;1;3.09 MB;3.09 MB
/releases/19.07.0-rc1/targets/ar71xx/nand/openwrt-19.07.0-rc1-ar71xx-nand-hiveap-121-squashfs-sysupgrade.tar;1;0;1;4.07 MB;4.07 MB
//snapshots/targets/at91/sama5/openwrt-at91-sama5-rootfs.tar.gz;1;0;1;2.17 MB;2.17 MB
/releases/17.01.0/targets/octeon/generic/lede-17.01.0-r3205-59508e3-octeon-er-squashfs-sysupgrade.tar;1;0;1;2.80 MB;2.80 MB
/releases/18.06.4/targets/ar71xx/nand/openwrt-18.06.4-ar71xx-nand-nbg6716-squashfs-sysupgrade.tar;1;0;1;4.76 MB;4.76 MB
/releases/17.01.7/targets/ath25/generic/lede-17.01.7-ath25-generic-kernel.gz;1;0;1;159.75 KB;159.75 KB
/releases/18.06.0-rc2/targets/sunxi/cortexa53/openwrt-18.06.0-rc2-sunxi-cortexa53-sun50i-a64-pine64-plus-ext4-sdcard.img.gz;1;0;1;6.36 MB;6.36 MB
/releases/18.06.0-rc2/targets/apm821xx/sata/openwrt-18.06.0-rc2-apm821xx-sata-wd_mybooklive-duo-ext4-rootfs.img.gz;1;0;1;6.09 MB;6.09 MB
/releases/18.06.0-rc2/targets/at91/sama5d2/openwrt-18.06.0-rc2-at91-sama5d2-rootfs.tar.gz;1;0;1;1.97 MB;1.97 MB
/releases/17.01.0-rc1/targets/sunxi/generic/lede-17.01.0-rc1-r3042-ec095b5-sunxi-sun4i-a10-pcduino-squashfs-sdcard.img.gz;1;0;1;143.75 KB;143.75 KB
/releases/17.01.7/targets/ar71xx/nand/lede-17.01.7-ar71xx-nand-r6100-squashfs-sysupgrade.tar;1;0;1;159.75 KB;159.75 KB
/releases/17.01.7/targets/mvebu/generic/lede-17.01.7-mvebu-armada-388-clearfog-sdcard.img.gz;1;0;1;143.75 KB;143.75 KB
/snapshots/targets/scheduled_for_removal/brcm2708/bcm2710/openwrt-brcm2708-bcm2710-rpi-3-ext4-sysupgrade.img.gz;1;0;1;0;0
/releases/18.06.0-rc2/targets/sunxi/cortexa7/openwrt-18.06.0-rc2-sunxi-cortexa7-sun7i-a20-olinuxino-micro-ext4-sdcard.img.gz;1;0;1;5.31 MB;5.31 MB
/releases/18.06.2/targets/apm821xx/nand/openwrt-18.06.2-apm821xx-nand-meraki_mr24-squashfs-sysupgrade.tar;1;0;1;4.18 MB;4.18 MB
/releases/18.06.0-rc2/targets/sunxi/cortexa7/openwrt-18.06.0-rc2-sunxi-cortexa7-sun8i-h3-orangepi-plus-ext4-sdcard.img.gz;1;0;1;5.25 MB;5.25 MB
/releases/18.06.0/targets/brcm2708/bcm2709/openwrt-18.06.0-brcm2708-bcm2709-rpi-2-ext4-factory.img.gz;1;0;1;8.83 MB;8.83 MB
/releases/19.07.0-rc2/targets/mvebu/cortexa72/openwrt-19.07.0-rc2-mvebu-cortexa72-marvell_macchiatobin-squashfs-sdcard.img.gz;1;0;1;5.58 MB;5.58 MB
/releases/18.06.0-rc1/targets/mvebu/cortexa9/omnia-medkit-openwrt-18.06.0-rc1-mvebu-cortexa9-turris-omnia-initramfs.tar.gz;1;0;1;3.69 MB;3.69 MB
/releases/19.07.2/targets/arc770/generic/openwrt-19.07.2-arc770-generic-root.ext4.gz;1;0;1;2.95 MB;2.95 MB
/releases/17.01.0-rc1/targets/brcm63xx/generic/lede-17.01.0-rc1-r3042-ec095b5-brcm63xx-generic-livebox-vmlinux.gz;1;0;1;463.75 KB;463.75 KB
/releases/17.01.0-rc2/targets/ipq806x/generic/lede-17.01.0-rc2-r3131-42f3c1f-ipq806x-AP148-squashfs-nand-sysupgrade.tar;1;0;1;255.75 KB;255.75 KB
/releases/18.06.2/targets/apm821xx/nand/openwrt-18.06.2-apm821xx-nand-meraki_mx60-squashfs-sysupgrade.tar;1;0;1;5.06 MB;5.06 MB
/releases/17.01.0-rc2/targets/sunxi/generic/lede-17.01.0-rc2-r3131-42f3c1f-sunxi-sun5i-a13-olimex-som-ext4-sdcard.img.gz;1;0;1;271.75 KB;271.75 KB
/releases/18.06.0-rc1/targets/x86/64/openwrt-18.06.0-rc1-x86-64-combined-squashfs.img.gz;1;0;1;5.59 MB;5.59 MB
/releases/18.06.0-rc1/targets/sunxi/cortexa53/openwrt-18.06.0-rc1-sunxi-cortexa53-sun50i-a64-pine64-plus-squashfs-sdcard.img.gz;1;0;1;5.59 MB;5.59 MB
//snapshots/targets/sunxi/cortexa7/openwrt-sunxi-cortexa7-friendlyarm_nanopi-m1-plus-squashfs-sdcard.img.gz;1;0;1;6.71 MB;6.71 MB
/releases/18.06-SNAPSHOT/targets/omap/generic/openwrt-18.06-snapshot-r8077-7cbbab7246-omap-omap4-panda-ext4-sdcard.img.gz;1;0;1;5.75 MB;5.75 MB
/releases/18.06-SNAPSHOT/targets/omap/generic/openwrt-18.06-snapshot-r8073-5625f5bc36-omap-am335x-evm-ext4-sdcard.img.gz;1;0;1;5.86 MB;5.86 MB
/releases/18.06.7/targets/sunxi/cortexa8/openwrt-18.06.7-sunxi-cortexa8-sun4i-a10-olinuxino-lime-ext4-sdcard.img.gz;1;0;1;1.27 MB;1.27 MB
/releases/19.07.0-rc1/targets/x86/64/openwrt-19.07.0-rc1-x86-64-rootfs-squashfs.img.gz;1;0;1;2.82 MB;2.82 MB
/releases/18.06.0-rc2/targets/sunxi/cortexa7/openwrt-18.06.0-rc2-sunxi-cortexa7-sun8i-h3-orangepi-2-ext4-sdcard.img.gz;1;0;1;5.25 MB;5.25 MB
/releases/18.06.0-rc1/targets/mvebu/cortexa9/openwrt-18.06.0-rc1-mvebu-cortexa9-turris-omnia-sysupgrade.img.gz;1;0;1;5.15 MB;5.15 MB
/releases/19.07.0-rc2/targets/at91/sam9x/openwrt-19.07.0-rc2-at91-sam9x-at91sam9g20ek_2mmc-ext4-root.ubi.gz;1;0;1;2.47 MB;2.47 MB
/snapshots/targets/scheduled_for_removal/ixp4xx/generic/kernel-debug.tar.bz2;1;0;1;0;0
//snapshots/targets/ath25/generic/openwrt-ath25-generic-kernel.lzma;1;0;1;1.56 MB;1.56 MB
/releases/19.07.0-rc2/targets/layerscape/armv8_64b/openwrt-19.07.0-rc2-layerscape-armv8_64b-ls1012afrwy-ext4-firmware.bin.gz;1;0;1;304.60 KB;304.60 KB
/releases/19.07-SNAPSHOT/targets/x86/generic/openwrt-19.07-snapshot-r11235-2a8279c161-x86-generic-combined-ext4.img.gz;1;0;1;2.27 MB;2.27 MB
/releases/19.07.0-rc1/targets/arc770/generic/openwrt-19.07.0-rc1-arc770-generic-root.ext4.gz;1;0;1;2.93 MB;2.93 MB
/releases/19.07.0-rc1/targets/layerscape/armv7/openwrt-19.07.0-rc1-layerscape-armv7-ls1021aiot-sdboot-ext4-sdcard.img.gz;1;0;1;6.26 MB;6.26 MB
/releases/18.06-SNAPSHOT/targets/at91/legacy/openwrt-18.06-snapshot-r8080-9f2a40c72f-at91-legacy-at91sam9263ek-ext4-zImage.gz;1;0;1;3.11 MB;3.11 MB
/releases/19.07.2/targets/mvebu/cortexa72/openwrt-19.07.2-mvebu-cortexa72-marvell_armada7040-db-ext4-sdcard.img.gz;1;0;1;1.30 MB;1.30 MB
//snapshots/targets/rockchip/armv8/openwrt-rockchip-armv8-pine64_rockpro64-ext4-sysupgrade.img.gz;1;0;1;8.65 MB;8.65 MB
/releases/18.06.7/targets/sunxi/cortexa7/openwrt-18.06.7-sunxi-cortexa7-sun7i-a20-cubietruck-ext4-sdcard.img.gz;1;0;1;1.27 MB;1.27 MB
/releases/19.07.1/targets/brcm2708/bcm2709/openwrt-19.07.1-brcm2708-bcm2709-rpi-2-ext4-sysupgrade.img.gz;1;0;1;11.98 MB;11.98 MB
/releases/18.06.0-rc1/targets/armvirt/64/openwrt-18.06.0-rc1-armvirt-64-rootfs.cpio.gz;1;0;1;1.96 MB;1.96 MB
/releases/18.06.4/targets/archs38/generic/openwrt-18.06.4-archs38-generic-root.ext4.gz;1;0;1;2.81 MB;2.81 MB
/releases/17.01.5/targets/armvirt/generic/lede-17.01.5-armvirt-root.squashfs.gz;1;0;1;1.41 MB;1.41 MB
/releases/17.01.0/targets/gemini/raidsonic/lede-17.01.0-r3205-59508e3-gemini-raidsonic-nas4220-hddapp.tgz;1;0;1;3.12 MB;3.12 MB
/releases/19.07.0-rc2/targets/omap/generic/openwrt-19.07.0-rc2-omap-ti_am335x-evm-ext4-sdcard.img.gz;1;0;1;6.65 MB;6.65 MB
/releases/18.06.0-rc2/targets/mvebu/cortexa9/omnia-medkit-openwrt-18.06.0-rc2-mvebu-cortexa9-turris-omnia-initramfs.tar.gz;1;0;1;3.70 MB;3.70 MB
/releases/17.01.6/targets/ar71xx/nand/lede-17.01.6-ar71xx-nand-z1-squashfs-sysupgrade.tar;1;0;1;143.75 KB;143.75 KB
/releases/18.06.4/targets/sunxi/cortexa8/openwrt-18.06.4-sunxi-cortexa8-sun4i-a10-cubieboard-ext4-sdcard.img.gz;1;0;1;159.54 KB;159.54 KB
/releases/19.07.0-rc1/targets/sunxi/cortexa8/openwrt-19.07.0-rc1-sunxi-cortexa8-sun5i-a13-olimex-som-squashfs-sdcard.img.gz;1;0;1;5.07 MB;5.07 MB
/releases/18.06-SNAPSHOT/targets/omap/generic/openwrt-18.06-snapshot-r8077-7cbbab7246-omap-omap3-beagle-ext4-sdcard.img.gz;1;0;1;5.88 MB;5.88 MB
/releases/19.07.3/targets/pistachio/generic/openwrt-19.07.3-pistachio-rootfs.tar.gz;1;0;1;2.00 MB;2.00 MB
/releases/19.07.0-rc2/targets/x86/generic/openwrt-19.07.0-rc2-x86-generic-rootfs-ext4.img.gz;1;0;1;3.96 MB;3.96 MB
/releases/19.07.2/targets/mediatek/mt7623/openwrt-19.07.2-mediatek-mt7623-7623a-unielec-u7623-02-emmc-512m-squashfs-sysupgrade-emmc.bin.gz;1;0;1;1.28 MB;1.28 MB
/releases/19.07.0-rc1/targets/mvebu/cortexa72/openwrt-19.07.0-rc1-mvebu-cortexa72-marvell_armada7040-db-squashfs-sdcard.img.gz;1;0;1;5.57 MB;5.57 MB
/releases/17.01.5/targets/archs38/generic/lede-17.01.5-archs38-generic-root.ext4.gz;1;0;1;2.72 MB;2.72 MB
/releases/18.06.0-rc1/targets/sunxi/cortexa7/openwrt-18.06.0-rc1-sunxi-cortexa7-sun7i-a20-cubieboard2-ext4-sdcard.img.gz;1;0;1;5.30 MB;5.30 MB
/releases/19.07.0-rc1/targets/mvebu/cortexa53/openwrt-19.07.0-rc1-mvebu-cortexa53-globalscale_espressobin-v7-squashfs-sdcard.img.gz;1;0;1;5.55 MB;5.55 MB
/releases/19.07.0-rc1/targets/armvirt/64/openwrt-19.07.0-rc1-armvirt-64-root.ext4.gz;1;0;1;2.31 MB;2.31 MB
/releases/19.07.0-rc2/targets/omap/generic/openwrt-19.07.0-rc2-omap-ti_omap4-panda-squashfs-sdcard.img.gz;1;0;1;5.67 MB;5.67 MB
/releases/19.07.2/targets/archs38/generic/openwrt-19.07.2-archs38-generic-root.ext4.gz;1;0;1;2.88 MB;2.88 MB
/releases/19.07.0-rc2/targets/mvebu/cortexa72/openwrt-19.07.0-rc2-mvebu-cortexa72-marvell_macchiatobin-ext4-sdcard.img.gz;1;0;1;6.40 MB;6.40 MB
/releases/17.01.6/targets/omap/generic/lede-17.01.6-omap-default-rootfs.tar.gz;1;0;1;159.75 KB;159.75 KB
/releases/19.07.1/targets/brcm2708/bcm2710/openwrt-19.07.1-brcm2708-bcm2710-rpi-3-squashfs-sysupgrade.img.gz;1;0;1;10.94 MB;10.94 MB
/releases/18.06.0/targets/armvirt/32/openwrt-18.06.0-armvirt-32-root.ext4.gz;1;0;1;2.12 MB;2.12 MB
/releases/17.01-SNAPSHOT/targets/x86/legacy/lede-17.01-snapshot-r4046-beaa2ec-x86-legacy-generic-rootfs.tar.gz;1;0;1;127.75 KB;127.75 KB
/releases/19.07.1/targets/sunxi/cortexa8/openwrt-19.07.1-sunxi-cortexa8-sun4i-a10-marsboard-squashfs-sdcard.img.gz;1;0;1;4.72 MB;4.72 MB
//snapshots/targets/sunxi/cortexa7/openwrt-sunxi-cortexa7-xunlong_orangepi-pc-plus-ext4-sdcard.img.gz;1;0;1;6.29 MB;6.29 MB
/releases/19.07.2/targets/sunxi/cortexa7/openwrt-19.07.2-sunxi-cortexa7-sun7i-a20-cubieboard2-ext4-sdcard.img.gz;1;0;1;5.65 MB;5.65 MB
/releases/19.07.1/targets/arc770/generic/openwrt-19.07.1-arc770-generic-Default-sdcard-vfat-ext4.img.gz;1;0;1;5.82 MB;5.82 MB
/releases/18.06.0-rc1/targets/at91/sama5d2/openwrt-18.06.0-rc1-at91-sama5d2-at91-sama5d2_xplained-ext4-root.ubi.gz;1;0;1;2.33 MB;2.33 MB
/releases/18.06.4/targets/pistachio/generic/openwrt-18.06.4-pistachio-rootfs.tar.gz;1;0;1;1.93 MB;1.93 MB
/releases/18.06.5/targets/apm821xx/sata/openwrt-18.06.5-apm821xx-sata-wd_mybooklive-duo-ext4-rootfs.img.gz;1;0;1;6.13 MB;6.13 MB
/releases/18.06.7/targets/sunxi/cortexa7/openwrt-18.06.7-sunxi-cortexa7-sun7i-a20-pcduino3-ext4-sdcard.img.gz;1;0;1;1.28 MB;1.28 MB
/snapshots/targets/scheduled_for_removal/brcm2708/bcm2708/openwrt-brcm2708-bcm2708-rpi-ext4-sysupgrade.img.gz;1;0;1;0;0
/releases/18.06.4/targets/sunxi/cortexa7/openwrt-18.06.4-sunxi-cortexa7-sun8i-h3-nanopi-neo-ext4-sdcard.img.gz;1;0;1;159.54 KB;159.54 KB
/releases/17.01.0-rc1/targets/sunxi/generic/lede-17.01.0-rc1-r3042-ec095b5-sunxi-sun7i-a20-bananapi-squashfs-sdcard.img.gz;1;0;1;271.75 KB;271.75 KB
/releases/17.01.7/targets/oxnas/generic/lede-17.01.7-oxnas-pogoplug-pro-ubifs-sysupgrade.tar;1;0;1;143.75 KB;143.75 KB
/releases/19.07.0-rc2/targets/x86/legacy/openwrt-19.07.0-rc2-x86-legacy-combined-squashfs.img.gz;1;0;1;6.22 MB;6.22 MB
/releases/19.07.0-rc1/targets/tegra/generic/openwrt-19.07.0-rc1-tegra-compulab_trimslice-squashfs-sdcard.img.gz;1;0;1;5.36 MB;5.36 MB
/releases/19.07.0-rc1/targets/sunxi/cortexa8/openwrt-19.07.0-rc1-sunxi-cortexa8-sun4i-a10-marsboard-ext4-sdcard.img.gz;1;0;1;5.56 MB;5.56 MB
/releases/19.07.0-rc1/targets/sunxi/cortexa7/openwrt-19.07.0-rc1-sunxi-cortexa7-sun8i-h3-bananapi-m2-plus-squashfs-sdcard.img.gz;1;0;1;5.85 MB;5.85 MB
/releases/18.06-SNAPSHOT/targets/omap/generic/openwrt-18.06-snapshot-r8073-5625f5bc36-omap-omap3-beagle-ext4-sdcard.img.gz;1;0;1;5.88 MB;5.88 MB
/releases/18.06.0-rc2/targets/at91/sama5d3/openwrt-18.06.0-rc2-at91-sama5d3-at91-sama5d3_xplained-ext4-sdcard.img.gz;1;0;1;5.62 MB;5.62 MB
/releases/18.06.0-rc1/targets/sunxi/cortexa7/openwrt-18.06.0-rc1-sunxi-cortexa7-sun7i-a20-bananapi-squashfs-sdcard.img.gz;1;0;1;4.47 MB;4.47 MB
//snapshots/targets/sunxi/cortexa7/openwrt-sunxi-cortexa7-xunlong_orangepi-zero-squashfs-sdcard.img.gz;1;0;1;5.54 MB;5.54 MB
/releases/18.06.4/targets/arc770/generic/openwrt-18.06.4-arc770-generic-Default-sdcard-vfat-ext4.img.gz;1;0;1;4.87 MB;4.87 MB
/releases/17.01.4/targets/brcm63xx/smp/lede-17.01.4-brcm63xx-smp-livebox-vmlinux.gz;1;0;1;159.75 KB;159.75 KB
/releases/18.06.7/targets/sunxi/cortexa7/openwrt-18.06.7-sunxi-cortexa7-sun7i-a20-bananapi-squashfs-sdcard.img.gz;1;0;1;1.78 MB;1.78 MB
/releases/19.07.0-rc1/targets/mvebu/cortexa53/openwrt-19.07.0-rc1-mvebu-cortexa53-globalscale_espressobin-v7-emmc-squashfs-sdcard.img.gz;1;0;1;5.55 MB;5.55 MB
/releases/18.06.4/targets/sunxi/cortexa7/openwrt-18.06.4-sunxi-cortexa7-sun7i-a20-cubieboard2-ext4-sdcard.img.gz;1;0;1;143.54 KB;143.54 KB
/releases/19.07.2/targets/sunxi/cortexa7/openwrt-19.07.2-sunxi-cortexa7-sun7i-a20-olinuxino-lime-ext4-sdcard.img.gz;1;0;1;5.64 MB;5.64 MB
//releases/19.07.3/targets/mxs/generic/openwrt-19.07.3-mxs-root.ext4.gz;1;0;1;5.39 MB;5.39 MB
/releases/17.01-SNAPSHOT/targets/archs38/generic/lede-17.01-snapshot-r4046-beaa2ec-archs38-generic-Default-sdcard-vfat-ext4.img.gz;1;0;1;127.75 KB;127.75 KB
/releases/18.06.0-rc2/targets/sunxi/cortexa8/openwrt-18.06.0-rc2-sunxi-cortexa8-sun4i-a10-pcduino-squashfs-sdcard.img.gz;1;0;1;4.74 MB;4.74 MB
/releases/17.01.0-rc1/targets/at91/legacy/lede-17.01.0-rc1-r3042-ec095b5-at91-legacy-default-rootfs.tar.gz;1;0;1;143.75 KB;143.75 KB
/snapshots/targets/scheduled_for_removal/adm5120/router_be/kernel-debug.tar.bz2;1;0;1;0;0
/releases/18.06.0-rc2/targets/sunxi/cortexa8/openwrt-18.06.0-rc2-sunxi-cortexa8-sun5i-a13-olinuxino-squashfs-sdcard.img.gz;1;0;1;4.75 MB;4.75 MB
/releases/18.06.0-rc2/targets/sunxi/cortexa7/openwrt-18.06.0-rc2-sunxi-cortexa7-sun8i-h2-plus-orangepi-r1-ext4-sdcard.img.gz;1;0;1;5.27 MB;5.27 MB
//snapshots/targets/rockchip/armv8/openwrt-rockchip-armv8-friendlyarm_nanopi-r2s-squashfs-sysupgrade.img.gz;1;0;1;7.87 MB;7.87 MB
/releases/19.07.0-rc1/targets/omap/generic/openwrt-19.07.0-rc1-omap-ti_am335x-bone-black-squashfs-sdcard.img.gz;1;0;1;5.72 MB;5.72 MB
/snapshots/targets/scheduled_for_removal/au1000/au1500/kernel-debug.tar.bz2;1;0;1;0;0
//snapshots/targets/sunxi/cortexa7/openwrt-sunxi-cortexa7-xunlong_orangepi-one-squashfs-sdcard.img.gz;1;0;1;5.55 MB;5.55 MB
/releases/17.01.7/targets/mxs/generic/lede-17.01.7-mxs-duckbill-sdcard.img.gz;1;0;1;143.75 KB;143.75 KB
//snapshots/targets/sunxi/cortexa7/openwrt-sunxi-cortexa7-cubietech_cubietruck-squashfs-sdcard.img.gz;1;0;1;6.26 MB;6.26 MB
/snapshots/faillogs/mipsel_24kc/packages/kea/host-compile.txt;1;0;1;37.84 KB;37.84 KB
/releases/17.01.0-rc2/targets/x86/geode/lede-17.01.0-rc2-r3131-42f3c1f-x86-geode-rootfs-ext4.img.gz;1;0;1;271.75 KB;271.75 KB
/releases/19.07.0-rc1/targets/pistachio/generic/openwrt-19.07.0-rc1-pistachio-rootfs.tar.gz;1;0;1;1.99 MB;1.99 MB
/releases/18.06.4/targets/armvirt/64/openwrt-18.06.4-armvirt-64-root.ext4.gz;1;0;1;2.23 MB;2.23 MB
/releases/18.06.0-rc2/targets/sunxi/cortexa7/openwrt-18.06.0-rc2-sunxi-cortexa7-sun7i-a20-lamobo-r1-ext4-sdcard.img.gz;1;0;1;6.08 MB;6.08 MB
/releases/18.06.0-rc1/targets/x86/legacy/openwrt-18.06.0-rc1-x86-legacy-rootfs-ext4.img.gz;1;0;1;3.01 MB;3.01 MB
//snapshots/targets/sunxi/cortexa7/openwrt-sunxi-cortexa7-sinovoip_bananapi-m2-ultra-squashfs-sdcard.img.gz;1;0;1;6.71 MB;6.71 MB
/releases/18.06.0/targets/armvirt/64/openwrt-18.06.0-armvirt-64-rootfs.cpio.gz;1;0;1;1.96 MB;1.96 MB
/releases/18.06.6/targets/armvirt/64/openwrt-18.06.6-armvirt-64-root.ext4.gz;1;0;1;2.24 MB;2.24 MB
/releases/18.06.5/targets/brcm2708/bcm2710/openwrt-18.06.5-brcm2708-bcm2710-rpi-3-squashfs-sysupgrade.img.gz;1;0;1;7.81 MB;7.81 MB
/releases/19.07.0-rc1/targets/gemini/generic/openwrt-19.07.0-rc1-gemini-dlink_dir-685-ext4-sysupgrade.bin.gz;1;0;1;9.01 MB;9.01 MB
/releases/17.01.1/targets/kirkwood/generic/lede-17.01.1-kirkwood-dockstar-squashfs-sysupgrade.tar;1;0;1;159.75 KB;159.75 KB
/releases/19.07.0-rc2/targets/at91/sam9x/openwrt-19.07.0-rc2-at91-sam9x-at91sam9g35ek-ext4-root.ubi.gz;1;0;1;2.47 MB;2.47 MB
//snapshots/targets/at91/legacy/openwrt-at91-legacy-at91sam9g35ek-ext4-root.ubi.gz;1;0;1;1.98 MB;1.98 MB
/releases/17.01.1/targets/kirkwood/generic/lede-17.01.1-kirkwood-iconnect-squashfs-sysupgrade.tar;1;0;1;239.75 KB;239.75 KB
/releases/18.06.2/targets/brcm2708/bcm2709/openwrt-18.06.2-brcm2708-bcm2709-rpi-2-squashfs-sysupgrade.img.gz;1;0;1;7.76 MB;7.76 MB
/releases/17.01.6/targets/x86/generic/lede-17.01.6-x86-generic-rootfs-ext4.img.gz;1;0;1;143.75 KB;143.75 KB
/releases/17.01-SNAPSHOT/targets/x86/xen_domu/lede-17.01-snapshot-r3007-b850218-x86-xen_domu-generic-rootfs.tar.gz;1;0;1;63.75 KB;63.75 KB
//snapshots/targets/sunxi/cortexa7/openwrt-sunxi-cortexa7-lamobo_lamobo-r1-ext4-sdcard.img.gz;1;0;1;7.29 MB;7.29 MB
/releases/18.06.7/targets/ar71xx/nand/openwrt-18.06.7-ar71xx-nand-c-60-squashfs-sysupgrade.tar;1;0;1;3.71 MB;3.71 MB
/releases/17.01.7/targets/sunxi/generic/lede-17.01.7-sunxi-sun7i-a20-cubieboard2-ext4-sdcard.img.gz;1;0;1;143.75 KB;143.75 KB
/releases/19.07.0-rc1/targets/mvebu/cortexa53/openwrt-19.07.0-rc1-mvebu-cortexa53-globalscale_espressobin-squashfs-sdcard.img.gz;1;0;1;5.55 MB;5.55 MB
/releases/18.06.0-rc2/targets/armvirt/64/openwrt-18.06.0-rc2-armvirt-64-root.ext4.gz;1;0;1;2.24 MB;2.24 MB
/releases/17.01.0-rc2/targets/sunxi/generic/lede-17.01.0-rc2-r3131-42f3c1f-sunxi-sun5i-a13-olinuxino-ext4-sdcard.img.gz;1;0;1;271.75 KB;271.75 KB
/releases/17.01.6/targets/sunxi/generic/lede-17.01.6-sunxi-sun7i-a20-olinuxino-micro-ext4-sdcard.img.gz;1;0;1;143.75 KB;143.75 KB
/releases/19.07.0/targets/apm821xx/sata/openwrt-19.07.0-apm821xx-sata-wd_mybooklive-ext4-sysupgrade.img.gz;1;0;1;6.54 MB;6.54 MB
/releases/19.07.0-rc1/targets/ar71xx/nand/openwrt-19.07.0-rc1-ar71xx-nand-c-60-squashfs-sysupgrade.tar;1;0;1;4.05 MB;4.05 MB
/releases/17.01.7/targets/ipq806x/generic/lede-17.01.7-ipq806x-NBG6817-squashfs-sysupgrade.tar;1;0;1;127.75 KB;127.75 KB
/releases/18.06.4/targets/sunxi/cortexa7/openwrt-18.06.4-sunxi-cortexa7-sun7i-a20-bananapi-ext4-sdcard.img.gz;1;0;1;319.54 KB;319.54 KB
/releases/17.01.0-rc1/targets/zynq/generic/lede-17.01.0-rc1-r3042-ec095b5-zynq-rootfs.tar.gz;1;0;1;63.75 KB;63.75 KB
/releases/18.06.7/targets/sunxi/cortexa7/openwrt-18.06.7-sunxi-cortexa7-sun8i-h2-plus-orangepi-r1-ext4-sdcard.img.gz;1;0;1;1.27 MB;1.27 MB
//releases/19.07.3/targets/sunxi/cortexa7/openwrt-19.07.3-sunxi-cortexa7-sun7i-a20-olinuxino-lime-squashfs-sdcard.img.gz;1;0;1;4.80 MB;4.80 MB
/releases/19.07.0-rc1/targets/x86/generic/openwrt-19.07.0-rc1-x86-generic-generic-rootfs.tar.gz;1;0;1;3.70 MB;3.70 MB
/releases/19.07.0-rc1/targets/mxs/generic/openwrt-19.07.0-rc1-mxs-duckbill-sdcard.img.gz;1;0;1;11.28 MB;11.28 MB
/releases/19.07.0-rc1/targets/at91/sam9x/openwrt-19.07.0-rc1-at91-sam9x-at91sam9x25ek-ext4-root.ubi.gz;1;0;1;2.47 MB;2.47 MB
/releases/18.06.0/targets/ramips/mt7621/openwrt-18.06.0-ramips-mt7621-ubnt-erx-squashfs-sysupgrade.tar;1;0;1;3.35 MB;3.35 MB
/releases/19.07.1/targets/sunxi/cortexa7/openwrt-19.07.1-sunxi-cortexa7-sun8i-h3-orangepi-one-ext4-sdcard.img.gz;1;0;1;5.60 MB;5.60 MB
/releases/19.07.0-rc1/targets/x86/geode/openwrt-19.07.0-rc1-x86-geode-combined-squashfs.img.gz;1;0;1;6.39 MB;6.39 MB
/releases/18.06.0-rc1/targets/gemini/generic/openwrt-18.06.0-rc1-gemini-nas4220b-rd.gz;1;0;1;6.00 MB;6.00 MB
/releases/19.07.1/targets/brcm2708/bcm2709/openwrt-19.07.1-brcm2708-bcm2709-rpi-2-squashfs-sysupgrade.img.gz;1;0;1;10.77 MB;10.77 MB
/releases/19.07.0-rc1/targets/gemini/generic/openwrt-19.07.0-rc1-gemini-dlink_dns-313-ext4-factory.bin.gz;1;0;1;8.49 MB;8.49 MB
/releases/19.07.2/targets/mvebu/cortexa72/openwrt-19.07.2-mvebu-cortexa72-marvell_armada8040-db-ext4-sdcard.img.gz;1;0;1;1.27 MB;1.27 MB
/releases/18.06.4/targets/sunxi/cortexa7/openwrt-18.06.4-sunxi-cortexa7-sun7i-a20-olinuxino-lime-squashfs-sdcard.img.gz;1;0;1;159.54 KB;159.54 KB
/releases/19.07.0-rc1/targets/at91/sama5/openwrt-19.07.0-rc1-at91-sama5-at91-sama5d4_xplained-ext4-zImage.gz;1;0;1;3.31 MB;3.31 MB
/releases/19.07.0-rc2/targets/sunxi/cortexa53/openwrt-19.07.0-rc2-sunxi-cortexa53-sun50i-h5-orangepi-zero-plus-squashfs-sdcard.img.gz;1;0;1;5.98 MB;5.98 MB
/releases/19.07.1/targets/ar71xx/nand/openwrt-19.07.1-ar71xx-nand-wi2a-ac200i-squashfs-sysupgrade.tar;1;0;1;4.38 MB;4.38 MB
//snapshots/targets/rockchip/armv8/openwrt-rockchip-armv8-radxa_rock-pi-4-ext4-sysupgrade.img.gz;1;0;1;8.61 MB;8.61 MB
/releases/19.07.0-rc2/targets/at91/sam9x/openwrt-19.07.0-rc2-at91-sam9x-at91sam9g15ek-ext4-root.ubi.gz;1;0;1;2.47 MB;2.47 MB
/snapshots/targets/scheduled_for_removal/ar71xx/tiny/openwrt-ar71xx-tiny-vmlinux.lzma;1;0;1;0;0
/releases/18.06.3/targets/apm821xx/sata/openwrt-18.06.3-apm821xx-sata-wd_mybooklive-ext4-rootfs.img.gz;1;0;1;5.62 MB;5.62 MB
/releases/17.01.7/targets/ramips/mt7621/lede-17.01.7-ramips-mt7621-ubnt-erx-squashfs-sysupgrade.tar;1;0;1;143.75 KB;143.75 KB
/releases/18.06.4/targets/sunxi/cortexa8/openwrt-18.06.4-sunxi-cortexa8-sun4i-a10-pcduino-ext4-sdcard.img.gz;1;0;1;159.54 KB;159.54 KB
/releases/19.07.1/targets/sunxi/cortexa7/openwrt-19.07.1-sunxi-cortexa7-sun7i-a20-olinuxino-lime2-emmc-squashfs-sdcard.img.gz;1;0;1;4.87 MB;4.87 MB
/releases/19.07.0-rc2/targets/x86/geode/openwrt-19.07.0-rc2-x86-geode-combined-squashfs.img.gz;1;0;1;6.40 MB;6.40 MB
/releases/19.07.0-rc1/targets/sunxi/cortexa7/openwrt-19.07.0-rc1-sunxi-cortexa7-sun8i-h3-orangepi-one-ext4-sdcard.img.gz;1;0;1;5.59 MB;5.59 MB
/releases/18.06.0-rc2/targets/at91/sama5d4/openwrt-18.06.0-rc2-at91-sama5d4-at91-sama5d4_xplained-ext4-root.ubi.gz;1;0;1;2.29 MB;2.29 MB
/releases/19.07.0-rc2/targets/sunxi/cortexa53/openwrt-19.07.0-rc2-sunxi-cortexa53-sun50i-h5-orangepi-pc2-ext4-sdcard.img.gz;1;0;1;6.79 MB;6.79 MB
/releases/19.07.1/targets/x86/legacy/openwrt-19.07.1-x86-legacy-rootfs-ext4.img.gz;1;0;1;3.14 MB;3.14 MB
/releases/18.06.7/targets/brcm2708/bcm2710/openwrt-18.06.7-brcm2708-bcm2710-rpi-3-ext4-sysupgrade.img.gz;1;0;1;1.27 MB;1.27 MB
/releases/17.01.5/targets/ipq806x/generic/lede-17.01.5-ipq806x-AP148-legacy-ubifs-nand-sysupgrade.tar;1;0;1;7.97 MB;7.97 MB
/releases/18.06.0-rc2/targets/apm821xx/sata/openwrt-18.06.0-rc2-apm821xx-sata-wd_mybooklive-ext4-rootfs.img.gz;1;0;1;5.60 MB;5.60 MB
/releases/19.07.0-rc2/targets/sunxi/cortexa53/openwrt-19.07.0-rc2-sunxi-cortexa53-sun50i-a64-pine64-plus-squashfs-sdcard.img.gz;1;0;1;5.98 MB;5.98 MB
/releases/18.06.4/targets/sunxi/cortexa7/openwrt-18.06.4-sunxi-cortexa7-sun7i-a20-cubietruck-squashfs-sdcard.img.gz;1;0;1;143.54 KB;143.54 KB
/releases/19.07.0-rc1/targets/brcm2708/bcm2709/openwrt-19.07.0-rc1-brcm2708-bcm2709-rpi-2-ext4-sysupgrade.img.gz;1;0;1;11.96 MB;11.96 MB
//snapshots/targets/bcm27xx/bcm2708/openwrt-bcm27xx-bcm2708-rpi-ext4-sysupgrade.img.gz;1;0;1;13.79 MB;13.79 MB
/releases/18.06.0-rc1/targets/brcm63xx/smp/openwrt-18.06.0-rc1-brcm63xx-smp-livebox-vmlinux.gz;1;0;1;2.06 MB;2.06 MB
/releases/19.07.0-rc1/targets/sunxi/cortexa8/openwrt-19.07.0-rc1-sunxi-cortexa8-sun4i-a10-cubieboard-ext4-sdcard.img.gz;1;0;1;5.56 MB;5.56 MB
/releases/19.07.0-rc1/targets/gemini/generic/openwrt-19.07.0-rc1-gemini-dlink_dir-685-ext4-factory.bin.gz;1;0;1;9.01 MB;9.01 MB
/releases/18.06.0-rc1/targets/omap/generic/openwrt-18.06.0-rc1-omap-omap3-beagle-ubifs-sdcard.img.gz;1;0;1;6.00 MB;6.00 MB
/releases/19.07.0-rc2/targets/mvebu/cortexa72/openwrt-19.07.0-rc2-mvebu-cortexa72-marvell_armada7040-db-ext4-sdcard.img.gz;1;0;1;6.39 MB;6.39 MB
/releases/18.06.0-rc2/targets/archs38/generic/openwrt-18.06.0-rc2-archs38-generic-root.ext4.gz;1;0;1;2.82 MB;2.82 MB
//snapshots/targets/mvebu/cortexa9/omnia-medkit-openwrt-mvebu-cortexa9-cznic_turris-omnia-initramfs.tar.gz;1;0;1;4.53 MB;4.53 MB
/releases/19.07.0-rc1/targets/sunxi/cortexa7/openwrt-19.07.0-rc1-sunxi-cortexa7-sun8i-h2-plus-orangepi-r1-ext4-sdcard.img.gz;1;0;1;5.61 MB;5.61 MB
/releases/19.07.0-rc2/targets/at91/sam9x/openwrt-19.07.0-rc2-at91-sam9x-at91sam9g20ek-ext4-root.ubi.gz;1;0;1;2.47 MB;2.47 MB
/releases/17.01.6/targets/ath25/generic/lede-17.01.6-ath25-generic-kernel.gz;1;0;1;159.75 KB;159.75 KB
/releases/19.07.2/targets/armvirt/32/openwrt-19.07.2-armvirt-32-rootfs.cpio.gz;1;0;1;20 Bytes;20 Bytes
/snapshots/faillogs/mipsel_24kc/packages/softethervpn5/host-compile.txt;1;0;1;30.24 KB;30.24 KB
/releases/18.06.0-rc1/targets/at91/sama5d2/openwrt-18.06.0-rc1-at91-sama5d2-at91-sama5d2_ptc_ek-ext4-zImage.gz;1;0;1;3.03 MB;3.03 MB
/releases/19.07.0-rc2/targets/at91/sam9x/openwrt-19.07.0-rc2-at91-sam9x-at91sam9g20ek_2mmc-ext4-zImage.gz;1;0;1;3.35 MB;3.35 MB
/releases/faillogs-18.06/i386_pentium/packages/perl-inline/host-compile.txt;1;0;1;391 Bytes;391 Bytes
/releases/19.07.0-rc2/targets/apm821xx/sata/openwrt-19.07.0-rc2-apm821xx-sata-wd_mybooklive-squashfs-sysupgrade.img.gz;1;0;1;5.40 MB;5.40 MB
/releases/18.06.6/targets/gemini/generic/openwrt-18.06.6-gemini-sysupgrade-ib4220b.tar.gz;1;0;1;10.51 MB;10.51 MB
/releases/19.07.2/targets/sunxi/cortexa8/openwrt-19.07.2-sunxi-cortexa8-sun5i-a13-olimex-som-squashfs-sdcard.img.gz;1;0;1;5.08 MB;5.08 MB
//releases/19.07.3/targets/layerscape/armv8_64b/openwrt-19.07.3-layerscape-armv8_64b-ls1012afrwy-ext4-firmware.bin.gz;1;0;1;304.60 KB;304.60 KB
/snapshots/targets/scheduled_for_removal/brcm2708/bcm2709/kernel-debug.tar.bz2;1;0;1;0;0
/releases/18.06.6/targets/pistachio/generic/openwrt-18.06.6-pistachio-marduk-squashfs-sysupgrade.tar;1;0;1;4.75 MB;4.75 MB
//snapshots/targets/at91/sama5d3/openwrt-at91-sama5d3-at91-sama5d3_xplained-ext4-sdcard.img.gz;1;0;1;5.48 MB;5.48 MB
/releases/17.01.0-rc1/targets/x86/64/lede-17.01.0-rc1-r3042-ec095b5-x86-64-rootfs-ext4.img.gz;1;0;1;2.59 MB;2.59 MB
/releases/18.06.6/targets/archs38/generic/openwrt-18.06.6-archs38-generic-Default-sdcard-vfat-ext4.img.gz;1;0;1;5.93 MB;5.93 MB
/releases/19.07.1/targets/ar71xx/nand/openwrt-19.07.1-ar71xx-nand-rambutan-squashfs-sysupgrade.tar;1;0;1;4.06 MB;4.06 MB
/releases/18.06.0-rc1/targets/at91/sama5d2/openwrt-18.06.0-rc1-at91-sama5d2-rootfs.tar.gz;1;0;1;1.96 MB;1.96 MB
//snapshots/targets/layerscape/armv8_32b/openwrt-layerscape-armv8_32b-ls1012afrwy-ext4-firmware.bin.gz;1;0;1;294.62 KB;294.62 KB
/releases/18.06.4/targets/brcm63xx/smp/openwrt-18.06.4-brcm63xx-smp-livebox-vmlinux.gz;1;0;1;2.06 MB;2.06 MB
//snapshots/targets/at91/legacy/openwrt-at91-legacy-at91sam9g20ek_2mmc-ext4-root.ubi.gz;1;0;1;1.98 MB;1.98 MB
/releases/18.06.4/targets/brcm2708/bcm2709/openwrt-18.06.4-brcm2708-bcm2709-rpi-2-squashfs-sysupgrade.img.gz;1;0;1;7.76 MB;7.76 MB
/releases/18.06.1/targets/armvirt/64/openwrt-18.06.1-armvirt-64-rootfs.cpio.gz;1;0;1;1.97 MB;1.97 MB
/releases/17.01.0-rc2/targets/x86/legacy/lede-17.01.0-rc2-r3131-42f3c1f-x86-legacy-rootfs-ext4.img.gz;1;0;1;143.75 KB;143.75 KB
/releases/17.01.6/targets/x86/64/lede-17.01.6-x86-64-generic-rootfs.tar.gz;1;0;1;287.75 KB;287.75 KB
/releases/18.06.7/targets/sunxi/cortexa7/openwrt-18.06.7-sunxi-cortexa7-sun7i-a20-cubieboard2-ext4-sdcard.img.gz;1;0;1;1.28 MB;1.28 MB
/releases/19.07-SNAPSHOT/targets/ar71xx/mikrotik/openwrt-19.07-snapshot-r11228-78c4c04dd7-ar71xx-mikrotik-vmlinux-initramfs.lzma;1;0;1;3.88 MB;3.88 MB
/releases/18.06-SNAPSHOT/targets/omap/generic/openwrt-18.06-snapshot-r8080-9f2a40c72f-omap-omap4-panda-ubifs-sdcard.img.gz;1;0;1;5.93 MB;5.93 MB
/releases/19.07.0-rc1/targets/at91/sama5/openwrt-19.07.0-rc1-at91-sama5-rootfs.tar.gz;1;0;1;2.08 MB;2.08 MB
/releases/17.01.1/targets/kirkwood/generic/lede-17.01.1-kirkwood-linksys-viper-squashfs-sysupgrade.tar;1;0;1;911.75 KB;911.75 KB
/releases/19.07.1/targets/ar71xx/nand/openwrt-19.07.1-ar71xx-nand-wndr4300-squashfs-sysupgrade.tar;1;0;1;4.51 MB;4.51 MB
/releases/19.07.0-rc1/targets/omap/generic/openwrt-19.07.0-rc1-omap-ti_omap4-panda-squashfs-sdcard.img.gz;1;0;1;5.67 MB;5.67 MB
/snapshots/targets/scheduled_for_removal/ppc44x/generic/kernel-debug.tar.bz2;1;0;1;0;0
/releases/19.07.0-rc2/targets/oxnas/ox820/openwrt-19.07.0-rc2-oxnas-ox820-akitio_mycloud-ubifs-sysupgrade.tar;1;0;1;8.45 MB;8.45 MB
/releases/19.07.0-rc2/targets/x86/legacy/openwrt-19.07.0-rc2-x86-legacy-rootfs-ext4.img.gz;1;0;1;3.13 MB;3.13 MB
/snapshots/faillogs/arc_archs/packages/python3/host-compile.txt;1;0;1;902.24 KB;902.24 KB
//snapshots/targets/mvebu/cortexa53/openwrt-mvebu-cortexa53-glinet_gl-mv1000-ext4-sdcard.img.gz;1;0;1;7.67 MB;7.67 MB
/releases/19.07.0-rc1/targets/sunxi/cortexa8/openwrt-19.07.0-rc1-sunxi-cortexa8-sun5i-a13-olinuxino-squashfs-sdcard.img.gz;1;0;1;5.10 MB;5.10 MB
/releases/19.07.0-rc2/targets/sunxi/cortexa8/openwrt-19.07.0-rc2-sunxi-cortexa8-sun5i-a13-olimex-som-ext4-sdcard.img.gz;1;0;1;6.04 MB;6.04 MB
/releases/19.07.1/targets/sunxi/cortexa7/openwrt-19.07.1-sunxi-cortexa7-sun8i-h3-orangepi-plus-ext4-sdcard.img.gz;1;0;1;5.61 MB;5.61 MB
/releases/19.07.0-rc1/targets/at91/sama5/openwrt-19.07.0-rc1-at91-sama5-at91-sama5d4_xplained-ext4-sdcard.img.gz;1;0;1;5.94 MB;5.94 MB
/releases/18.06.0-rc2/targets/sunxi/cortexa7/openwrt-18.06.0-rc2-sunxi-cortexa7-sun7i-a20-olinuxino-lime-squashfs-sdcard.img.gz;1;0;1;4.47 MB;4.47 MB
/releases/18.06.0-rc1/targets/omap/generic/openwrt-18.06.0-rc1-omap-omap4-panda-ubifs-sdcard.img.gz;1;0;1;5.86 MB;5.86 MB
/releases/17.01.0-rc2/targets/sunxi/generic/lede-17.01.0-rc2-r3131-42f3c1f-sunxi-sun7i-a20-bananapi-ext4-sdcard.img.gz;1;0;1;127.75 KB;127.75 KB
/releases/19.07.0-rc1/targets/ar71xx/nand/openwrt-19.07.0-rc1-ar71xx-nand-wndr4300-squashfs-sysupgrade.tar;1;0;1;4.51 MB;4.51 MB
/releases/18.06.0-rc1/targets/sunxi/cortexa7/openwrt-18.06.0-rc1-sunxi-cortexa7-sun8i-h3-orangepi-plus-squashfs-sdcard.img.gz;1;0;1;4.42 MB;4.42 MB
/releases/19.07.0-rc1/targets/brcm2708/bcm2708/openwrt-19.07.0-rc1-brcm2708-bcm2708-rpi-squashfs-factory.img.gz;1;0;1;10.32 MB;10.32 MB
/releases/19.07.0-rc2/targets/at91/sam9x/openwrt-19.07.0-rc2-at91-sam9x-lmu5000-ext4-factory.bin.gz;1;0;1;5.87 MB;5.87 MB
//snapshots/targets/omap/generic/openwrt-omap-rootfs.tar.gz;1;0;1;2.77 MB;2.77 MB
/releases/19.07.0/targets/layerscape/armv7/openwrt-19.07.0-layerscape-armv7-ls1021atwr-sdboot-ext4-sdcard.img.gz;1;0;1;6.35 MB;6.35 MB
/releases/19.07.0-rc1/targets/sunxi/cortexa7/openwrt-19.07.0-rc1-sunxi-cortexa7-sun8i-h3-nanopi-m1-plus-ext4-sdcard.img.gz;1;0;1;6.92 MB;6.92 MB
/releases/18.06.0-rc1/targets/archs38/generic/openwrt-18.06.0-rc1-archs38-generic-Default-sdcard-vfat-ext4.img.gz;1;0;1;5.88 MB;5.88 MB
/releases/17.01-SNAPSHOT/targets/sunxi/generic/lede-17.01-snapshot-r4046-beaa2ec-sunxi-sun8i-h3-orangepi-plus-ext4-sdcard.img.gz;1;0;1;271.75 KB;271.75 KB
/releases/17.01.4/targets/ipq806x/generic/lede-17.01.4-ipq806x-R7800-squashfs-sysupgrade.tar;1;0;1;4.81 MB;4.81 MB
/releases/17.01.7/targets/rb532/generic/lede-17.01.7-rb532-default-rootfs.tar.gz;1;0;1;143.75 KB;143.75 KB
//snapshots/targets/at91/legacy/openwrt-at91-legacy-tny_a9g20-ext4-factory.bin.gz;1;0;1;5.30 MB;5.30 MB
//snapshots/targets/sunxi/cortexa7/openwrt-sunxi-cortexa7-xunlong_orangepi-plus-ext4-sdcard.img.gz;1;0;1;6.28 MB;6.28 MB
/releases/17.01.7/targets/ar71xx/nand/lede-17.01.7-ar71xx-nand-c-60-squashfs-sysupgrade.tar;1;0;1;159.75 KB;159.75 KB
/releases/18.06.0/targets/armvirt/64/openwrt-18.06.0-armvirt-64-root.squashfs.gz;1;0;1;1.57 MB;1.57 MB
/releases/18.06.4/targets/armvirt/64/openwrt-18.06.4-armvirt-64-root.squashfs.gz;1;0;1;1.57 MB;1.57 MB
/releases/19.07.2/targets/sunxi/cortexa8/openwrt-19.07.2-sunxi-cortexa8-sun4i-a10-pcduino-ext4-sdcard.img.gz;1;0;1;6.07 MB;6.07 MB
/releases/18.06.0-rc1/targets/at91/sama5d4/openwrt-18.06.0-rc1-at91-sama5d4-at91-sama5d4_xplained-ext4-sdcard.img.gz;1;0;1;5.54 MB;5.54 MB
/releases/19.07.1/targets/sunxi/cortexa7/openwrt-19.07.1-sunxi-cortexa7-sun8i-h3-nanopi-neo-squashfs-sdcard.img.gz;1;0;1;4.75 MB;4.75 MB
/releases/19.07.0-rc2/targets/mvebu/cortexa53/openwrt-19.07.0-rc2-mvebu-cortexa53-globalscale_espressobin-v7-squashfs-sdcard.img.gz;1;0;1;5.55 MB;5.55 MB
/releases/19.07.0-rc1/targets/at91/sama5/openwrt-19.07.0-rc1-at91-sama5-at91-sama5d27_som1_ek-ext4-root.ubi.gz;1;0;1;2.45 MB;2.45 MB
/releases/17.01.0-rc2/targets/x86/generic/lede-17.01.0-rc2-r3131-42f3c1f-x86-generic-rootfs-ext4.img.gz;1;0;1;159.75 KB;159.75 KB
/releases/18.06.9/targets/x86/legacy/openwrt-18.06.9-x86-legacy-combined-ext4.img.gz;1;1;2;6.77 MB;3.39 MB
/snapshots/targets/scheduled_for_removal/ar71xx/nand/openwrt-ar71xx-nand-wi2a-ac200i-squashfs-sysupgrade.tar;1;0;1;0;0
//snapshots/targets/mvebu/cortexa53/openwrt-mvebu-cortexa53-globalscale_espressobin-ext4-sdcard.img.gz;1;0;1;7.67 MB;7.67 MB
/releases/18.06-SNAPSHOT/targets/sunxi/cortexa53/openwrt-18.06-snapshot-r8073-5625f5bc36-sunxi-cortexa53-sun50i-a64-sopine-baseboard-squashfs-sdcard.img.gz;1;0;1;5.63 MB;5.63 MB
/releases/19.07.0-rc1/targets/rb532/generic/openwrt-19.07.0-rc1-rb532-default-rootfs.tar.gz;1;0;1;3.56 MB;3.56 MB
/releases/17.01.0-rc1/targets/sunxi/generic/lede-17.01.0-rc1-r3042-ec095b5-sunxi-sun4i-a10-olinuxino-lime-squashfs-sdcard.img.gz;1;0;1;159.75 KB;159.75 KB
/releases/faillogs-18.06/arm_cortex-a9_vfpv3/packages/perl-parse-recdescent/host-compile.txt;1;0;1;429 Bytes;429 Bytes
/releases/17.01.6/targets/sunxi/generic/lede-17.01.6-sunxi-sun4i-a10-pcduino-ext4-sdcard.img.gz;1;0;1;159.75 KB;159.75 KB
/releases/18.06.0-rc1/targets/at91/sama5d3/openwrt-18.06.0-rc1-at91-sama5d3-rootfs.tar.gz;1;0;1;1.96 MB;1.96 MB
/releases/17.01.0-rc2/targets/xburst/qi_lb60/lede-17.01.0-rc2-r3131-42f3c1f-xburst-qi_lb60-default-rootfs.tar.gz;1;0;1;127.75 KB;127.75 KB
/releases/19.07.0-rc1/targets/x86/generic/openwrt-19.07.0-rc1-x86-generic-combined-squashfs.img.gz;1;0;1;6.90 MB;6.90 MB
/releases/18.06.0-rc1/targets/at91/sama5d2/openwrt-18.06.0-rc1-at91-sama5d2-at91-sama5d27_som1_ek-ext4-root.ubi.gz;1;0;1;2.33 MB;2.33 MB
//snapshots/targets/sunxi/cortexa7/openwrt-sunxi-cortexa7-friendlyarm_nanopi-neo-air-squashfs-sdcard.img.gz;1;0;1;6.69 MB;6.69 MB
/releases/18.06.3/targets/ar71xx/nand/openwrt-18.06.3-ar71xx-nand-r6100-squashfs-sysupgrade.tar;1;0;1;4.76 MB;4.76 MB
/releases/19.07.1/targets/sunxi/cortexa7/openwrt-19.07.1-sunxi-cortexa7-sun7i-a20-cubieboard2-squashfs-sdcard.img.gz;1;0;1;4.79 MB;4.79 MB
//snapshots/targets/bcm27xx/bcm2708/openwrt-bcm27xx-bcm2708-rpi-squashfs-sysupgrade.img.gz;1;0;1;12.31 MB;12.31 MB
/releases/19.07.0-rc2/targets/oxnas/ox820/openwrt-19.07.0-rc2-oxnas-ox820-cloudengines_pogoplugpro-ubifs-sysupgrade.tar;1;0;1;9.18 MB;9.18 MB
/releases/18.06.0-rc1/targets/sunxi/cortexa7/openwrt-18.06.0-rc1-sunxi-cortexa7-sun8i-h3-orangepi-2-ext4-sdcard.img.gz;1;0;1;5.25 MB;5.25 MB
/releases/17.01.0-rc1/targets/omap/generic/lede-17.01.0-rc1-r3042-ec095b5-omap-default-rootfs.tar.gz;1;0;1;191.75 KB;191.75 KB
/releases/18.06.2/targets/brcm63xx/generic/openwrt-18.06.2-brcm63xx-generic-livebox-vmlinux.gz;1;0;1;1.94 MB;1.94 MB
/releases/18.06.3/targets/ar71xx/nand/openwrt-18.06.3-ar71xx-nand-hiveap-121-squashfs-sysupgrade.tar;1;0;1;3.71 MB;3.71 MB
/releases/19.07.0-rc1/targets/gemini/generic/openwrt-19.07.0-rc1-gemini-raidsonic_ib-4220-b-ext4-factory.bin.gz;1;0;1;8.22 MB;8.22 MB
/releases/18.06.0-rc1/targets/arc770/generic/openwrt-18.06.0-rc1-arc770-generic-Default-sdcard-vfat-ext4.img.gz;1;0;1;4.84 MB;4.84 MB
/releases/18.06.0-rc1/targets/at91/sama5d4/openwrt-18.06.0-rc1-at91-sama5d4-at91-sama5d4_xplained-ext4-zImage.gz;1;0;1;3.02 MB;3.02 MB
/releases/18.06.0-rc2/targets/sunxi/cortexa53/openwrt-18.06.0-rc2-sunxi-cortexa53-sun50i-h5-nanopi-neo-plus2-squashfs-sdcard.img.gz;1;0;1;5.59 MB;5.59 MB
/releases/18.06.0-rc2/targets/at91/sama5d2/openwrt-18.06.0-rc2-at91-sama5d2-at91-sama5d2_xplained-ext4-sdcard.img.gz;1;0;1;1.28 MB;1.28 MB
/releases/17.01.7/targets/imx6/generic/lede-17.01.7-imx6-rootfs.tar.gz;1;0;1;159.75 KB;159.75 KB
/releases/18.06.7/targets/archs38/generic/openwrt-18.06.7-archs38-generic-root.ext4.gz;1;0;1;1.72 MB;1.72 MB
/releases/19.07.0/targets/layerscape/armv8_64b/openwrt-19.07.0-layerscape-armv8_64b-ls1012afrwy-ext4-sdcard.img.gz;1;0;1;8.04 MB;8.04 MB
/releases/18.06.1/targets/octeon/generic/openwrt-18.06.1-octeon-erlite-squashfs-sysupgrade.tar;1;0;1;4.44 MB;4.44 MB
/releases/19.07.1/targets/layerscape/armv7/openwrt-19.07.1-layerscape-armv7-ls1021aiot-sdboot-ext4-sdcard.img.gz;1;0;1;6.28 MB;6.28 MB
/releases/17.01.7/targets/oxnas/generic/lede-17.01.7-oxnas-akitio-ubifs-sysupgrade.tar;1;0;1;159.75 KB;159.75 KB
/releases/18.06.0-rc2/targets/sunxi/cortexa53/openwrt-18.06.0-rc2-sunxi-cortexa53-sun50i-h5-nanopi-neo-plus2-ext4-sdcard.img.gz;1;0;1;6.36 MB;6.36 MB
/releases/17.01.0-rc2/targets/brcm2708/bcm2710/lede-17.01.0-rc2-r3131-42f3c1f-brcm2708-bcm2710-rpi-3-ext4-sdcard.img.gz;1;0;1;191.75 KB;191.75 KB
/releases/18.06.5/targets/ar71xx/nand/openwrt-18.06.5-ar71xx-nand-nbg6716-squashfs-sysupgrade.tar;1;0;1;4.76 MB;4.76 MB
/releases/18.06.4/targets/sunxi/cortexa7/openwrt-18.06.4-sunxi-cortexa7-sun7i-a20-bananapi-squashfs-sdcard.img.gz;1;0;1;159.54 KB;159.54 KB
/releases/19.07.0-rc2/targets/sunxi/cortexa8/openwrt-19.07.0-rc2-sunxi-cortexa8-sun4i-a10-pcduino-squashfs-sdcard.img.gz;1;0;1;5.09 MB;5.09 MB
/releases/19.07.0-rc1/targets/sunxi/cortexa7/openwrt-19.07.0-rc1-sunxi-cortexa7-sun7i-a20-bananapi-ext4-sdcard.img.gz;1;0;1;5.63 MB;5.63 MB
/releases/18.06.4/targets/sunxi/cortexa8/openwrt-18.06.4-sunxi-cortexa8-sun4i-a10-cubieboard-squashfs-sdcard.img.gz;1;0;1;159.54 KB;159.54 KB
/releases/19.07.1/targets/sunxi/cortexa8/openwrt-19.07.1-sunxi-cortexa8-sun4i-a10-cubieboard-ext4-sdcard.img.gz;1;0;1;5.57 MB;5.57 MB
//snapshots/targets/mediatek/mt7623/openwrt-mediatek-mt7623-unielec_u7623-emmc-squashfs-img.gz;1;0;1;5.63 MB;5.63 MB
/snapshots%2Ftargets%2Fbcm27xx%2Fbcm2709%2Fopenwrt-bcm27xx-bcm2709-rpi-2-ext4-factory.img.gz;0;234;234;21.62 MB;94.59 KB
https://downloads.openwrt.org/releases/19.07.4/targets/brcm2708/bcm2708/openwrt-19.07.4-brcm2708-bcm2708-rpi-ext4-factory.img.gz;0;1;1;1 Bytes;1 Bytes
/snapshots%2Ftargets%2Fbcm27xx%2Fbcm2710%2Fopenwrt-bcm27xx-bcm2710-rpi-3-ext4-factory.img.gz;0;67;67;13.68 MB;209.05 KB
/snapshots%2Ftargets%2Fbcm27xx%2Fbcm2708%2Fopenwrt-bcm27xx-bcm2708-rpi-ext4-factory.img.gz;0;139;139;24.07 MB;177.33 KB
/snapshots%2Ftargets%2Fx86%2F64%2Fopenwrt-x86-64-generic-squashfs-combined-efi.img.gz;0;13;13;1.14 MB;89.92 KB
/snapshots%2Ftargets%2Fx86%2F64%2Fopenwrt-x86-64-generic-ext4-combined-efi.img.gz;0;8;8;1.03 MB;131.33 KB
